TYartMOpAnAoDmYQIUqv	TRUE
eSqYthh	TRUE
jOUY4PmfqCtMeXP2WPXYCL1du	TRUE
A	TRUE
twlEMnmU3	TRUE
XgV1oawj	TRUE
fxUBTAUwMQvvjfbjm3X1QHd	TRUE
vFiTyplqDLsLZLt42HoJaW	TRUE
IGq	TRUE
uqW2B4oFqfpDUJXCuFhfjrRI	TRUE
tmZGZ34NswvZCqsahvFHoR2	TRUE
l	TRUE
Ev33pnybpSSmSs	TRUE
zl	TRUE
woqhDqfdlT	TRUE
nRU21KPDwIQcTlcCiBUq	TRUE
cAFgzJ	TRUE
mz3btq1sQyNAjI3rWlmkwhO	TRUE
WXaFPlUDJ2xOmg	TRUE
3smISeZMtbFAd3K	TRUE
iP4WszyCKrjne2dIf1yjwBN1I	TRUE
OYzlvQTMSjJwLDnraFAAzOY	TRUE
nvCKfKS3XXUyZkQOxTTvdKKU	TRUE
GyC	TRUE
HC	TRUE
1oZhw3d3P2N3hHHfJoaEB2GZV	TRUE
o2rl2QHQGLmmi	TRUE
jdqhp2qBmZjfA4NPV	TRUE
nTbyo	TRUE
LdfSRyJZlkep4hsl2	TRUE
qn43I	TRUE
gbvjxW1xud4H	TRUE
qOhiaR4	TRUE
NnjGtJsozLD2C	TRUE
oxBJXU4XjmNww	TRUE
KVWbQDqKCkPncTThZaHpq	TRUE
TvyH3dT	TRUE
cBTjaoEvPxqdaYtT	TRUE
vXcPPhc1hxuxbY	TRUE
Kk2B4zcvwZOynq	TRUE
gUMd41AsLoNZWT	TRUE
UQDXKdgT	TRUE
EViJTZ2HuSAgY	TRUE
Z	TRUE
EMavVbx	TRUE
OV	TRUE
hrXHtvoUZjEBrSQxxvNLOr	TRUE
lvXWSucDJhuLIqhHBbLG	TRUE
f	TRUE
LmwVfiWSM	TRUE
LkXD3GNQNpHVd	TRUE
ZNiYijuRTP3kbeA2rPkSUz	TRUE
YzdH	TRUE
KzP	TRUE
JStrVjsAFG	TRUE
MxYXgxI	TRUE
aTlLcCw	TRUE
DjVYI4pUK	TRUE
lrnxhh	TRUE
cjPjAqGVMFpl	TRUE
agjRrqHwg3cklxTz	TRUE
YMzkebDG	TRUE
Qwh	TRUE
Z	TRUE
HlKKkSDK1DfeaPP	TRUE
TgoVfPLsZ3J	TRUE
QBjNgzgdgVZvXPwsJUqmB	TRUE
23qhWHu	TRUE
yY	TRUE
QLLarwVgdQKzHARF1W	TRUE
32CnZPjfadyEjRKRPSvHYxt	TRUE
shV23xPGGEex3Xgmrav	TRUE
Mq2JP3wCFWWvD1pFzQEMqBCc	TRUE
jtsw4CcTzaDXnMBeBbChCrjr	TRUE
HYr1D1xQ2NrwWFBATIytaGkG	TRUE
azbMSq1PlUQzFnS	TRUE
hlO1eXDxLbRLLuPTExPIiwGb	TRUE
t4Io	TRUE
2k1fURDQlYHq	TRUE
ZobdkExyvjlpr	TRUE
YkWPlWPMcIAkkWNypZSYdq1GJ	TRUE
tvvMbWs2prNzl	TRUE
AgUOgAUOWTHXgOj2EyVKVZx	TRUE
CluMWnqSEg	TRUE
JlmRe2hgDMHCTfwDOTbTWkstJ	TRUE
crAIc2	TRUE
Oh1lGMJqYxfIanoxZUQh	TRUE
RQXQVAo	TRUE
VRDX2QClbqHgBdQRK	TRUE
f2KDZvweKuMhlnfl	TRUE
PJfLzFemegB3E3l	TRUE
Bm3FzYwIQwmlwbYijhIrv	TRUE
FNVnDaPKMQwHRYt4	TRUE
pJyu3vkyw2GAw	TRUE
uQjNTz	TRUE
Sm1Mo4JTQ1yxM1gs	TRUE
A2MQNSRmBDmAhpIbx1	TRUE
cpI	TRUE
1jcksIML3yTwiPTkpXBxM	TRUE
LSzuYo2oGXTK4qG	TRUE
wqvWeEcHtbizSXyqswj	TRUE
Iu	TRUE
qmmSyh	TRUE
iZQIaLTpiKZRgYzyVKCk1Dm	TRUE
reYbAqeSuDbOWowowApA	TRUE
QIT1qxgKh	TRUE
FNWmg4Tr2ptkPsxKlPtfMuonk	TRUE
NZ3iyYvbIes2ORSnPVKgk	TRUE
mjtuZ4	TRUE
G	TRUE
URYaC	TRUE
dkWhVivQVBRxv4EoKjJxMH2	TRUE
FfofIaM	TRUE
tgD2XMdOf3zJxCeeNert	TRUE
n4NCxGPGOTH4iB	TRUE
fzDFgpGvg1M	TRUE
uyDZEA	TRUE
UqMPeByLBuFlK	TRUE
dG4hqTyYjHlNOiJY	TRUE
IqADUztlFj3fcuRAffEUusPZv	TRUE
FopYHj	TRUE
lkUI	TRUE
xOYdT	TRUE
DRHIE	TRUE
Qdekauznu	TRUE
ANcaPuw1ODbl4E	TRUE
kBawhnIIpBH2qCKLOhN	TRUE
JqRy	TRUE
qNwz	TRUE
VR3Qm1vghw12OJpJUqwD3	TRUE
jsNYjYWk1	TRUE
HE	TRUE
UdMVBni	TRUE
WwBTfiEP4MyPc1lt2B	TRUE
tmCttpXCC1RBpKujjXLtw	TRUE
ozGfHcjYMhpnkeaBrqkZ	TRUE
eyEfT4jJyuPRIQRo	TRUE
HScVyERNk2ENu3MqOcY	TRUE
saIBolEsZqNIKYbMW	TRUE
MpdJqx3JR	TRUE
EqvQevlsBGHTEVVAjaGJ	TRUE
eRTiUvdnap	TRUE
ows4B	TRUE
dwkp	TRUE
uhfiN1KZkzmHWVwiRVJEEINd	TRUE
H	TRUE
TyiEIqyTRpjJA3QHO	TRUE
zooEuvkFt4Y3Aa4chnqPp	TRUE
N42KtPyHMDYttRqf	TRUE
qp	TRUE
HVAXtSE3ff3ArUffwhz4	TRUE
E4vEAr3bDulqgBnan4	TRUE
AEn2dCOUVeSLYoI	TRUE
JlzoUqUeEEokXnucEAqr	TRUE
wrVwMCXmENsDSGuswJtw	TRUE
sfdeNlwSOMgzTlv33dXDnhX	TRUE
BWsMHfvCwkx1yuO1	TRUE
KRpezKVlyaMlvO	TRUE
rZLB3YxAEAN	TRUE
xoLEVXgYGDFwlh	TRUE
FOjMXNEztEu2HOSveTOPYdKyh	TRUE
FvTkKgCnWdpnDftQnUIBaO	TRUE
lwit3tTEjqiSNA	TRUE
jsubKCJPj	TRUE
s2GUBODKeIzr4lJwg2d	TRUE
jrfDQLmOOcum	TRUE
kKJXZSJzaLbvhJWAvzXIqYO	TRUE
vHJfe1cX	TRUE
up4mOYYG	TRUE
liiSsyIAGNV1lCwKmOWE13hm	TRUE
knXfLkf1	TRUE
4cnAoW4SE4hQL1qM3	TRUE
vjSmOwmRrcWtoMhESX2P1fJO	TRUE
wZNXtZqrhgOAmtD1popOy	TRUE
Cdi4QTdZ1zneqGV2baiCo3v	TRUE
KvBLG4n	TRUE
rMcbTDBg2S	TRUE
EVLmv	TRUE
2UHPPag3nBEAC	TRUE
d3lKmNerKE	TRUE
IjVcTHfaLByX2SB	TRUE
myXVrctIqnA2WqwMJEXfVu	TRUE
nCQWtoPxjpshqVygZvWjmgBZp	TRUE
JCSsWBfm	TRUE
KUeQcavQGRRSh	TRUE
grR	TRUE
DZUluaun	TRUE
asI3qGxbolC	TRUE
FYJ1QDM2	TRUE
vWrbVJYP	TRUE
OPjQlBMDRi	TRUE
Jld	TRUE
cur	TRUE
RpzaMQQLoAijZpIrr	TRUE
enWIbfjyUBB	TRUE
oaso1u	TRUE
3EiTLEdgycH	TRUE
GJn2dJtaXYwUiZeB2Rgn	TRUE
4lmOaYWl3cttVnGaW	TRUE
VDQ3wN	TRUE
DnYfusTSexocD	TRUE
iu	TRUE
Uig3zG	TRUE
R3iDd3kOY3oJrdAHJz	TRUE
x4e2io	TRUE
VMlQIVjxY1DxTPBszDMRqsY	TRUE
lWJsNXLOv	TRUE
OusMExUQqCiU	TRUE
Jzy1WdTdZPEagbp3jBtBO1	TRUE
a2RBfQIr4Dkn3ip1drediykz	TRUE
dqxRIadFalXdY3uOk1bviTLVW	TRUE
Lou4VXCWWwM2uwwW	TRUE
clVCNEHggMtpFgiHRk3RIi	TRUE
UQcKGbgfRUMj2ife	TRUE
mq4jDhQi	TRUE
4BQJQRkkenxxMYETmjMeigE	TRUE
WQIAWlcjAYasKRG3ZvHODE	TRUE
N2c4GeVypIKdUpdj	TRUE
pIqTw	TRUE
OnebJHROVUFkIkev3T	TRUE
TvH	TRUE
colIS2BFnFaHwKbjoqfHQqF	TRUE
JG3fp3XpPWKtAQP4TfUtA	TRUE
PUWPzzl3RZjh	TRUE
pF	TRUE
vcPLMwXmyGiPmV1Ufvp	TRUE
cvTdB	TRUE
Rg	TRUE
rTYc	TRUE
JiWsBoP4yhXEVH	TRUE
2i4LZxmHyUVpgREWakF	TRUE
V4COfvQGVIEqeBUq	TRUE
33D3aQjvdKp	TRUE
WJt3VFy1wdzvQGSCdOMhqmb	TRUE
VBWqPcS	TRUE
HmQIhjoexXhrKh4qoy1JUHk	TRUE
ZhmJQ3dWhYVq	TRUE
1ODkpVGEq2yLeAgL	TRUE
xWWXKXAmaTKBtYXcqbT	TRUE
LmvitkSX2pd	TRUE
VYG4skfO3ZH2CPabDP	TRUE
jLqHVIUtIix1IPXsmsO	TRUE
CnERp	TRUE
QjHSVavMoyQK	TRUE
J3X	TRUE
3HxsOW4oUXxFJSF	TRUE
ovUj4	TRUE
EiJzuUk	TRUE
jdas	TRUE
Uu2Zn2bhMMqqQRPOwSQI	TRUE
WlxoHkSP	TRUE
Hlhu4uo	TRUE
fWzrIzUQlUeGi33smd	TRUE
qlWi	TRUE
1	TRUE
TzNfUNi2tCC4HF	TRUE
HUWbgNjkJiuNpjoEHc	TRUE
gVaEVC	TRUE
OoWwisbK2oT	TRUE
XJg	TRUE
c	TRUE
jECJOdIpMk3QIlJUyWOeT	TRUE
PKYH	TRUE
pbahcRwQXNEwZT4	TRUE
ZBOpAxenPldxrhPR	TRUE
nJZtXrCcmTjEGTLGUvdVjxx	TRUE
XUC	TRUE
TDDGeNSvWuLTwwvONWAh	TRUE
OICyzYy2ynBleX	TRUE
2YGBIUndIRcDRCcAfVV1H	TRUE
xOOwnEnB2uPtgGXTr	TRUE
guTieHMwuHUykyAz4KVYDJGnx	TRUE
fc	TRUE
LfPpjFTdvKeAf1FI	TRUE
NFb	TRUE
TFSMn	TRUE
HgY2TstNanFsUsBsqhl	TRUE
FimpAPbcHWty2WyLL2m	TRUE
ZLAG	TRUE
D	TRUE
aHCtFg	TRUE
mshvEBrdAR	TRUE
wOE4LmrPb	TRUE
3xpkyggm	TRUE
lclkpuUDYpzpdxuGverHSuBu	TRUE
Qf	TRUE
GMo4vJmlxqsihyrMy	TRUE
DRb1qPhU	TRUE
NDkx	TRUE
4bgfZ4iDthGvS1Xzy	TRUE
eM2LltFweS	TRUE
1UfM4KBvXSIVHtHAVZQjec1	TRUE
JFE	TRUE
ouYJUm	TRUE
LjQtPYNZ	TRUE
ZzIK	TRUE
AQvNtyUx4PxHBZbpX1JRwc	TRUE
Yab	TRUE
2lYwAeECT3	TRUE
NB	TRUE
eR1YqxNT1ubr	TRUE
xYz2KVrAPvBhs	TRUE
csFZsWOyzvDwB31CEN	TRUE
KhQbNCqZQ1oQYox	TRUE
WwgrsmEcTc	TRUE
hizGOB34kUeNyp	TRUE
BuNuaNtuUdzW	TRUE
y11V	TRUE
PMSFOU4OJxXt3zqaAWT	TRUE
kMwjnls1pS2p	TRUE
QIpdGaBIf3pODCmffPkbz	TRUE
K1wfHOXOf	TRUE
4	TRUE
GwooQ	TRUE
TV3RSZvUpsmW2z3ongY	TRUE
DDUZt2hA	TRUE
2FRjEriGmkNRoWDYxMn	TRUE
evFUYDJh1Xi4XNYnFz4	TRUE
nn	TRUE
IkEag4l	TRUE
o	TRUE
foS	TRUE
sr1Brb	TRUE
rDvva2l	TRUE
tlzL1JZUWjoC	TRUE
vHHNRRi2ym	TRUE
W4wZabGLpJwb	TRUE
YCsLaKJY3wPVI	TRUE
POXx	TRUE
GFuwgZhurL	TRUE
OkHqhmIG2kxnq1TCNkSHWD1f	TRUE
P4yB3CyHd4	TRUE
U4FnMNwRvU	TRUE
TrrSwwUSYQH	TRUE
LMBHqntcxEIZVlJQ1sXBQh	TRUE
4dwvkzVQVRnRMUrbtuL4RvX	TRUE
kA	TRUE
HmScqAGsPwetOHR1JnXjNL	TRUE
UcpuRvISwphAFPfOAMTFfXYJ	TRUE
F	TRUE
NESUflU1Rqg	TRUE
nhjFdXoH4fjmzE	TRUE
ekwxEkh3CShOUvG	TRUE
IMYUjfhCAQV4hsW1m	TRUE
rNfk2FwAePFUEGhgc4bhQlPXv	TRUE
xmtBwmdvphW	TRUE
2XBbavsX2ES	TRUE
rIVDMkAlo	TRUE
xeqmNNG2J	TRUE
gT3BNXlvIICSej	TRUE
cc3BGhpkNDbmulfMTdbV2G1T	TRUE
VsZRUjzRmgDtIvia3ktcqx3o	TRUE
nc3	TRUE
NElHadtLr	TRUE
ycedqOvyVG	TRUE
fSVW	TRUE
MhT	TRUE
a2w44iGJ2JRFoYHOmZRmaWBqK	TRUE
1eIUgNrT3Io44bZRQ	TRUE
ManrOxh	TRUE
SQHNnXhJxoN	TRUE
UGvUtmpOr	TRUE
WtNglVFlUrylovr	TRUE
xYSkGHaWu3PzC	TRUE
YQHbg	TRUE
2	TRUE
dXMziBIwIwl	TRUE
r2K2ReCA1ihTHbV	TRUE
AHawePqFUwcSyPdzJO	TRUE
MqNCBfDDDfsGsSyPqV	TRUE
UQn	TRUE
3buDOWMCyoQN4A2CypYIOn	TRUE
iLFSbNA4GYhGG2Gy	TRUE
K	TRUE
PDfygPbjQoBOHlgrO2oF	TRUE
n	TRUE
O3rmH	TRUE
wTrufYqgff2hKS3nn	TRUE
wyTIpNUoGhkpMlmqIiEud3	TRUE
HyvkFomtoRlPpArqrsXX2	TRUE
smNklHxyThLStW3zEfecCBbAS	TRUE
D1tgPs3TqkGcsxRVUtXMuFCt	TRUE
1FMUSWXw3YCGnwD	TRUE
wTNaVlhIeTUnu2EqCT	TRUE
YfYocENcZOGJqFdQMJrD	TRUE
fsBZMWVq3Q1BwqggHSeYhOs1	TRUE
AR2ujXXiSrgl4pXgMiOLHK	TRUE
jO2EZoU	TRUE
XDAVny3M3U	TRUE
jrL2sqHGqeTWR	TRUE
CipqA3VIg	TRUE
sk	TRUE
1jepNVIAOLQgCs	TRUE
e12b1CSHJo2aw	TRUE
B1DadCnkYYe	TRUE
aHq1	TRUE
fZPou	TRUE
SZ3bncUnOyeTRdiDG	TRUE
CuCCiUEUnSAbcqhQlD	TRUE
qOCVANjyndFW2zMpjhJGO	TRUE
nzVvxG1E	TRUE
VTEllVbmQ3nKsfcGxrwqDnrxN	TRUE
t	TRUE
dzemTnBn1iH3IByjvgldZM	TRUE
E4JFTPDjBWG	TRUE
cpCU	TRUE
GB4OeyuUWPJOItWw2UJn	TRUE
qXhyv4d2VOpPaQt	TRUE
vjIEogekL3FMvR2pQ	TRUE
ExASBNXJDULU	TRUE
FXwfVwObLAfmycngXgWyF	TRUE
XRaQNhUbZB	TRUE
WUVoKOvPLNBaW	TRUE
GCMnhEKtXntujdsWBDg	TRUE
4NnNgFTO2HHzZJZV1DpFRrGBs	TRUE
3j	TRUE
qXlJlrG	TRUE
OGgdfFETCvIpKlyWFI	TRUE
sFeWKtgRnR1lts	TRUE
jRiG1xCKiEKpeFbgOteAbCYg	TRUE
2yVH2wDers3oIUJJVcEpEg	TRUE
uelc1nbDRabfobN44wgp1g	TRUE
vqPBhuAFN	TRUE
FZ4I	TRUE
PGtScpGhhoTtyez2WaSCUlACV	TRUE
fyOTvnQTEObKwPbToP	TRUE
ZsVDA1kPj1DYthBrUo	TRUE
t3S1IBtJr	TRUE
lAAjjhvgDLdmYqKaXacRtubYs	TRUE
RDjNklPrsCUMAIrKZpWph	TRUE
sI3sDeFb3wh	TRUE
q	TRUE
1eoyhhqQoI1RW3EiYfi	TRUE
m	TRUE
pSGtwN	TRUE
oHuXc2ZoVOEu	TRUE
mzXQM1gsgHC3xrKaw4	TRUE
LZjBZopyCacmMOesNMVvfKVd	TRUE
PXT4m1MNjssI1YGvvE	TRUE
Us1TGnz3uIQhkyz	TRUE
UIC2e	TRUE
egJad	TRUE
OcEVjIbsQjYHDK	TRUE
HatXvaZp4j	TRUE
hZc2MOibn	TRUE
qsfeFUOJvOUhEEgskmEcMg	TRUE
Jk	TRUE
vnb	TRUE
2PDwUvBTfiBQAPe	TRUE
K1	TRUE
kFFMR	TRUE
2mrk1J	TRUE
lUvhdE4vQ4HKt	TRUE
kQTIsXmY3e	TRUE
TYsjz1og2RDORiErVaJWumn	TRUE
UmlQijgbqfXQZcA	TRUE
Akx1BSlc	TRUE
2K1pWyPB	TRUE
tvqHVJFLKIOv34uIDsj1Frnck	TRUE
mcEq4BMDWq2jKEN4aG	TRUE
NqG2	TRUE
sksPpJ2uemKxIOSx	TRUE
HyaDasolGMUdWuhiOXtrO	TRUE
viETYmNKE1Z	TRUE
GiNPTJF4jTzd	TRUE
px3mVp	TRUE
ObNG4KdL	TRUE
lVWbODx1WChNVx3C4	TRUE
FtCWnFzdyxcQEG3hnecoyW	TRUE
uPSczmsiBT3JW	TRUE
eLz4mN3gCnDke4TR2wKGjBSQ	TRUE
RqahApL2ogwNpVYrFqlp	TRUE
Px1BOrEdHjSQUNl	TRUE
XPoNcoaBAzBbdppo1nXWs	TRUE
QJMTdFuglCSbfF	TRUE
UbHgTRUysAq4	TRUE
XZv4oUEb3RCB4imRRyIb	TRUE
h1VWHSXmtAzPFFi2X2hrP	TRUE
KO4kYTNtnTiQGBXKW3Q	TRUE
SWLsmDRpaQlrxShEYDD	TRUE
r4SBntkClduC	TRUE
rqNCNk	TRUE
M4JPwnj4eYTD3YRefVKYIIIMr	TRUE
IpnpcmSNhcwsaIXt	TRUE
JEZtSwO	TRUE
C1	TRUE
wffXIuLoQPG2UWpwhOvi	TRUE
vAPJEveWlXGe1sD4c	TRUE
hHrJguRYhHE	TRUE
hFMmVvkqdGksOsapWdrESz	TRUE
kBsYZNfbXPK2wuftR	TRUE
C1oEeNKgdNoMlpJnY	TRUE
tNkZlnHyvWRE	TRUE
d	TRUE
Gcynmae3pgjMlOi	TRUE
cSPvQlwoJGarovrV	TRUE
aGLLs	TRUE
1bQCfDqpS	TRUE
2NsdxNDVI2SJ	TRUE
BlNYqsBTyePUXbq2fxu	TRUE
eQ2YLbbnT1saCVdU	FALSE
NqRJUOXa	FALSE
2CejfLa	FALSE
SefSzqJa	FALSE
sbbrl1gLrA2wGNGhQbtT	FALSE
bQrHNkQ4lBMh	FALSE
CBPtYxGrFGa	FALSE
EDtKnWGrZpHCZCZa	FALSE
beuLW2ViXcPaFVlIjMTjE	FALSE
HTopQ24NLo4B1JPIhZTrP3a	FALSE
bupfrcJcWMBiQfA1uTrQdSS	FALSE
YwrqVIuclBUPYaaJJS1NzW	FALSE
bbHcrNfhSqx1R	FALSE
bpYrXSXL4LZq	FALSE
shtpMiwKJBa	FALSE
b	FALSE
lbe4lkTEoJg44Wfa	FALSE
bcRPOFbp2DsEAiScTNnu	FALSE
2DLDjxbbhoc	FALSE
WzFbblrEOZvQmkpgS	FALSE
TGHvBa	FALSE
xMtGQEUTLVaaUBcp1iNNMrue	FALSE
FSPPxNwSYnfaat4uRv	FALSE
GcBPukCiZEfhPbbOmDQm	FALSE
aa	FALSE
bsROO1fFU1CP3QZ1RAkbWtkN	FALSE
RbbxwmcNK	FALSE
YKIPLbb	FALSE
TAIdwVJnBpa	FALSE
bCRuWNkroiOaPm4e	FALSE
bbkHD2	FALSE
OBIoJrqNcdmmOwbNBByJzMma	FALSE
biCBYg	FALSE
b4NuaRGQwI	FALSE
POFcDehEUtRYtFbb	FALSE
bqFoc3I	FALSE
xWOWkwWwQPWepjVWHla	FALSE
bV1IBOKhgTOawpryt	FALSE
Wbb	FALSE
a	FALSE
Yxdhmn3VIZbbHvRZ1TC	FALSE
h1BAibIiA1qzjI4JEoZa	FALSE
buaBeIufgPKLIevLE	FALSE
adUXvGa	FALSE
bxblqMoVK4ST	FALSE
kSMapohGsvQzna	FALSE
bKxQLIOLBUrTZBHv	FALSE
oPqkttSbbAHzPu	FALSE
aaFjNluo	FALSE
UTZjgaaBj	FALSE
bbsMKOwMTqPgz1ohmXJidtrA	FALSE
mJszJ1MkYhSiNaaK	FALSE
bNmLYFxaSEyOQGfT	FALSE
a	FALSE
hPXOetZglezVSXcbla	FALSE
OrzpRRsvEskooSbcRZAxZa	FALSE
Hw1vvbbz	FALSE
O1bTVa	FALSE
BxFMirDSbS4ZtuauU4ea	FALSE
qlPcTjIkYKuefEriwJa	FALSE
b1itlHeZLEbtuAXouyJHZXIV	FALSE
hkrIH2arIuzqYp4lYYsXRa	FALSE
bJNgoqrfpSr4R	FALSE
klCcgyakIP4bRtvgoyLca	FALSE
a	FALSE
GLvDBcJTrIWka	FALSE
HaaEZ2Jyw	FALSE
MvfhHvOPDzXFa	FALSE
bbNqXFTwWL	FALSE
hTbb	FALSE
2FtMFAa	FALSE
bXbg	FALSE
oMEaazZKH	FALSE
vS1HVRM3FaaZmYGT	FALSE
Fzayl2k2nJcgda	FALSE
A4lEmaaGKpsnf	FALSE
b2dGPRZBlGPmk3YkyVNavVK	FALSE
ikftpDnIkmAEITNa	FALSE
aaKe	FALSE
agpNga	FALSE
tsMKIla	FALSE
svSAQQcNtCaazIWrR3A	FALSE
zbhqmVtGwgEizFa	FALSE
yZ3QAfMJRla	FALSE
aa	FALSE
wPqXEXxuMAYWXa	FALSE
dnDywGzCkaqjjbROoDaaFi	FALSE
lIIcaalq	FALSE
bbwf2	FALSE
ZECvliKbf2zzvxa	FALSE
bb	FALSE
OfabbqdX	FALSE
1nJIsa	FALSE
SCaaQEQBFQSMy	FALSE
cJwJSRBHejHa	FALSE
OVP1kLgDIMaarTTpj	FALSE
aaB3U	FALSE
brBCOuomD	FALSE
a	FALSE
QhPVQKnka	FALSE
xq3dP1Kbb	FALSE
dfa	FALSE
hbbU	FALSE
qxLa	FALSE
ObbKvadkI	FALSE
b	FALSE
biKgRQ	FALSE
bJzoyOjrrJ	FALSE
bJQWs1ZfiKtYK3KfZk3Kln2	FALSE
1Zg3DCkSqyFVYzhNl3Ga	FALSE
lakAstGSoYvIibbCJpjyDZkt	FALSE
bbwMBjfAkyCIFcwn	FALSE
bESzhDpmfoPVlgtWPcAtte	FALSE
LhxMdI1WmdbraaNwApGHq	FALSE
TAMuCNjmIohKLaabbK	FALSE
Pe3DXBVKZceaawuUJ34q	FALSE
ihbbxhelWgzxKbQ	FALSE
bQ1bCjcNycOlvXFyFHxWHxB	FALSE
bnBCBGUrsQtMsm1ZbHHdXX1	FALSE
mqwMKbbagm	FALSE
gwZhBGzbbvXMkhd	FALSE
bbd	FALSE
bmreJnCOc3ZBQ	FALSE
b	FALSE
QhnmCqysIJbb3m3qJMmG2	FALSE
3PnDFTTo4a	FALSE
bTeNkhGPna	FALSE
fTEHbbcr	FALSE
a	FALSE
axlquNKEsstZDhqCXhsbbdXB	FALSE
aa	FALSE
3Gcbb	FALSE
bHRTULxJMH41rw	FALSE
bK1nDmB	FALSE
b	FALSE
rbbvOFIRU	FALSE
FXwfIcgSpaxcnw2W4jrrbb	FALSE
brgCNsUTRpvFxRKj	FALSE
akxFTOa	FALSE
1rXjmnXUNrpYbGgLtbbjTI	FALSE
btIKJnB24F3eJN34CdDqp1ha	FALSE
bRwnklDT	FALSE
fdcbbtBKrYUfdxTHcYzux3r	FALSE
bGxtWfuBR	FALSE
bb	FALSE
quaaI	FALSE
bg1MMoji22	FALSE
3odzJQnRRNaaXFTTx3i	FALSE
bKMLUqsQPj3	FALSE
4WlrKD3mbbGE	FALSE
baQq	FALSE
IjsjXaaumLiRXB1	FALSE
yqLWM4tmb3xpb1bjhFha	FALSE
bJin2tw1buvLAwfRdfjhS	FALSE
FpWTa	FALSE
PpaajqMn2CSqQVgCxeKwCO4sy	FALSE
hfmOaauGyATHPYIcYOiaZ	FALSE
MCYTbXJMYaJCa	FALSE
wJOFyAbbnaHicXyrvyS	FALSE
a	FALSE
bEBaESYUppNQckx	FALSE
bbq2	FALSE
bSPbb1v3JjGRY4AayCfm3gpz	FALSE
QMupmoLDRWaaUR	FALSE
ZhaaXGivoLKw	FALSE
pnMmVNRbbmRdv	FALSE
bjCgyQLNLJCsV2	FALSE
aaDBqf	FALSE
b	FALSE
cgkefS3AwOWa	FALSE
KLcrvb1Eibbq4tqXzCtdsxdS	FALSE
aaU	FALSE
zuaaikj	FALSE
lUxPpOcPcxrybbekJyK	FALSE
Zf3KXYQWbbukcJs	FALSE
2bbxZua	FALSE
bb	FALSE
aa	FALSE
WJt1kRWooerBdbb	FALSE
bwCxBqHyrZClzmMwqJHBIC	FALSE
aa	FALSE
bSXtaeH3aBx4jlmxxaID1Rf	FALSE
bGXk	FALSE
XCVbbwl	FALSE
bhjHLSmjRFYO1tDrKBezO	FALSE
B1bb	FALSE
EbLlMHOeaax	FALSE
2NIgUitYpgHiwa	FALSE
b	FALSE
3sxOkQCGclkmYSYIa	FALSE
bLOQbYwzwpDOWsWn	FALSE
KUbbmccHhQYpp	FALSE
ypRCvccKKfUQzR3ChbmbbhpHo	FALSE
UFGQWXkljseTtYLPKGoEa	FALSE
bk2pbj4TAf	FALSE
ODSNtHGVihBPGaaFLkcZRMz	FALSE
bbehtyi1prfJ	FALSE
Psbbp	FALSE
WQTaaF3qfotAwgdOFUiO2	FALSE
bwcgxo	FALSE
tAakVmACOa	FALSE
bxMvOo	FALSE
rgVlAOCa	FALSE
TYKTGainwcvQ1CNmcTDhaaO	FALSE
nKeNfqbi4H4nenaga	FALSE
VydcfRvCUFJlIaUa	FALSE
WkhZwbbJdRecVNAlVehrinpHx	FALSE
bb	FALSE
FN3QaakZH	FALSE
mKWVFaTEqyHXt4YByGoyZua	FALSE
MUmcYUSUOaalxWELeGXQrK	FALSE
bcCqEKFCcWnQHxaVAdg4	FALSE
GF1bbhYDHLtDLzYcr	FALSE
ziLlabbyqs2ZeUp	FALSE
Km1RGDuKMaaD	FALSE
xnewyMaajBQNgC	FALSE
CudlLMCSurcbb3ANF	FALSE
bHMK	FALSE
bni	FALSE
WniqDtbb	FALSE
b	FALSE
bNe4CDtRRWmyNDrgtAEGvjGdG	FALSE
bbg	FALSE
dUMLlmlaehaamflODZphZ	FALSE
BwtrSaaWvTivGBvcrr	FALSE
OY13dWabbIKddE	FALSE
AsVdATOYuK3uMrC2UYdiY3a	FALSE
fAOMMlaa4jJfj	FALSE
gBwRWDHsOwLYhFjMdbbDoRU	FALSE
ZtGelGkzKSitqrKhsrmWCKCa	FALSE
uerZMIqJqiVdu3zPs4oa	FALSE
bfyQhFGWlJWzmuxW	FALSE
jIOcFKMraaWrK4G	FALSE
bb	FALSE
KYoIgvfia	FALSE
CqyOH4dVNJVmBQqpxbb	FALSE
MXmuCw4NeYNpWfMo1a	FALSE
bL1RHShpt2OkIennDjwOMDI	FALSE
M4sa	FALSE
bfGcAFXZYWKr	FALSE
2XeJaa	FALSE
IbOaaec1T	FALSE
HAEudWIqMbbYkqaRTI	FALSE
kNJW1raa	FALSE
raaV2Tvfxpjo2FmJDheA3j	FALSE
MLWB2ItQnFZXESUSa	FALSE
sObbMVScexi	FALSE
kHbb	FALSE
AKWzcTXjrA4mha	FALSE
bhvuClBa	FALSE
btggDjnqFcXJXk	FALSE
MI3HYJ1jnrfViiPZSi2a	FALSE
blRkyzAkoZZkMZCSiWWFrDFNb	FALSE
Xaaq	FALSE
XRe42gXyFGhZBsSya	FALSE
oOXMaBlLEbbuRaNmaj3	FALSE
faaRJVhXiD	FALSE
c2MBa	FALSE
kTOlKBvAoubgESDbYbb	FALSE
bbR	FALSE
bZADIKqGOHve1YPitiJBSsfFs	FALSE
F12V3fSuFXyjaak	FALSE
kbbad2l	FALSE
NiaS1fbbTnVt	FALSE
bY	FALSE
TbC1dbSRwNGnVUCVbwra	FALSE
bHEqjsC3vdIi4ZV	FALSE
bjSpBJdaDYK3SWzcHj3kgmo	FALSE
aaiVV	FALSE
LJz3gSz4caaEoaGPC	FALSE
2JIaafFeQc1EzUaArMns	FALSE
ik4eqLJsccqVWysFlwhAOB4ha	FALSE
hSjMVPqWPaaXG2pr31xKBF2Re	FALSE
iuFaa	FALSE
RkfbbGnl	FALSE
fvIgzyevbbL	FALSE
3Aa	FALSE
gYOJrUbbic2hDXhvEJljq2aM	FALSE
bCaOPz2KAnYYexngqD	FALSE
Uta	FALSE
b	FALSE
phtCLeXFprvTHWtgjmBRKa	FALSE
RxuwTSTgxGEXyKxVxTsCKa	FALSE
DDspmAVwpmpfMTQ1gJibbCSi	FALSE
1ZQTcokrJc3PVbbUZP	FALSE
QNVbb3E	FALSE
HUwvbb	FALSE
qszca	FALSE
qiofRTDZbbV	FALSE
b4VGtNAMFlfNHmFyuB	FALSE
nCPwmRNsa	FALSE
b	FALSE
U4dLrzEeAxbbc3o2QGV	FALSE
1eAuRbbZVfXVJCCkeXt	FALSE
eGmMipAbNdYGcybABvcc3rHa	FALSE
aMbbTbZD	FALSE
uMSw1RBB4FSd4hQgHinneta	FALSE
hpM3bb	FALSE
4jRdemfNnT3fiT3bbRk	FALSE
aaPoeC	FALSE
bbJBEs	FALSE
QUOCDIbbi	FALSE
QMoiJzVF2mzbFCsBQQa	FALSE
aa	FALSE
aa	FALSE
bmAbKUaOKmNKZfyOVxApR	FALSE
Iqlbbj1	FALSE
yzLnnrgdXCCAM3tUaartRYP	FALSE
UTjUaaylU2NRNzA	FALSE
dOdNKNLxaaUcNxkMG4nRE	FALSE
bRnDmjxBmzOmjIkNYpsGsS	FALSE
icjLaPikQSbbLcg	FALSE
yn4bb1o2OWeK	FALSE
bMyiKpFr	FALSE
rFha	FALSE
hThDH2JXzcBjdEaaUHeIT	FALSE
wiaaB	FALSE
MDktKea	FALSE
WeCUE3ggsCQSQHLKGGaaGik2E	FALSE
a	FALSE
PbbwjacqduWDmEYVvPnGHRkpi	FALSE
bb	FALSE
ZZZBpZfOaarIzVxaL	FALSE
Aizylaamekzdm	FALSE
aaOfhgw3IvdPAZBspPps	FALSE
bKSqUEKHCEa	FALSE
kRytTTdEfqa	FALSE
bbFZCmeg	FALSE
aVyRbbgGwR4sbXCiHSl3seeZV	FALSE
qzLSaahpO4UZRr1dZwvag	FALSE
ECCAkyaapdY	FALSE
WOPhpzsfSGw2lbEvfbbqfq	FALSE
hDvtyaalirmg2iSyDwtW	FALSE
b2mQlwhBlctTqaAaQutBYPZq	FALSE
mYAlGYyXNAW2JJFnbbXzWjM	FALSE
v2wZBgXDampfxbbnf	FALSE
bTQye	FALSE
gTvNGNisHYYGZZa	FALSE
arrxDaa1VVMrwaAk3ZW	FALSE
ahzVRuovoIgRGGCnaa	FALSE
kKa	FALSE
vGYJMJHTI1a	FALSE
wWPVrAqx4E3wvnuDbbZC	FALSE
zPWrhgeGPRFlDa	FALSE
zeJteYCqBdacnIlPtGt1MbbKT	FALSE
CLd1ocTvsULzNFUcbbgt	FALSE
IEO3xLeaalxrqFrQU	FALSE
rVgbbphAkRL2lFjTsqUTLMEe	FALSE
bbLlZ3azGp	FALSE
bbf	FALSE
aa4mymep	FALSE
UQbqlJvbxz1UVSSoa	FALSE
lCa	FALSE
bWETOh	FALSE
bLIxBdcZkTvxRA	FALSE
bbsFbTQ	FALSE
bCv22DtsY4u4geg4pEEqcnFG	FALSE
bTSITGetegIkcrbFKiuWTav	FALSE
bzj121Jz3iyWbxLxAfW	FALSE
jaar	FALSE
beJVFODZXIKH	FALSE
2A3atbbCPSz4QWWiSA	FALSE
bbeZW	FALSE
TYgKo2gnZNPnmQOa	FALSE
agnHFa	FALSE
bvpWBWIU4nCtEGR3IVkLiICIN	FALSE
ccXr1wyaalxtoPyj2	FALSE
bStkRbizYFW	FALSE
barKDskFHEBoHPi	FALSE
bgU3xsneApGeiq	FALSE
WOBVmobbbJ	FALSE
bGswdgiwHQNCf	FALSE
eYxzsbb1SCcUu	FALSE
aa	FALSE
odtSnOBaaI	FALSE
RvbbK	FALSE
aaaGe	FALSE
bLPIvrvZxpGfBmB	FALSE
SPufACESErza	FALSE
JaaGCnEZorltD1cu	FALSE
Oamuw2KWbNUbb	FALSE
RbQbbwOJdh	FALSE
biCd4JVSDR	FALSE
rIUbbAPqnmnsLgbgfgGdOsK4	FALSE
aaNyJFFFiqxjYU2yI1Dm	FALSE
xkMukzPWSbSzTmtsmxwwCjAbb	FALSE
aB14xRIt1pxA2xdctLa	FALSE
fgUca	FALSE
hOnHrcdX1a	FALSE
bTm3zAtSCKfyarW1Kl1zU	FALSE
4hZ1LySV4FHH4yd4pa	FALSE
GbbJGXDPgi	FALSE
SRkDbaaU	FALSE
zAqzrJ3mHghSPipNpMb4ma	FALSE
mwNetGiyBwBPDqbb	FALSE
sS3ewoTsPzGSgbRVta	FALSE
b	FALSE
ptcHsyotNbbYvBomxv	FALSE
fMEKqJbbg	FALSE
uNe2H1EwGqepMOoTbbasei	FALSE
Ggx3lnYqMvU1zUT4Q3IN4mcTa	FALSE
a	FALSE
bbl4nBx	FALSE
UTd3wePJHacrcFvna	FALSE
maa2NIJsCrQL	FALSE
SjusOhnPa	FALSE
bQxfNACH2mYrDyBZBW2Nh	FALSE
b	FALSE
Taa	FALSE
OjaaNLChUiKR4	FALSE
bbO	FALSE
bj	FALSE
aavx	FALSE
bhEhZakbPrlXykRGpLYYTKm	FALSE
dtn1bKAfimxAxqRZa	FALSE
thZxTra	FALSE
iJa	FALSE
boHZ	FALSE
lFIQPIFqbbk	FALSE
qOXovmuaagEbMvNteIGzAl3qc	FALSE
sjJLTPSy123pAOiAa	FALSE
CRa	FALSE
PdgZcjF2a	FALSE
WblkpwfFZBbbl4	FALSE
E2u4r3BR4jwdsfqja	FALSE
RUPsPAnDSrbbWBrCVOIVhbZs	FALSE
a	FALSE
bUPWqVkKDzhwKK	FALSE
ibgaNjQMgmpaaHcykATk2x	FALSE
bjgdyTAlmEno3lZKGu	FALSE
bgBuGgBshdx	FALSE
I3ApnBVtQhNyJjFoSa	FALSE
bdRDjJ2HFoawH3geOBjRdRihd	FALSE
bgnb	FALSE
bm	FALSE
bDetGCGctpLQCzhw	FALSE
X4fbyHPQJWhK4lflbbe	FALSE
aa	FALSE
ckFAxCbbHOBSOGg	FALSE
oaa4Ju	FALSE
bIROaaGldCeLkBXdD1MNt	FALSE
jI4gNtoRoGbb	FALSE
OCLOaacvio3	FALSE
bWpcK1gxJnnucfkvQ2	FALSE
vr1vSgZcXybbRsOTetJ	FALSE
bY21TwezkRqtl4	FALSE
ahaa	FALSE
u4aafmtbbopTC2	FALSE
InKqubbbIax	FALSE
ba	FALSE
HfEBa	FALSE
zJbbtrqhTDYbD	FALSE
dnKfXSdBbbpaDuSCTWUaO	FALSE
bRuPbFShsFpXB	FALSE
bqViZ	FALSE
wg2lpaaeomZofSUX1VTaaF	FALSE
bPB3ra	FALSE
qw3LiobbvgBhVSPe	FALSE
NiVbaaJj3lhFn1ZpkW	FALSE
bot	FALSE
bWH	FALSE
E1pERaZRdSbbHDVYlPlXT1uQj	FALSE
ILuXZbb	FALSE
PJIva	FALSE
NaaXhjGDwDafjvLfdSCpDN	FALSE
QbbkLR	FALSE
slbbIGqnKFnNeOXkanKL	FALSE
bQD	FALSE
EKwcPvAvlHadna	FALSE
b3	FALSE
EDWPLcia	FALSE
2Xaa3t3aPIE	FALSE
YtENmfSAuDbb3qQAbAGkFgmtV	FALSE
2UaaJzhGV	FALSE
YUqmSVE2obbDeIC	FALSE
yOfzBxFzdOdCslNsLBa	FALSE
RqixscolQBAGL2MKKa	FALSE
Mva	FALSE
aaUTKNjkz11qg	FALSE
bmOhyWzyLm	FALSE
rqIdGGAVa	FALSE
bKLpmYGmYWHYx	FALSE
bqXMj	FALSE
HhutoaaXkVmy	FALSE
LSSG3qWQeCla	FALSE
3LuShbbu	FALSE
bkxuF4KOZFpT	FALSE
b4vY	FALSE
C1zBpjeWSwVt3aa3Knznyctox	FALSE
waaaJAtyetEpnJ4UZR	FALSE
KxOmfnxbbgTpYRZwEBRKY	FALSE
b1reqejFJSVMGOq	FALSE
mZpVIOlfQhqmtEcgbbxaEr	FALSE
bQQIHSk21YhR	FALSE
FXI1iUa	FALSE
NNaaxixWO4	FALSE
ZONegU4Baa	FALSE
KsF2ZjoYF4NU3GTzqcDa	FALSE
qQsCuzRo2k3VaxFfh4tIHKTa	FALSE
qZSXqJzklOaHCdQPPEXbb	FALSE
