cdcddabcccccccbdd	TRUE
dcdabd	TRUE
dcacdaba	TRUE
cdbbabdcdcbddaabcccabc	TRUE
abcaabddbdaaabcc	TRUE
dcbcdbbacbcbadcbbabbd	TRUE
bacadad	TRUE
cadacbabd	TRUE
abad	TRUE
c	TRUE
dabdccbbaddcdcbddaac	TRUE
bcbddbaadbccdaacadb	TRUE
cbcaaba	TRUE
a	TRUE
a	TRUE
dcdabacaccccacdbbdacbabac	TRUE
dcbadccbbab	TRUE
ccdbdd	TRUE
ddccacb	TRUE
dbdbaaba	TRUE
cdabbbaacaadbadcbdcabbbd	TRUE
bcabbcdabacdadc	TRUE
dcdadcadabcbbdddaabaabccd	TRUE
abc	TRUE
abddaadacddcacbbdaddcccb	TRUE
acccadbaaddddababbcdccb	TRUE
acaddadcdcd	TRUE
acbbdcbccdbaaabcacb	TRUE
abdbddbacbcaba	TRUE
aabab	TRUE
aadccdbbdbdaadcb	TRUE
caacacbbaaadadaabacddc	TRUE
ddbadbaaca	TRUE
cddbbdb	TRUE
abcbacbccaacbba	TRUE
aaddaad	TRUE
b	TRUE
bdabadccbddd	TRUE
abcdcbbdcabbcdab	TRUE
bcbcbbdbbd	TRUE
daacbdccab	TRUE
baabccccbc	TRUE
ddbddadabdbccbcbaaadcda	TRUE
cdaddabadabadd	TRUE
dcabaada	TRUE
bddadca	TRUE
addc	TRUE
dcacbddaddbcdbdbbca	TRUE
caddbdbcccdb	TRUE
d	TRUE
bcabcbccabbccacabadbdad	TRUE
cacdbabadababbcdc	TRUE
abaccdcbbbaacddbbddcbcc	TRUE
adcdadabacdbbabdddcbabdd	TRUE
adbbdadabccccbbbcadbb	TRUE
caabcdadbbdbdbcdacccbcab	TRUE
adabbcdcaa	TRUE
ddcdddcbdcb	TRUE
dababdbdaacdbd	TRUE
bdcddacdcbdaba	TRUE
ccdcabdbcbdcada	TRUE
aadbbccbbddccbbacaabacbba	TRUE
abcba	TRUE
adbabbdbdcadcbcbcbdcb	TRUE
bacdbbbcacacabbbca	TRUE
bcbbbdaddbadabdcdbccb	TRUE
dcacbbdbabbabbcdaacdd	TRUE
bdcbcabcccdcaccadbbadda	TRUE
bdbcdbadbccab	TRUE
ccdddacdcdcddaacdab	TRUE
bdbcdcc	TRUE
bdadacadcbbaacdaaddcdcaba	TRUE
acbddcdb	TRUE
badcaabd	TRUE
ddaadcbbdaaddcadcaca	TRUE
dccaccdbbbcbcadacbc	TRUE
aaacabccaccccb	TRUE
ca	TRUE
a	TRUE
caccbdc	TRUE
aaabcccddccbbcbbdaddaaad	TRUE
cbcddaabbacdbad	TRUE
acbddaabcbb	TRUE
accbbb	TRUE
ccbdaacdbbbdbccabaddc	TRUE
bccacdacbddcd	TRUE
aabdbdacbaa	TRUE
dcdadcbbdcdcaabca	TRUE
bac	TRUE
daabadabababbadd	TRUE
bbabddadadbda	TRUE
dcbdcbbcd	TRUE
acb	TRUE
adbbcdcdbaccbddccbbbddcbb	TRUE
cccbdaacbaaccbaddbcaaacc	TRUE
bbcaabdaca	TRUE
bacaaacaabaabb	TRUE
bdabadcbabbdbabbda	TRUE
acbcadbdbaacdccdcadc	TRUE
badddcdaabbdbcd	TRUE
aaacdbccdacdabcacaa	TRUE
aa	TRUE
aaddcbadbcbbcbad	TRUE
adda	TRUE
bdccab	TRUE
ba	TRUE
ddabbdaccdd	TRUE
cbcabbccaccccbdaac	TRUE
dbabacdaacb	TRUE
dddddabbbdcacacc	TRUE
abbcbbabcdcabbdddd	TRUE
ddcdacdbd	TRUE
ddb	TRUE
dcdacbd	TRUE
adddbcd	TRUE
acbb	TRUE
bdddabacdbcdaadaabdbcbbcb	TRUE
cabcbdaccadd	TRUE
dacacabbacdbabcabcbcdb	TRUE
abccdacacaacaabcbcacdb	TRUE
cdacbcaccacbbcccccbbd	TRUE
ccacbbccc	TRUE
cbb	TRUE
babbdccbacbcbadcabbacddda	TRUE
abdabdaacaadadddccca	TRUE
cbdbaccccdd	TRUE
daaddcdcdaccdabbdcdda	TRUE
dcbccbbcbddabaaabbbc	TRUE
bbcbaaabbdc	TRUE
ddcbabdbcbabdacbbdcbdadc	TRUE
cdcbdbdcdcbccbc	TRUE
dbabacadcadadacacabddbbc	TRUE
cabddccdcdd	TRUE
daaadd	TRUE
d	TRUE
cc	TRUE
bbaadbcabcca	TRUE
dbaddabadd	TRUE
cbbccdcaccaaadabbcda	TRUE
adbcaddbabb	TRUE
cac	TRUE
bddcbacba	TRUE
c	TRUE
dbad	TRUE
bdaacbaacbbcbcdbc	TRUE
ccadaababcdddaabcbbdacdca	TRUE
cbdbbacdb	TRUE
dabbcadaddbbad	TRUE
cdccdbdaddccbdaddaab	TRUE
cccdcdaadddbbabaddddcd	TRUE
cccabdcbadababd	TRUE
bb	TRUE
bad	TRUE
abcbdcadbcdbcbababab	TRUE
ddcddcadbadbadbcaccaad	TRUE
ccdcdddbdcb	TRUE
bdaadabddcacdcdadabcddbc	TRUE
cdababbbaadbccadcda	TRUE
bcbcdbdacdac	TRUE
bdccacdaaccacdbcbccabdb	TRUE
daddbbccba	TRUE
daabbababaab	TRUE
ccdacabdcb	TRUE
acdaba	TRUE
badadbdccbc	TRUE
bcadcaadcdcadac	TRUE
dbbdbbb	TRUE
bb	TRUE
da	TRUE
daabccdbdddbbcddbcdadabbb	TRUE
dcbaccccaaaccabaadbdccb	TRUE
baabbccdcacadabbdba	TRUE
ccbadcbaabdcdaddbbaadbbcb	TRUE
cdaddbccababd	TRUE
bdcdcdc	TRUE
bbdccabccbccabddbccacdba	TRUE
abcdbdcadcbbcd	TRUE
aadbaaddcdb	TRUE
dcdacc	TRUE
dcbddaaccb	TRUE
aacdacac	TRUE
dadcbacc	TRUE
cabddbcbadadcdabccadddbc	TRUE
cbaabab	TRUE
cccdcbdaac	TRUE
dcabadb	TRUE
dbc	TRUE
dbbadadaba	TRUE
daaccbbabc	TRUE
dcaabccacccdbbbcc	TRUE
acacadbcbccdcdadacbad	TRUE
acccaccdbacddaddb	TRUE
cabaccabcaccc	TRUE
cadcdcad	TRUE
cbbdbbdabddaacddaa	TRUE
ca	TRUE
da	TRUE
abacdcaadccbbac	TRUE
dcaacabbbdac	TRUE
dabbca	TRUE
cdaaabbdaabadcc	TRUE
ac	TRUE
addcccbabdbdd	TRUE
bcabbdaadacdaabdbcdc	TRUE
ddbddcddbdbcccabaaaca	TRUE
bbddcaabbbaab	TRUE
bdbbcabdbac	TRUE
ddbdacdaddbbddabbbaccd	TRUE
cddccbacdadbcdbadaba	TRUE
acd	TRUE
aaccaacacdacbcadbaada	TRUE
c	TRUE
cabda	TRUE
abacdbabcdabba	TRUE
cabdddaccdbbacd	TRUE
bdbacbcdaaddcaabdacddddb	TRUE
cc	TRUE
cdccacdabbdacaadb	TRUE
bdabdcccbadbdbdaabbcbad	TRUE
acdacdabc	TRUE
acbdcabdbbcab	TRUE
cccbbccacccd	TRUE
abdbca	TRUE
b	TRUE
abdabccdabcabcdacdbab	TRUE
cccbabdabaaada	TRUE
cccda	TRUE
cbadbdacbbbd	TRUE
cabcacbbbdaaadbdcdbdabdc	TRUE
bacddcadcdbccaaacacdaddac	TRUE
caacacdacdaaddaaaccdcbad	TRUE
cccbbdcbcccbd	TRUE
accbbddbbdaabcba	TRUE
badadbbaddcaddccdbac	TRUE
bcaaacd	TRUE
aaabbd	TRUE
cdbca	TRUE
badda	TRUE
cbddacdacaac	TRUE
dccbababcccaaadcabddcd	TRUE
ccdcbdcccaaaddbddbdda	TRUE
dcbcbdcbacdddbcabaad	TRUE
abacbdabddccbadcdaabdcbc	TRUE
ddaadacdddbdbaccadbbca	TRUE
addb	TRUE
d	TRUE
baabdcdbaadbdbbddab	TRUE
addd	TRUE
acaabbddccaadbadaccad	TRUE
bddacaacddbbdcbdcaacdba	TRUE
daacabad	TRUE
ddadbbabaaadddbbac	TRUE
cadc	TRUE
cdd	TRUE
dccddaacaa	TRUE
bcdcbbbcccca	TRUE
cdccc	TRUE
dbbddaddbadcabddccbaadd	TRUE
dddc	TRUE
a	TRUE
b	TRUE
dccbdbdacaa	TRUE
ccc	TRUE
cbbabbdacd	TRUE
bcbdbbdbbcacbadacdc	TRUE
adabdadcbddcadadccb	TRUE
cdcb	TRUE
cdadabdcccdca	TRUE
abacdadadccdbbad	TRUE
abbdcacaadbc	TRUE
aadbcbdd	TRUE
acdbaaccdddbabbcbd	TRUE
dcca	TRUE
daaadccdabbdcbcc	TRUE
bcdadcbacddddbaca	TRUE
bacadbacdcccbabcccbba	TRUE
bbdbbdbcdbdacab	TRUE
ddcbbacbbabadbdcdbdcdd	TRUE
bbadcaadb	TRUE
acccbdbaadcadcbdaad	TRUE
abdcacbbaddbcadaba	TRUE
dbdbccbccbaabdbbadcc	TRUE
cdcabccbbacbabab	TRUE
cdbdcbddbc	TRUE
cbdaccccadabbcaabdb	TRUE
dccacbacbbddadabcacbccc	TRUE
cababacddddb	TRUE
bccdbcddbbadabcd	TRUE
dbb	TRUE
cca	TRUE
babcdcabbaaabcccbaacccadc	TRUE
adadadadcdabdbdd	TRUE
dbbccdddc	TRUE
ad	TRUE
dcddddddbabbddac	TRUE
cad	TRUE
adbc	TRUE
dbcbbcb	TRUE
ddbabaadbaacdbcbb	TRUE
addcbc	TRUE
dddddccbcdadabccaa	TRUE
bbacbdcabdcbacccadbdb	TRUE
ddccdd	TRUE
babccabcddcdbdcbbaaabcb	TRUE
cddbddacdddcbcccba	TRUE
babddbaccdcccaacad	TRUE
bba	TRUE
bcbcdbdcbdbcdadb	TRUE
accaddbcdcccdddcdb	TRUE
acbcdaaddbaddd	TRUE
ddcbbaab	TRUE
abaabacbc	TRUE
aaaddc	TRUE
acbdbaccaccbccbccbcccbc	TRUE
c	TRUE
bd	TRUE
dbbbcadbb	TRUE
abdbcccbcbaabadbbbcb	TRUE
adabdaacaccbcddcacbccdd	TRUE
dc	TRUE
adbaabaabbdd	TRUE
dbbdddcadadbb	TRUE
aabaaacaabadadadcbaaadcdb	TRUE
cb	TRUE
caacbaddadbaaaddbddbbc	TRUE
baccaabdacbabbacbc	TRUE
db	TRUE
abccaadaacdaddc	TRUE
caaddcbcddbadabbbc	TRUE
babcabacdaaabdd	TRUE
dbbcbddaaadcdcdbccdaa	TRUE
cbd	TRUE
adbbddbdbcddc	TRUE
cabdcddddbcdcadddcc	TRUE
bbadddcbda	TRUE
adcddcdb	TRUE
abdaccdddacbacc	TRUE
dbadcd	TRUE
adacdbaabcaabbbdd	TRUE
c	TRUE
addbdbb	TRUE
cdddcaabcaacdda	TRUE
bddbca	TRUE
bbddacbdd	TRUE
cdabadcdaacacdbdd	TRUE
addcbbbaaccbdb	TRUE
dbbcbadda	TRUE
bbddbbaddabdbcbdaac	TRUE
cacbc	TRUE
adadcacab	TRUE
bbad	TRUE
ddbbababdaaabccbcadac	TRUE
dbaddbdc	TRUE
cbdcabccbbaaaccaab	TRUE
ddcbcdadccabaddcadaddcaba	TRUE
dacdbc	TRUE
ddcdcdccaaddad	TRUE
dbac	TRUE
badbccd	TRUE
cbccc	TRUE
dcaadcadd	TRUE
addbdcdaccacdcccdaababdb	TRUE
bbdabcbdbdcaaddcddc	TRUE
bccabbdbddbdcaabacbcd	TRUE
dccdbcabbcbdabdbddab	TRUE
dbadcbcdacdcdaa	TRUE
cbbdaacabbdbcbcdacbcca	TRUE
bacad	TRUE
addaba	TRUE
bcaacdaccaadbcdd	TRUE
aacd	TRUE
cdcabacdadddacbccacaccdb	TRUE
bbcabbcaabdccbdbaccaac	TRUE
ddbcbaabd	TRUE
adbdcdccbbbaaabab	TRUE
b	TRUE
daaddcbdcdcdbadaacdadbc	TRUE
aacbaddbd	TRUE
bbcadbbabaaacd	TRUE
cbbdabcadcdaaadcabc	TRUE
cbabdbccbadd	TRUE
cddacbabdcbbdbddadc	TRUE
dadaa	TRUE
ccabacbabbd	TRUE
acacc	TRUE
cbacad	TRUE
dcdbdabaacdda	TRUE
ddccaaabda	TRUE
badabaca	TRUE
bcadccdaddabdc	TRUE
d	TRUE
aadcdcbcdcbdaaabdbac	TRUE
cbbcbadccbaabadbdccb	TRUE
cd	TRUE
caadcaaaccdcccabdddbabcdc	TRUE
abbcadcbbacccd	TRUE
bcdcd	TRUE
dadaccbbd	TRUE
ccbdc	TRUE
aaddadcbcddcdadcbddcddbcb	TRUE
cacdcbccbd	TRUE
dcadccabcbb	TRUE
bccddabdddcaacd	TRUE
ccb	TRUE
dddaccabbdaad	TRUE
d	TRUE
bbdbadbbbddaa	TRUE
bcacc	TRUE
dcabbacddcbdbbdcbbacbc	TRUE
ddddacdd	TRUE
dacbdccbbccdcdbbccabca	TRUE
abcaadcbdc	TRUE
dddbcdbdcdbbcdcc	TRUE
aadcccaabdbcdcdaccaaddbbb	TRUE
cddacbabcbadcacc	TRUE
bdda	TRUE
acaddda	TRUE
dcacbccbadbaadcbbc	TRUE
caaccdabccbdddb	TRUE
abda	TRUE
ba	TRUE
aaabaabddaacbaacdcbbcdddd	TRUE
cbdabaabbbdaac	TRUE
dcbdbcbbcadd	TRUE
cbcc	TRUE
ccadbcdbcaadbaaba	TRUE
bcaacccb	TRUE
adbddacbbadbddacabdbb	TRUE
aaacabdabdaaabdc	TRUE
acacbbd	TRUE
cdbaccccddadd	TRUE
ccddddabccd	TRUE
ddabaccbcadddadccadaadc	TRUE
cbabadcabdbbbddbb	TRUE
babaddabdddadcbcb	TRUE
bdcacdccdcdcbbaaad	TRUE
bbdbddcdbdbbbcdabcad	TRUE
abacddaabdaadbadb	TRUE
cbbadcccccbbaacbcdbdbcd	TRUE
acabcaabdddda	TRUE
cccbcbdcacaccbccb	TRUE
cdabdbdbc	TRUE
accaa	TRUE
dccbdb	TRUE
ada	TRUE
babdbddaadcdac	TRUE
acbaacbba	TRUE
dccddcccdabdcabbcdadbca	TRUE
acdbaccacddcd	TRUE
d	TRUE
bdccadddcccddc	TRUE
dcbbdcdaaabcadccadb	TRUE
dddaccadbddbcdaccd	TRUE
adadccdcbadcbcdbacdcbd	TRUE
aacdbacbadcddbaa	TRUE
cddbcaadcbadddacabddbdcdb	TRUE
bcddcdaa	TRUE
bcb	TRUE
bbddbcdacadcb	TRUE
daddabacabdacbcba	TRUE
cbdbdcacabdabddc	TRUE
daabbbddbdab	TRUE
cd	TRUE
bdbdcbacacdbbaacdbabcaadb	TRUE
cabcdbbbccdbabdcbddbdb	TRUE
cbbaa	TRUE
dcdacdabbddccbcaaccacd	TRUE
cdadb	TRUE
cc	TRUE
aabdbaccccddbbabacdccbc	TRUE
ddaccacacbbcdbccbcacba	TRUE
dadbcadcdbacccbbcbbc	TRUE
baabacabdacacdcbbb	TRUE
ddbc	TRUE
cadbcccaacccdbd	TRUE
dcbcddad	TRUE
cdbdaddbccbcbabac	TRUE
ddc	TRUE
ccbac	TRUE
bcdbabaabdbddbdaaddcaa	TRUE
dadbdacdcabb	TRUE
ddbcadccaccab	TRUE
adabbacb	TRUE
cdacacabdacb	TRUE
bdbbbcadcdacdcccdbddbbac	TRUE
bccaadabaaca	TRUE
ccbcadadaadbadabdcc	TRUE
bdbb	TRUE
dcdabadbbcadbcdcdcccccc	TRUE
daacba	TRUE
bbdbcbbcaacaba	TRUE
dbcaccbdcaaccccdcdcddada	TRUE
bcbca	TRUE
baddcabdbac	TRUE
accacabbdabaccaca	TRUE
badcacddbacdacccbd	TRUE
ccbbaaad	TRUE
bacbadadabadbbcddbdc	TRUE
c	TRUE
ccdbdbabbdbadbabacdaaccb	TRUE
bbbaaa	FALSE
bbb	FALSE
dcccccaccaaa	FALSE
aaa	FALSE
bbbadcbdbdcbacbccccbd	FALSE
bdabdbcddcdbcddaaaacbda	FALSE
bbbbcaba	FALSE
badccdababbbbccdb	FALSE
bbbb	FALSE
adaaa	FALSE
bbbbbda	FALSE
aaa	FALSE
acdaddbcdcacbcbbdacdacaaa	FALSE
addaacabaaaaaa	FALSE
bbbccbcbbdcd	FALSE
dbdadacbaaa	FALSE
dacabadbdddcabcaabbbbcc	FALSE
bbbdbc	FALSE
ccdabbcaaaaa	FALSE
cacbddcbcdbababcbbbbddcb	FALSE
dacacdabcbcabbbbdaaa	FALSE
bbbdbacaddbb	FALSE
aaa	FALSE
aaa	FALSE
bbbbbb	FALSE
ccbaaaac	FALSE
accaaaaacda	FALSE
bbbbcacc	FALSE
dbbbbac	FALSE
abccabbccadbaaacdcaaaaaa	FALSE
abbbbc	FALSE
aaa	FALSE
bbbaaaacaadaacccacadaa	FALSE
caaaacabb	FALSE
bbbaaacdcb	FALSE
bbbdcbacbcb	FALSE
babbbbdad	FALSE
cbbcbbabbbdaaacdaaaa	FALSE
aaa	FALSE
dbccbbbbcd	FALSE
ddcbbbb	FALSE
cdbbdddbbacaaa	FALSE
ddbdcadccadbabaaaaaabca	FALSE
acddcbdbadccbaccbccadbaaa	FALSE
bbbbad	FALSE
aaaa	FALSE
acdbadaaaacdabccacd	FALSE
abbbbcccdddc	FALSE
ddbbbbbddcbbdbbd	FALSE
ddccdbdbdcbbdaaaaacad	FALSE
bbb	FALSE
bbbda	FALSE
bbb	FALSE
daaa	FALSE
acabbaaaabba	FALSE
bbbdadccddadacbc	FALSE
bbb	FALSE
abdcaccdbdbcccccbcbdaaa	FALSE
bbbbdbaaad	FALSE
bbbbbc	FALSE
bbbdbbdcbbbbcbaabdc	FALSE
acaacaadbbbacbdcaaaaabca	FALSE
badaaaabbbaca	FALSE
aabbaaaaaabaa	FALSE
bbbac	FALSE
cbbaaaaa	FALSE
bbba	FALSE
aaa	FALSE
ddbcdcbaccdccbccacacdbaaa	FALSE
dadbdbbbbdbcaba	FALSE
dcbcdaddcaaa	FALSE
dbacbacacdcdacacaaa	FALSE
caabcbbdcadacccdcaaa	FALSE
aadaaaabcd	FALSE
bbbbacdadbb	FALSE
dcdcdcdbbbbddcbcbdd	FALSE
bbbbbbbccbdacbdaa	FALSE
abddbbabcbbcacdaddacabbbb	FALSE
baadcdbdaaddbbbbdacab	FALSE
aaa	FALSE
aabbbbbbcabdadcdbbcdc	FALSE
bbbbabcdbbbdbccdbbabacba	FALSE
addcbaaaaccdbcdac	FALSE
bbbdbaddcbaaabbadcaacdbcb	FALSE
bbbadcbacabcbbd	FALSE
aaa	FALSE
aaa	FALSE
bbbaaacaccd	FALSE
ccabcbcaaaadbc	FALSE
bddbddcbaabbbb	FALSE
aaa	FALSE
dbcbdbaadaabaabaaaaa	FALSE
ccabcabbbbb	FALSE
baaaa	FALSE
abaccdbbbbbacadabbabb	FALSE
bbb	FALSE
cacdddadcaaaa	FALSE
aaaa	FALSE
bccbcbaaaa	FALSE
bbbcbcdbccccaaaabcadab	FALSE
bbbbbdacdbbadacbdccdacdc	FALSE
bddbbbbbbbabcccdaad	FALSE
daaaacbbbd	FALSE
ddcabcadddbbbbbc	FALSE
aaaa	FALSE
bbbcacdacdadacab	FALSE
dcaaaaabcabdbdbbaba	FALSE
bbba	FALSE
aabbbbadbac	FALSE
acadcccabcbaaa	FALSE
bbaccbddbdcacabbbbdcbd	FALSE
bbcdabaaaaacbdabcacc	FALSE
dcbbababbbbcdd	FALSE
ddaacddcbcaabbdbaaaaaadbd	FALSE
bbbbbbdbadcdcabbba	FALSE
dcabbbb	FALSE
bbbccccacbb	FALSE
bbbbaddcddcbbadcddddac	FALSE
acbaccddbacdddcaaa	FALSE
daaa	FALSE
bbcadbbdbaaccaaa	FALSE
bdbdaaa	FALSE
bbbbacccadddbaac	FALSE
bbbcbcaaaaddcaaccdbbacd	FALSE
badabaadccadcccaaaacd	FALSE
bbbccbdccdcbcad	FALSE
bbb	FALSE
bbbbbcddd	FALSE
aadcaaaadcadacaab	FALSE
ddadbbbbcaababc	FALSE
acacbdbdaadcdaacabbbbacd	FALSE
aaa	FALSE
dabdbdbaadddbbbbbc	FALSE
bcdbbbb	FALSE
ddaaaaaaadbaabccdabddcb	FALSE
cdaaaab	FALSE
bbbdcccbdbcacdcdac	FALSE
dacbdaaaaabddddccaddadba	FALSE
cdabadacaaaadadacacdd	FALSE
bbbbcbdbdbdb	FALSE
bbbbadadcd	FALSE
bdacdbddbcaaa	FALSE
bbb	FALSE
bbbccaabaacdaacacbd	FALSE
aaaaad	FALSE
bddaadccbbbbbaacd	FALSE
bbbabbdaba	FALSE
dadadcbcbdaaa	FALSE
aaa	FALSE
bdbbbbdbcbacacadaacadad	FALSE
cbbdcaabbbbadd	FALSE
bdcaabadaaaa	FALSE
bbb	FALSE
bbbdddabbdddbdbabd	FALSE
daacacdaaaaa	FALSE
adbaccaaaacc	FALSE
cbbddaadbaaa	FALSE
bbbc	FALSE
daaccacbabcdcccaaaa	FALSE
baaaabcabcdcbcb	FALSE
abbbbccbdccdabacdba	FALSE
aaa	FALSE
aaaa	FALSE
bcaaaadcaadbdccaaddd	FALSE
aadbcdbacbbbaaaacccdabb	FALSE
daaaadccbcabdbdac	FALSE
dadadabbbbcacc	FALSE
ddbabcaacaaa	FALSE
bcacbbccaaaadbcbbdaabaa	FALSE
bbbcda	FALSE
abacddbbbbdd	FALSE
bccaddcdcaaa	FALSE
bbbddcadbdcdcbbdada	FALSE
bdaccaaccaccbaaaa	FALSE
dccababcabcdbbaaaa	FALSE
cdbacbdbaaaaaaadbabbdc	FALSE
daaaaa	FALSE
bbbabcadbabdaaca	FALSE
aaa	FALSE
accccacccbcccdaaa	FALSE
bbbbdaacccbbbbbdbdadcabac	FALSE
cabaabcdbbbbbbdaa	FALSE
bbbbcbccbcddbdaaba	FALSE
cbcdaaaa	FALSE
dcbbbbdcdbbdac	FALSE
aaa	FALSE
bbb	FALSE
cabcbbacbbbbcccaaaa	FALSE
ddccdddbbaaaadcbcbddd	FALSE
cbcaaaa	FALSE
adaaaa	FALSE
babbdcaaaa	FALSE
cdbacbaabbbbcbad	FALSE
bbbabababa	FALSE
aabbaadddcdaaa	FALSE
bbbbabbbcaaaaddaadcaaadb	FALSE
bbbdabbccaabacaaad	FALSE
dcbcdcadaaccccbbdbaaa	FALSE
ddcaaaabc	FALSE
bbb	FALSE
bcababaaddaabcaaaa	FALSE
ccaaadabaaaab	FALSE
dcaabbddbbbbbddb	FALSE
bbcdbbbbdccdd	FALSE
bbbc	FALSE
bbb	FALSE
ddbcdadacaabaadacbadccaaa	FALSE
bbbbbdabcbaadccdbcbcab	FALSE
bbbbaba	FALSE
dabbbbdbabdabbbbaaa	FALSE
bbbccacddaacdacdcadaca	FALSE
dbaaa	FALSE
cbcacccaccccbddacaaaab	FALSE
adbbacccdcaaa	FALSE
bbb	FALSE
dbbaaaa	FALSE
bbbb	FALSE
bcbbbbba	FALSE
bbbacbdcdcbabaabc	FALSE
aaaab	FALSE
ddaaaab	FALSE
abdbaacaaa	FALSE
aaaacdca	FALSE
bbbcacadbc	FALSE
ddbdaddabbbbaddbcbcacabd	FALSE
bbb	FALSE
baacccbddaacbbbbaccc	FALSE
abcbbaaa	FALSE
bccdbabcabdbbbbbcccacb	FALSE
bbbaadd	FALSE
abaadadabcadcbdaaaa	FALSE
bbbaccdaadaaaba	FALSE
bbbaccdbbdcdcbd	FALSE
aaddcdacacdbbbaabbddbaaa	FALSE
bababdbbbbd	FALSE
abaadbbbbdacccbdaad	FALSE
bbaaaacb	FALSE
bcdadaaaaaaccbb	FALSE
bbbadaccbbdacdcc	FALSE
bbbcbbdacabcccaddbddddaaa	FALSE
bbbbacbbada	FALSE
cbbbbd	FALSE
bbbdcbacdaddc	FALSE
aaa	FALSE
cdbbaaaaddbadbbbcdaaaa	FALSE
bbb	FALSE
bbbdbbadbcbbacccd	FALSE
cadbccaaaaa	FALSE
caaaaabbcbcaddadcdd	FALSE
bbbbbd	FALSE
ddcbbdcaaa	FALSE
adacddcdcbadabbbbcbabbcbb	FALSE
bbb	FALSE
bbbcabbdddcaaaaddcabccbc	FALSE
dcbbbbc	FALSE
bbbbbaddaadbcbdaaac	FALSE
bbbdcccadbacbacdcbbdad	FALSE
bbbdadcad	FALSE
aabaacdbacdbccadaaa	FALSE
bbbaddcbbbb	FALSE
aaa	FALSE
aadddbdbaaaaabddbcbdad	FALSE
ddbbbabbcdbccacbcacbaaa	FALSE
aaaaa	FALSE
bbbaacccddbbdbcba	FALSE
aaa	FALSE
dacccccdabbaaa	FALSE
cbaacbbbbbaabdddbdaccad	FALSE
cccaddbdaaaaaaacab	FALSE
ddbcdddabdacdaaaa	FALSE
addcabcaccccddbababbaaaa	FALSE
bbbacd	FALSE
bddabbbbc	FALSE
aaa	FALSE
dcbdadccabbbbddbdaca	FALSE
bbbdaa	FALSE
bbbdcbab	FALSE
bbbbabda	FALSE
bbddabbdcbccbabbadaaaaa	FALSE
dbaacaaaccaacbabdddcaaaa	FALSE
bbbabdc	FALSE
adcddacddddacacdacbaaa	FALSE
aaa	FALSE
dcbbbbbacabbabcca	FALSE
bbb	FALSE
caaa	FALSE
adaaa	FALSE
bbbdaaaadaab	FALSE
aaaabdc	FALSE
bbbbabbccdcacbadccbdc	FALSE
bbbdaddcbdac	FALSE
aaa	FALSE
cbbddcacdbbbbbbcabab	FALSE
bbbdbbbdbcbcddcdaacadbac	FALSE
bbbabbcddbacdddd	FALSE
cbbaaaacdcb	FALSE
aaaacdabda	FALSE
aaaaaa	FALSE
aaa	FALSE
aaa	FALSE
bdbbbbaccaccdbdaabda	FALSE
bbbbabccd	FALSE
babdabcaccbdaaaa	FALSE
bbacbbbbcdbcacabcccdbda	FALSE
bbb	FALSE
bbaaaabbbababccb	FALSE
aaccbbabadbbaacddcabdaaaa	FALSE
dcdbcbcbbbbbbd	FALSE
abcbbaaa	FALSE
bbb	FALSE
aaaa	FALSE
bdcbbbbb	FALSE
cdcbadbaabaaaaababbaaba	FALSE
bbbcbbdbdddab	FALSE
bbbccacbbdccabdcbb	FALSE
cbcbdbbcbdabcdcbaabaaaa	FALSE
bbaaaa	FALSE
aaaa	FALSE
badabcaaa	FALSE
aaaabdaaacbddbbbcaddc	FALSE
bbdcbaabddccdaaaaa	FALSE
bbbbdcacadccbab	FALSE
bbbdccbbbbccabca	FALSE
aaaadaababbaba	FALSE
bbbacdbcbabaaab	FALSE
cadbaaaaadabac	FALSE
dbadaadbcabaaaab	FALSE
abcaabdcaaaadc	FALSE
aaa	FALSE
bbacaddbaaaa	FALSE
bbbdacacabaadaacd	FALSE
bcbddbbbb	FALSE
aaa	FALSE
bbbdaddbadcad	FALSE
bbb	FALSE
ddccbcaaaaa	FALSE
aaa	FALSE
bbbcbabcadbb	FALSE
bbbbd	FALSE
aaaadccddc	FALSE
aaaacdc	FALSE
aaccabaaaaacabbbccaddbba	FALSE
cbdccdaaaaabaddacbbddba	FALSE
bbacbbbb	FALSE
bbbcd	FALSE
ddbdbaaaaccbacdabccd	FALSE
caabaaaaaabddcaba	FALSE
dcadabdababbdaccabcbccaaa	FALSE
dbaaaaaadddcb	FALSE
bbbcc	FALSE
bbbbdb	FALSE
aaaacbcbb	FALSE
ccbbcaaaacd	FALSE
bdcadabbbaadaabaaa	FALSE
bbbaddcadbacbbbabcd	FALSE
dbbbbca	FALSE
bbb	FALSE
bcbbbbaaadacdbacb	FALSE
caaaacbaac	FALSE
dbaadadcbbcccdbbbaaaa	FALSE
dcccdaaaa	FALSE
ddbbbbadacbcbd	FALSE
bbbca	FALSE
abdadccdbabcdcccddaaa	FALSE
aaa	FALSE
bbbbb	FALSE
bbbabddbd	FALSE
bbbbbdbdacaba	FALSE
bcccaaaabddaccadbbbbddbdc	FALSE
aaa	FALSE
bbbb	FALSE
cdcccadabacdbaaa	FALSE
adbcdaacbadaaaaaaa	FALSE
aaa	FALSE
adbaccabaaaaacccaadccdc	FALSE
bbbdddcbbbcdc	FALSE
bbb	FALSE
bbbaddcdbcbcdddadbbba	FALSE
cbddcbdcdaaaa	FALSE
ddcddcacaaaaaabaacb	FALSE
cacdddbccbdbcddbdadddaaa	FALSE
bbbbca	FALSE
bbbccaac	FALSE
bddacbdbbcdcaccdbaaccaaa	FALSE
aaa	FALSE
bbb	FALSE
accaccbbabcdcdddcdaaa	FALSE
acdbbbbcadacccadbccb	FALSE
aaaaa	FALSE
dbddacdcaaa	FALSE
bbdccdadccbdaaa	FALSE
bbbbdaab	FALSE
bbbccdcbbaddcdcbdcdcc	FALSE
bacbbbbbbaaaacaddb	FALSE
bcadadaaa	FALSE
baaaabdbdba	FALSE
cccaaaaabdacdbacdcabc	FALSE
cdcdbdddabadaaa	FALSE
bbbaaddbb	FALSE
bbbbaadbac	FALSE
abbbbbadaabaddcaab	FALSE
dcaaa	FALSE
cbbbbcbbabcdcdcbccdb	FALSE
cbbbbab	FALSE
acaddbbbbbdcdccbc	FALSE
bbdbbaacabbaaa	FALSE
bbbbcddbcdacbcc	FALSE
bbbdc	FALSE
ddbbadddaaa	FALSE
abbaabddddbbbcbbbbccddd	FALSE
bacaccaaccabcdcbccdadaaa	FALSE
dccdcaaaaa	FALSE
bbbdcabccdcbdcbaac	FALSE
dbdaadbddbbbbc	FALSE
bbbcabcdccabaaccda	FALSE
bbb	FALSE
dbaaa	FALSE
caaa	FALSE
bbbcdcdadcdbdbadbcbbdbccd	FALSE
dbbbb	FALSE
aabdadaccbbbdabbdcaaaa	FALSE
bbb	FALSE
bbbcbabacabbaaccdacba	FALSE
bbbabbaddaaaacc	FALSE
bbbccdccbcaccbbbbbdc	FALSE
bbb	FALSE
bbabadaadddcabcdcbbaaa	FALSE
bccabacaaaaadad	FALSE
cddaaaaaa	FALSE
daaaadccbccaabcaaba	FALSE
bbbcdabaabdacdcbdccdad	FALSE
cacaaa	FALSE
aaaabaaadcaacabd	FALSE
bbbcadadbabcabdba	FALSE
aaaaadadbdccaccbdccb	FALSE
bbb	FALSE
bbbadbbcbcabdbc	FALSE
daaaaaabccddb	FALSE
cdccacbaaa	FALSE
aaaaadcadacbabaacbacdc	FALSE
bddbbbbbaaa	FALSE
caaaaaacb	FALSE
cbaaa	FALSE
dcdcaacdaaaaadddbbbabca	FALSE
dbaaadbbbcaacaadbbbbdb	FALSE
bbbdbaaa	FALSE
aabacdabdcadacbaaccaaa	FALSE
cdacaaaccacddadcdaaaa	FALSE
dbbbcbccadcbaaaaa	FALSE
bbbbd	FALSE
bddabbaaa	FALSE
dcddcaaa	FALSE
babadadacdaaaabcbcaaaaad	FALSE
dcbaddbaccaaaacccabd	FALSE
bdaaaa	FALSE
abadaaaaaccdd	FALSE
adcaccccaaaaa	FALSE
aacacaaaa	FALSE
babbdbcadaaaabab	FALSE
bbbcccabcbadadddbdaadbdba	FALSE
aaaaaabbc	FALSE
bbbbbcba	FALSE
bbb	FALSE
cabdbdbcdbdabcbadaaa	FALSE
bbbadbcabddac	FALSE
aadccbcdcdaaaaccaa	FALSE
abdaaaa	FALSE
acaaaaa	FALSE
dcadabadaccdcadacaaa	FALSE
adccccbdcabbbbcd	FALSE
bbbbbcadbbadb	FALSE
caabacadbcaaabbbbaaa	FALSE
dbbbbbbbddc	FALSE
bdddcbabcbabbbbddbbbd	FALSE
cbbbbbbbbbaccddcdcdcabdcc	FALSE
bbbabaaaadbdbaa	FALSE
cdaddbddcdaaaa	FALSE
aaaa	FALSE
bbbacadbccbc	FALSE
babcbacbbbbdddaaaadbcacbc	FALSE
dabdddcaddacbdcddacbbbbab	FALSE
bacdbbacaddbabaaacdcddaaa	FALSE
bbbbbbcaadbadabbbbdcdcada	FALSE
bbbdcdbacaacbab	FALSE
bbbb	FALSE
aaaabcda	FALSE
bbbadaabdcbcbba	FALSE
bbbbaccdbadcddbaadaacddd	FALSE
bbaaaaaaccdaaaad	FALSE
caaaabbbaccddacbab	FALSE
abddaaacbdaaaaabacbdba	FALSE
bbb	FALSE
babbbbdacd	FALSE
baaaabaacbdcbc	FALSE
bbbdddcdddabacb	FALSE
aaa	FALSE
bbbdddabbcdcaaadbaad	FALSE
bcbdbbcddddaadabbbbcbac	FALSE
dbcacbaaa	FALSE
bbbb	FALSE
