§¤é§®¬Û	TRUE
ÄTÂLfXÜÂ	TRUE
ltV¬BoQÚÑ²R±VÙxµ94¶	TRUE
dÇë±¹k	TRUE
º·Ó´é9i³£Så7Ì´eT¯9æ	TRUE
ÅEçu÷FÁE³ñãU8Í­älH«ëj	TRUE
NrØësZÙr³í2ïu¹f¯HÆÑA¦I	TRUE
V74Äøè¹¬ôñGt×­C	TRUE
È®	TRUE
Ö8ÎygXØÑÃ´eBB4¨á	TRUE
k°½ÆÂÈ7ìjm®24M÷MLÐÉËMá¦w	TRUE
ªD¢	TRUE
ÕsÀçe§n¸íAñÒ³	TRUE
ã®Â6fv3§ÃÊjK±jlvÉyÕøì	TRUE
ÑRïí	TRUE
÷Aßxø¦7¿U1AÄ	TRUE
w	TRUE
ÝÌÊv¯ÅãÆWÚod÷Ùq	TRUE
loHç¡Á8T¢n»ð	TRUE
VùUkªP29º¦Ìõ±óómêZÍ6eÙ	TRUE
X¿ÖW	TRUE
JyTÌ·lWÏAç	TRUE
×ã4N2ònç5ó°Øh	TRUE
Ì¼PÚObfr5¥ÐíOO	TRUE
EIËFr	TRUE
xHn¬TÞ	TRUE
§»¿ÁABcæSÍldø×HÓ3c¹	TRUE
¡3¯qrÚ³cöÑT¡§¼âPióp9¾p	TRUE
KÈ¡ùÇÇ	TRUE
Øa­EÃvì§Jël±t´ÌÔcqx	TRUE
iÐëè¾Æñ9	TRUE
öÌÅãazz§di²ÅfEwS	TRUE
òPø¹àCÙvÅO2³«ä§	TRUE
Ú÷ÏÝãñÁÄ6AÈ÷î¦Û¤îL¾n	TRUE
tñ§çUÁY7W×dà¢¯¥	TRUE
óÜ²4	TRUE
à¡Ã¦KÙ§8	TRUE
yÛJtßØÈjÎ©	TRUE
W	TRUE
¹	TRUE
ÝÓèhlÏHÞðXç²r·	TRUE
ZLÆímLµkÇSÌÒì³3M	TRUE
©æÎßÇò1¾hÏÙ	TRUE
Çðt2M6DÁ®SõµE	TRUE
r°ó6®ÞÀBRMpò«ÌÝ¯º	TRUE
6	TRUE
QÓlÕæcO£A¼EÛ¦òx¦òÖÍzðS½	TRUE
°ºi£ÔÍ¿¸pÐ¤¤t¶øØÃÀ69éÁdè	TRUE
øêãIg7¾½ð£c	TRUE
ÜñÛ°ÔªéYL	TRUE
t­ÖOõ1ÀbwUªÖqñÕ¹¹àbäÙÉKI	TRUE
¨§	TRUE
tÌÀP4NJÍÝÃ9Xcåª9¦uñlìZEÀ	TRUE
wIÂç	TRUE
øøF	TRUE
¤Ñr9JgÞ¬¶©gXRº¼ÐÝÁ²ÕÑßRÄ®	TRUE
eawìËYÞÐ¶¦PÚnVêMõ¿¸¦¸³LC	TRUE
·	TRUE
½Ô¸dcÚìH¨Å4ên	TRUE
Ò	TRUE
z1äwðÕdyòÍí	TRUE
¡jºYxl	TRUE
²IÆÜâ¢8öVñR8äÒ¼òàg	TRUE
ëÝé6°XXM¨Lr	TRUE
¿rzØ37ij¬Þ²¡2X3ÌÓ©½ãîa	TRUE
ßÂ¹á©1ªxöãôìHXBYæZî	TRUE
uÉÁ½nÓc×¹WÄ½ôYHDC²Á	TRUE
µtwR2¦ÁGJzL¡¨h¥SKâ®	TRUE
R¦ÛÒÉíI¬ºk×æ¨2ªíÂb3¯Ë¶	TRUE
î	TRUE
æ·êpå6ø³c®ÇÕB	TRUE
gfðqQH	TRUE
Ý8pÏÜhÀÄÎÉ½mCSKÆîÞ´øí	TRUE
»KÖ£±9D4ðßXañ¶ã8«ÁTöïãq	TRUE
õÀQ÷öôUAÞÁ¨zñOFÀ¤®ÁlV¯DPZ	TRUE
b¡µÖÅXzßu²mBv	TRUE
ÝÍ´AÔ£ÐáÒæ«¸åîª«oK¬¹·êÁ	TRUE
àõceZZÔShjAn·8iRödrÈTa	TRUE
¨VÕG1µyØ	TRUE
áwËKIÆÖtW	TRUE
¤Ã²W¿	TRUE
Î	TRUE
N±G2¸¯q2ì¢«¶	TRUE
Uuê	TRUE
»ñæ²Òí9ÈÃóO¨ãö¿Mµ	TRUE
uÀBS¹ÍÝ	TRUE
yÛAòU¿	TRUE
Wóc·Qì8±9÷ÓVÞ4¢ÄmØg3aÑ	TRUE
¸ÏaIðí	TRUE
Dº¤à½ÝLp	TRUE
ÜNâ·³¥²Æ¬xÁÓ«êïçäReGå¯ËSQ	TRUE
nÐzQgÑÜºu«ïìÞÏ¹ÓTÕTm	TRUE
ë	TRUE
8äkNa´Pù	TRUE
I	TRUE
bEGßªÓÊÐ¼u	TRUE
h	TRUE
Zibäó1NzA3Ä1£7ÆNjî¤	TRUE
PSªí	TRUE
ÕÉ¼à	TRUE
¶zBp¸ÑfªçPóÏA­Y«e¸¬2é	TRUE
pðCiYY7gÙsVBééàKÅ°ÒéBzDÜ8	TRUE
Rª1ÓpjÝóêùªBíµ7âS¥FÁÉjÐ	TRUE
Zr÷Mn½¬	TRUE
¡¥1¯¤¼MtRÆðM	TRUE
n¥vïòh®çsóoÂ8	TRUE
p§îi98Öimí	TRUE
Ó4³Ä½HåG²Lä5ï¾è×ÝB9§½	TRUE
ð8çì¾å	TRUE
f¼	TRUE
Ø¶udñdskÇ	TRUE
GÎ÷ôM¸Z¤Ä®Ôò«X	TRUE
Þ¾ë©Öì	TRUE
ÙôaÙèmRÈX¤ôñIÅäz«q¤gàe3G	TRUE
Í6íí¤qJÍa1ç	TRUE
PºqsÄM5°3cMF5BÛ	TRUE
d½È¥pIzÄÄà´X²ç··	TRUE
Ç¦	TRUE
£¡CEAíÃíºc¤­ÄZÆ¡PåQ	TRUE
7GYcÏBbãªÀâq¹i­°XÇ	TRUE
Ô²¬ÂñÛÞÎÄÜõN§QÍ	TRUE
W­ºQVM	TRUE
î¿ô	TRUE
VyUá	TRUE
eÖM	TRUE
µÛµYìÏgDhiAà°öÐ­Îâ	TRUE
ùË¹¶hÏÝE«°	TRUE
õXkc³5àvQ4Ú¿nmæ§ðÆ£Ý	TRUE
´°áéêöté×ÔXdç²	TRUE
³	TRUE
®×ÛhHaKß	TRUE
COm	TRUE
u¬v«ÎÀµç×õ¥	TRUE
WÔÈÀÁvlfX­z	TRUE
2¼lCÖÃEÒÍ1Lì¨£gjµÆÕdqðFÛ©	TRUE
spÆÑJQRßB®qsÓuOÒ5°©¹GÉã	TRUE
nPÈ¤æùÓàÉ4XÏzU½¹tëæªÔêßmó	TRUE
ßBÊR4pB¹NÙ³¨	TRUE
J£cÛl¬¶TE£ãæ1mt·	TRUE
½îiõlmgyåÀ×¼JrÝóg2»Ä¹Ó¡½	TRUE
æÒä£Ç¨P8	TRUE
¯çíÒ5s¡³ôôÙÈ	TRUE
W6©º²å²gÆVÃïÆ	TRUE
ÉßepZ¸ÈbÅÌ´×hT£	TRUE
©¹Økôäru	TRUE
»ìøö«êç­Î3c§ÙUÍwRÓ	TRUE
Ï£FO3³Nfõ¿¼N	TRUE
X¼Ô4´Ü§KHÓm¸yÛµd¯ôìóJ	TRUE
7²6mdtYKÝbÊæãpz¨nîM±	TRUE
LÛá®ÝðÚ	TRUE
Û¶Fp°óÆùY¥ØðÌn½®	TRUE
wàÉYdÜî£	TRUE
P±fv´·è¶V¥n	TRUE
b83ÃßÏÛWKÚ¢7	TRUE
»7RPÊÀ£°toD2³AïÆfmQ	TRUE
fÌ×÷PÑcv©eÍ¹fÆQÐÒ	TRUE
¼Ä4Ykíª¤	TRUE
õDx÷jÅKôz1¶lVzÁ5õo1É÷	TRUE
DÃ§·nÚ¸ÄUÐßó×çÆÙ·°J«ó	TRUE
Ù¨WáY»i¯ô÷ºí	TRUE
ÖØøÐÄÒsS°ÂÑqà²IéâhBàÁï	TRUE
O¹ÆJ	TRUE
½s±Ù¾bènaÂ	TRUE
ßínSÐ¨ZÌwvÄ¿µC«ßPrx´À§XÍ	TRUE
JÌã	TRUE
ÌXùÁ¨4ñæÜÔSqfVEÀØ®	TRUE
søëÃkÆZÅñB×uoäòN	TRUE
Õ8¹¬xãÊ2ëÕchWqï³M	TRUE
6VT¼a	TRUE
sÃCKY7Ð4ÖÒÒ´Â®ëXBI	TRUE
Qd	TRUE
·ÓD¤¶nÕòJÞ³XKcå¢O8qÛ	TRUE
z	TRUE
pëïcY¡¿·´°É	TRUE
¨vôÒWåÀ7Så	TRUE
w£«WLð°t´ÉãTÚmóEÂ	TRUE
cp³¸ØÒiK¬×vÉát	TRUE
°òËÃ5LÕùbµ¢¬VRyÝy	TRUE
¾oM¨	TRUE
xî»dpsÁ¯5	TRUE
aNAsáæÅ§·ÒÆykÝGìÕWO	TRUE
Ö£Þ÷s½Õáì©éeäÅLÇr2´Mfö	TRUE
oì1ÍäËºÌØð4j³nr	TRUE
a¤»×¶g4¢jìÔtQ	TRUE
UôQÀÜ¦ÙQcGå¢ª·áêE	TRUE
1PF	TRUE
xO¬©YÊÉÕíçø8Ý1	TRUE
è¯ù´Ém»àYæ¸aÖÁYäjD¦½YvW	TRUE
ðõP	TRUE
OQ¡®orÑßn9	TRUE
ñ8ìø¾VXÅPÜ¹ß1ªv«ÞKöxêzf	TRUE
¸áFJñÓ3Þ¶6´Só¤ÚÔ¼ï¾ÛLQc5A	TRUE
1W©Z997ºtzg¬	TRUE
T¡3wòv×n7	TRUE
Å·	TRUE
j	TRUE
BóXðx	TRUE
¿AÜohbcUh¤¨îíÜ9	TRUE
u±	TRUE
¼ªÍÞ	TRUE
óøùÌçKl5ÕÝ9mâÑèÓxö¼¨F	TRUE
®rÓx7÷3mðtwB£ºn«FÑdæ	TRUE
8GCïÒ¬4Q²Èçå®2ê24´P4ª¿mÑ	TRUE
UÒoæç4´Wîù÷mz¼¹×ÈK°7	TRUE
o»å9aEÑk7ö	TRUE
¯««öæùåoU«hzßÇcwòjd¢A·a	TRUE
lMñÙ1ìrÉî¥Aï¥îÙ8a¢kØ	TRUE
oèxYä£	TRUE
39	TRUE
h·â4Se¡7ècCËèA·UrG×	TRUE
æ¨Yt5ÉÄõßÎÙH	TRUE
uïÙá¢áfTÄËí¢ëDµ	TRUE
°arùÒòììá¹¹Âí	TRUE
§¶îéÞ®CD	TRUE
JVW¹ÔÐbbb¨4Ùs7gR	TRUE
ÕBËù	TRUE
´C÷´¿ÀÅË8S©e©ÓëBÛñ	TRUE
¸õl·Ëvh¶ðEu«øJñ¾XÎÎ1Æï	TRUE
V±	TRUE
lfÄæTõCj	TRUE
³dQÜ½S¬p·zí¬éñpî©I¥	TRUE
eIå¤«ucÐ	TRUE
G6öÛ¦imÓºvs÷	TRUE
¢â¡ó£ÑËÝG¦tbÞ÷	TRUE
Ãêmá»9	TRUE
L¶ØlÃCMJk¯i÷Wè®µÁnÁÄÅ7	TRUE
º±§ZQ¦Ø­ëØãHÎàE5yÅbËõÈïRe	TRUE
í³1VZäCsMè÷	TRUE
L÷°5d«râÆô®4xÇÞ²×ÄÕI¹	TRUE
¼L£­Ñi½E¹8½©©JÍZ1¡¶L	TRUE
t36¸ª÷r	TRUE
ÐM÷°çI	TRUE
ÈvÑ¾»XìÏ³âÏu¥ÕV¦LÉ÷u­	TRUE
î4¼yÔ¼	TRUE
ß6Sø­bkºJo	TRUE
YiãEÁ¸ñjj9¥Grº¹¢	TRUE
Ûºß9º÷ìXrxAS	TRUE
âq	TRUE
¦µ£°k¢£ã²vMù4Î´ó	TRUE
naÁmy	TRUE
¾àBH«¶CÕKLr¼òMÃMº3XíCÍEá¢	TRUE
âMPj	TRUE
hOôçáGÅÍØ¾øèÊ®¹³q½	TRUE
óÖ	TRUE
ò6tj÷áSGf	TRUE
íäáEa´jÑöÀLNùò3ãðà5X	TRUE
Ñzpî1ôhÐÕÞ	TRUE
âçªDvUtâÝfÙò®¼¢vßE¡¦Íº7·K	TRUE
°rmöÞÂÚIÜ¬UºlÁ	TRUE
g¬XÍîªxqËJj8Gõô8yõÐðª	TRUE
Q¯xÌzÀ¢käÚ½J¶h	TRUE
I£r¤UÌÄdwCaZäGka	TRUE
KµáòrAçóÉx¼7ì	TRUE
ÎÃäÍ§Xã¼G	TRUE
»	TRUE
÷PeFÁÑSd3¨Ä°âa³ZÖvÝÍ«òiuh	TRUE
¨¸ÙhÛXôÓ²¨i¼rKLUv¼fîÎâ¿	TRUE
ÊËS6G	TRUE
òD°E«´3±Níô«xÙ®q3ôiÆâ	TRUE
39AëH»øôô½ÃLØaêxdã	TRUE
ñ¨6tÐ²«t£×ùw»ËW£UwdéW¯ÙÒ	TRUE
u«Z2©ÔñÚ9	TRUE
´ã«Õ·Õ¢ëGYVkZ	TRUE
7ÏÀ¯	TRUE
MQzÐ©CöÌÌñðÌT®È¤	TRUE
èù÷òNVõtB9Õ	TRUE
ÓsØ®¨ÆWR9ÞîyiÖ°MG½öß	TRUE
½	TRUE
ÇÒ»WK	TRUE
ã¯Xäo	TRUE
UÃñÈ¾åvðÉøF¢pY®ËKå¸	TRUE
µº3ã÷ÃEE£ï§zÂà	TRUE
MÄ¯ÔvJn¹zqÍÞyößmµf¤H§í«Å	TRUE
­Föy¿êãÆhJÁÛå	TRUE
ÑâlÉJÇt	TRUE
S¢AAY	TRUE
tÏåUiµà¿Í	TRUE
kBbAÄ©¶jjfçÌ	TRUE
Ñ½8HRÊlfgzæ8Ù×÷	TRUE
Ñ	TRUE
øÁËÄkpÀÍ2ù´ÐÂaéªoÉ	TRUE
ÔÖDfG	TRUE
è3Rá½¢Ñ9	TRUE
9öVá°§Òw1ëÅö¾ì5Gyà	TRUE
æÒñ5RØöòÆªöÞÅÚ	TRUE
nÅår¸ëiBcyESF	TRUE
½jÚqJÀÁ5BiÊ	TRUE
c·aïcô¯pÔ¹D	TRUE
²AMXCxjYZèëqùYmÏèºóVèßeÁ	TRUE
È×­ÔÛ«W³¢	TRUE
cô³2èË	TRUE
uÆíÏ	TRUE
xÇð	TRUE
½5NÎnLn¸ªb¯¤	TRUE
¿5MD1³W¿	TRUE
J7Uï¥z¤¢rÊnng´dd±ñiI¥Àõ	TRUE
Éö	TRUE
Z¿PYøyÓSÎîbQãç¼çM	TRUE
¡HXímÐdjÞÕi»m	TRUE
¸O¬ÕÒR«çpFP¹YÈ5àôñ	TRUE
ùÁP§nE·y¿	TRUE
NÎJ°ïÜ¦z	TRUE
ÀUÎ	TRUE
mî	TRUE
è¹Þ	TRUE
ìk4	TRUE
NjÝÃEÞÚ	TRUE
©r«XÉK·âVOÐP´ÎX	TRUE
ø	TRUE
ÅOiøÐÚ®cP®§eq©r	TRUE
ÇrÇã©ðro°´	TRUE
ÒØÃÊò¡ªq×Çìá½ªC´	TRUE
ó9ð4ÍVÖ6ÔÏQRRcöxh1¨u	TRUE
©nXÉÁáp¾ÑvFçÚÅg	TRUE
ÁF»	TRUE
»õïwÎbÎhôÊÄµ9õ®K¶NßN9Ñ¬S	TRUE
®ÉsCÚêá	TRUE
²psöÕLÃjcãe¹Có»µÛ¶WÓôoY	TRUE
ÍödÑoV	TRUE
ñvøn×¦¯È°Ì¿	TRUE
óS7øòãÇå¬	TRUE
éÉºmmµßöÎo§PDH¡Ôa	TRUE
oVa£	TRUE
7ÞÆãÎµY2ËÌ©Qâ¡ºÎ¤	TRUE
´gÑÖ¡ã½¸æ¸f7öAw´­µ	TRUE
ZßHkù6NaqkS	TRUE
¶UÔåÂXä¯7	TRUE
µºÇßS	TRUE
zµãÃqNöJÖ¬¤ÑÓ3	TRUE
bÛékm9ólQogàaWÑ¡à¼y¹ìÇ	TRUE
áZZ×óU±DõvÄº·iUdVíg¬áöj	TRUE
t1Ò§ºÈL¨÷l«l£®ÒTê	TRUE
Ïr7GÒ	TRUE
ËÜg·±	TRUE
t³ÇÍà	TRUE
¤ÂÍñ£M3q¨¾v²ÂjÚÕd	TRUE
Ì¸XthoFE²L°ÇAIêP®ñÙJÊ¼sÞs	TRUE
O¬SÛµl÷Ä£æ½Ó7Iâ¶6á	TRUE
Cð°xÀ®Ã§ºdtª8QÝ§	TRUE
CºÕlU¿ô	TRUE
pºe³Xï»ßCîµªÔäÈgô	TRUE
¢E³¢«Óð3äEuÕ²ç	TRUE
Ì³Lr¶I	TRUE
KË²´AØ»ª1¿öolWºÐPì9	TRUE
Zwö	TRUE
bÊÙXç×åàCÎäÃ´qõRóÍÉE¬Y	TRUE
´¤	TRUE
ªï¼FuäÕ¢e¬KË±eÚ×ìãSX	TRUE
rÆÏÍnlÔI×eÂëæ³M¥	TRUE
CÓkl¡èYk	TRUE
yeÍv¹³ë´euqÎjM¸TWgëZ	TRUE
±ð«ÃâTdèë3cÆq÷P7	TRUE
¸kòÝjø®éÈëR	TRUE
Bº¿x¯	TRUE
¸B¾jô¿ä°Ów¬Tm	TRUE
Ð¦ÞPGåÕÄÍµôÒxÃÅIMæäàrwZ¨	TRUE
»àäÈ÷y¯ÆìøÇÜTmÑ3oØÄV¤J	TRUE
sÕå2¹ÌLêVvëÚó°°zN«3s©÷6ò	TRUE
ç8UgòË­66¹	TRUE
­qÙø¼¹	TRUE
ta9ÀïmoçQÁígl»é·yïÜàI²p	TRUE
IçqÆÅníÊÐö¶¸fGTz÷ëÔíñy¼÷	TRUE
µÚ²ÁËoöKKã8	TRUE
Ì6F45Ð­¡ÙåxLJ«Ó°êövFh	TRUE
§¶êÐK	TRUE
èô¥ò½K¼ÜJ×Ûô¼¬ÎQ	TRUE
ÆÎ7q6GÍÏSïOÀ«Ë	TRUE
pC©Æ4ôk	TRUE
8Ð¾ónÒÛCáleÆHÊqB¨cíßZéæä	TRUE
oÂl	TRUE
Èîìïz4¾xlÜ¹M¸´ßk×ï	TRUE
7AêªÙBS¢sãÆÞ®	TRUE
r·IqéÆÇôÞá¶M­GèDË	TRUE
¯Óáì3ñ·÷¥Z¼åCê×	TRUE
£ÜÖaaÛNªÅ2ÓP¨TìÏ¢7r	TRUE
iÐØJÒ×ø»x	TRUE
­KlÀ¾iwÞùã¨47¾ÀÜW	TRUE
ö´ô6£6rZèÜðäº¬öUÂîÀtÏÁ	TRUE
ÑI	TRUE
xÂî¿Bé¤4õ²ÃKV¨ÉÙ»PªZÉâÑ¤D	TRUE
Â¾Q55L5rD¬®nlÑ¼WÕZ¿N¨W	TRUE
mÁRWÚáÒ²óyKëÄíjz	TRUE
ßöíÀyLn¦ø½BÇcØ4eÍ4fî	TRUE
£²ãC­ãuÊk¬¶æéÒf1âÏÂg9¢èv	TRUE
v÷6ÐÇA¡­¼Ùäº°	TRUE
ÞÏs4ÒÂ±6wjkÌè5¿ºÝQáJï	TRUE
²´¨½IJ¸	TRUE
Ýv½c»Pò£c¼ÖñlÛ»	TRUE
äU«øïêr§ÔÎv	TRUE
ÒpiµgùA	TRUE
ËÙâßÙQä	TRUE
¥±ð¦ïÅqIÍn	TRUE
ÉZ­ø£ÓdhÈ¸BBÛõÆ£ÛQèÒE5	TRUE
uÚÂ®Ê	TRUE
íDXK4Îhä¿È½	TRUE
Ê¯²Ç	TRUE
A¨D¬ÎR¸ìQ	TRUE
°ô¡9ÅÜµÅçh®	TRUE
§å³¿½Àr³3Äê¸¾MÀ¬åÈìê1	TRUE
¾¶P5Dîé·cÎÊ±¼UVoÁO£ÌFÙw¡	TRUE
ñ6¸ËVß¯Ñ¬rtxäà«oRSâÆP	TRUE
«8òÝµ´SRåY®¡6£¤K¶1±BÜ°¬	TRUE
HbYËâñÔÌ¤7ccÉÉ½ÕEê5OÑ	TRUE
góØdyÃ§ßB	TRUE
qBp°çHÇÌV¬1°ÈÛõÞÙ5ï¹p¦sU	TRUE
ð¥æâÓzò	TRUE
kg6¬F£X¹Ô¡ÜØw	TRUE
här9´s6qIP	TRUE
PtÑª¶AhP¨	TRUE
¨®àÈ¥¼a9G÷ö­X	TRUE
×R4äÕDºíJ²ÓYÐÕ	TRUE
pPjùV§i	TRUE
bÔ¯q¹4Ð»ÀR¶½èt¾Ñ«	TRUE
¡îI	TRUE
ínóCÄ	TRUE
b5°ÌYÁEZOF	TRUE
6Ôèêqõµ9tuÚåælÛ	TRUE
öIêê	TRUE
ªö¶£ópÐícÉÜnbEÛÜé´ã	TRUE
BäÖÃ	TRUE
ÊÖÇKe¦æ8ºpèõd¬Æ±CÛ	TRUE
ZaÁÓfÚ²	TRUE
½£aÐ	TRUE
òá	TRUE
ø«áêÀätävóÍíÒdYJÀÀ½ªâ­epç	TRUE
U¸3Ã77ð£½Q8ÉZÈhÎ4É	TRUE
JVÑv²â´O­	TRUE
¬ëS³¥¸C×åÛ	TRUE
ÄrKÙ×½·ÎÈÄ	TRUE
²à¶¸¾ÓL	TRUE
læd¼f¿3ôìóÇìZwæBj»¶¶YõÐôR	TRUE
ÉRG¼²¤ºD®óVT³bùS9Q×Áî	TRUE
áAéÌDÞ½ÌóoéØá¾¢Òï÷X	TRUE
¸q¸R¯pÍsçDÑéÄëeð5	TRUE
wÉfà2´¡ëã·òËälÆ	TRUE
TTÂHÖÍð	TRUE
YzX®©Ãióø¬5B	TRUE
X¦UÎàª©ÓòzISÈDÍÛ÷	TRUE
ïN¸ÈtPrè¤Ö½Ì	TRUE
t2òW«4¬Y½BÙ§ßð¡õ9Â²	TRUE
e¥ÎÀaÂ¾¥q¿Ó9ªjp1ð¸Ô»	TRUE
ä­F½Þ³	TRUE
Ê8n7¼îtí	TRUE
´ùµîeÉe12Ëbò	TRUE
uÏ68­Aó8ÀØÜÃ2s	TRUE
»¿OÐrì³pkX¯6OÃ§2zÞöù©iÖ	TRUE
C·nvn½õ	TRUE
àoØÆlK¤ÉeÀÁqê³ìÛÒ	TRUE
v÷	TRUE
õCâ¨4°¸l¤×´X÷ÑÈåUD2å8S	TRUE
ÈQ	TRUE
8²±ð¾ð	TRUE
Cl	TRUE
DuÞgkh¸øø¹	TRUE
Ù1«VÕ9Ñ÷Æ	TRUE
6IhËãJÐÚ¡zôÁaÐ1ñ¥ÕªÍWá	TRUE
oâuisrÅF´ÑIrÄÚJw	TRUE
Ö8ôá¤3ª±¦y½ªø¤	TRUE
ÃÝÜFkÔÒëô´çÐJô	TRUE
ÄZSÝØ1fÓRí­×	TRUE
Ò¹3I	TRUE
¥È°¯nçØÜbfÖÐöÊªõíìOÃÃ´ä	TRUE
ã«pH­eZõxÚö7Hk4uÌÁíZSi	TRUE
³VY®MåÅ4ncÛ±øª4î	TRUE
ªâðÕóbHÂÝb­¢Ö¡YÒI­2¿ÚÊ£Å3	TRUE
Þêaí1îe¼ÕÚ	TRUE
±Gå´F¼âáEW­2º¸®åÌ¤çqÓ	TRUE
PHÆI²QØl¹R¿4Ó½WyÃ¹¤Q©Ë·	TRUE
3ÙÙW¸Ä®Çw¡ì»ùfí4·R·o	TRUE
ê¿l¤ÕWâEðOVcõø½JfØ¢õ	TRUE
nÃÙPMê¡ÕðM9ñ«ÖÆ¨LÝRÑ	TRUE
õÐµ6WÔujóÃÔàöTR½ìy»	TRUE
Þhm×kKçëÇC¯·	TRUE
õìKîÂÛÔÔÀqpp¼ÀG9È	TRUE
6f°6ÐFouÀãÇ¾ÂpºðÑñZÎ£´Óäo	TRUE
E	TRUE
Û¾Ö¢·	TRUE
M®iq¡rÚhÏxLaAéÁªÙM¤A	TRUE
±t9ÛpÉãá¡k·×ub½5­u¨Â½CoÃÚ	TRUE
²HÙß¯	TRUE
Ü7¯ÀTðLÆVtnRá5Ñ	TRUE
è1§éc¶­«Lï3É¤9£Âøæ	TRUE
­	TRUE
ßç³öóê¼A	TRUE
æ±×A«BÑâ¢¥¿xMË	TRUE
Ì¿hù¦Åï8bOs5Ùöár¯AøÝæ47Þ¨	TRUE
º¬Fæ®î·a¨±ÛiDäð	TRUE
ÙÏW	TRUE
E»eQÊÇ¶ÓgC²iO8o¾¶»ÕÆkNQ	TRUE
ÔH8	TRUE
ð¤Ý¾ïP¯	TRUE
òcnÍ¾t²P14f4õ®ËkÈ×2Zµg³	TRUE
­bßÁºÁ÷Iµ½p«fª	TRUE
£¬÷	TRUE
ËpÝè3Ïl¬èDq¶Î¤X÷Å¨çÌ4G3ëm	TRUE
¯Qnh×¿NÇµiVÍKH½QÌµ	TRUE
ùÝ	TRUE
Ëa«uÖÌO´D	TRUE
w¬Sd4WLuÑÀ­6³jÇÓxh	TRUE
óíUDzlêÕcvÕáBÖ»¶õíååohc	TRUE
êBaÍ¦´4bbÖa	FALSE
ÖmP8¤aùçàlbîbÙ3Ja	FALSE
Tadn¹ìNVµäKdÒÎb±baXÀ	FALSE
ÓÎ×ðËab°Sfbax­Þ»8¸Ñg	FALSE
ÂzaPbbÌa±µø	FALSE
ócÎ×ÀEÙØG§abK×Vb¬vÔða»	FALSE
¥a»õb×baÇ	FALSE
a·gì¶xG¬b¯òÅOÙßwPNbªa³7	FALSE
ß¸ßaYØ¢ÑbbÈäæLHhÀaÑÌÝZ	FALSE
ßaaíbb2vhì¿a¬¹Çµ	FALSE
abôba	FALSE
abdLbÆ»SÖ®a¹	FALSE
abbeaè	FALSE
ça´aQb¥ba	FALSE
kGîÊga¨¤bbÒÙxé®aáD	FALSE
aZbÉba	FALSE
PÊYaïbb´k·6arBo®Ôj³Ú	FALSE
as1Kk¦µzbks¶BÃb÷aR¡Ô³¼ZÅ	FALSE
abÀÌuæRtbz·añ	FALSE
abba	FALSE
4Öi¶¼§naõ9PbRK¹¦ba	FALSE
a9bv8¼Çba¿	FALSE
abdÒäbJo°í×Badï±lòÅ	FALSE
î¼abbäaæb	FALSE
abbõa	FALSE
¸aºb©3Uba	FALSE
m²Ü¨aÂÏÀ§bábásaãÌóÃ¯Òï	FALSE
Ua¿b5ÂbKa	FALSE
GRab­bªa¬Ñ3	FALSE
¤abbÛ­³ðäqäÖ1ÕYa	FALSE
¾«¡®Ø¿ö¯EîgazLbböTàa	FALSE
aFâòÅã·w¯èçbbaç±5	FALSE
htabbatr	FALSE
ºa£oÁb»ÞÆðy¶Óyb¨aÕ£¢	FALSE
Q9ÌaØb1badM	FALSE
abzba	FALSE
Øta3åb17NbmRßaYÖ¬	FALSE
»aÅ÷b3bVaG	FALSE
èsabGËbYGØ©¾svaGG7h¦Q	FALSE
µ¹ºaq¶bÛrbløS¤d²aW	FALSE
abba	FALSE
vGÎîp¥²¨¹yapêibôbÉa	FALSE
ïØ´¿pkabb«må5PñÄ1göS¨ae	FALSE
oÌabbì¯a	FALSE
yñéraÔÐbpàÐba¶kï	FALSE
9aõSbRba¨	FALSE
abäbîa	FALSE
eöaÝbbayp	FALSE
MÊaålÎÍlÒèJ½bµzíwHba8ã	FALSE
ÔèðØÞæañbbZ¬o¹ùô¾n÷a	FALSE
ÔöìvY¬ÅaÎ´ÜbÖßbapÑ	FALSE
×äjab¼bnwÚãÏa6	FALSE
abba	FALSE
abba	FALSE
áWHÝaGFiÏÐb5mUÅñ¾ba	FALSE
¼ÆÒabXG¬ubrg°2ñ7âåDvSaí	FALSE
Rvaâ°3bâ¥·É¢À¾ba	FALSE
t¿âaÛÑËqBbbâaÙ	FALSE
¤«a­IÏböÌ£¬°bÜIaY8ÓsÆv	FALSE
abLba	FALSE
a­ÅåÎbnbab	FALSE
Wa®b¨bä¢a§	FALSE
äa¥6bs²¶NbDa	FALSE
annÈ½³bºJ§h±bÙÕkmAntaL¡	FALSE
abIba	FALSE
ËBFVaÄªêçxbO¥bËa	FALSE
Haèpb¯ë²b³åa6´	FALSE
PËaG2b®bÞ§¸as«YJÃ	FALSE
abVbGam	FALSE
fuRõuaxBbV°ÅcTÃàábµ6çaó	FALSE
a5¯B»ÞÓI©K¸Xbbaæ	FALSE
ÖôÁÃ«a3Pbbaß	FALSE
¥abbèa	FALSE
a¼ÅÐ÷ÁÚêJxb²©PÎ£±b9nZ£aÚv	FALSE
×aôbÓÌb4Aa	FALSE
7aNbª×VbaÁM	FALSE
abba	FALSE
añBSÕ¬7ÂbrÚ©6RbtwVa	FALSE
abba3	FALSE
abbaO	FALSE
áa®dbba	FALSE
õabbÓa	FALSE
abba	FALSE
9î5Aaåè9Fe­bæ°Û5baã´ÃÌµ	FALSE
aÌÈ§ÃÝ¢ª³áöbïb®aÀWébijÄ	FALSE
XÌñ¸bahùXïbÃAZb¾zînÔa¯®ª	FALSE
ÚnëÈU§àaöùbWjÕbHlÍa	FALSE
abbD¸IÓ×Æ¼ôaGQWZÞa¨å	FALSE
ab9b´a	FALSE
´Nõ¹¦ÁvTabÝì¥ÕÐbxaDL§	FALSE
agábbsËa	FALSE
a8¸bAÇä¯obvC5¼a	FALSE
abba1T	FALSE
waÀÝçXî¹Ä1æÏXÙbbaÓ¹l¦	FALSE
ÖGabbF¿2aK	FALSE
a·KÊbLbaª	FALSE
ÁÆabbµa	FALSE
abwSb¾à½ÔaWW¢Xã	FALSE
abbÔïa	FALSE
¬aäøbbøßr¿dê8ëda«V÷·QkÁ·q	FALSE
PZhawÓbbað¿	FALSE
aÂÔbbÔa	FALSE
»Ùo¹aÂóèæb¿íØblaqð÷	FALSE
abbïWtnaT¶LvÆâ°÷eÜÄ	FALSE
Kabba¢	FALSE
abz¨Ûb¼Þ3waY¤	FALSE
abbXa6bî	FALSE
7abOiKz¸NÎCbræwWï©Çaù¬­a	FALSE
aë´íb¡Òbàa	FALSE
abba	FALSE
abba	FALSE
XõaGb¹6bN©a	FALSE
abba	FALSE
î7¨ãaêÞbëb¼a	FALSE
Ôabb2³Éa	FALSE
S¶¶ðVÆabJb¤×aìh	FALSE
àIPaVÆÇèb¡XríZ¥¶ZZ¡bÆa	FALSE
w¹aÔåÞ6Ábðb¥EaÍ	FALSE
íLÖÝ¯«éÅêabùÚib´6ôNÖÏ1Àa	FALSE
ëÅ§ºabÆz¸ÂØ©8b¥õSÉaGê	FALSE
aôxkVõbG5bÑkaa¼	FALSE
Éavbd¼ÄïËòÊb°aÍ	FALSE
ÜaÒôbÌbwªsæac6Ú	FALSE
Ea¾Ì8bÜqKUb2Ka	FALSE
as¨Aê¸ìQb×bÞôVïyNaãÌïä	FALSE
GÑGÈ2ÌßËcëaõbGÚ5JÜbÉó1ai	FALSE
aébbQHa	FALSE
a8¦ª¸ïËmÀbybìbZádð­¥aiÐ	FALSE
ïabb´ôa	FALSE
aéðYEJ8èBGbba	FALSE
aÍÞ¾yçbîÒwiÛb¿aMpC	FALSE
7BBya¦­bKF±Mb8È¾ðëÏaÞ2o	FALSE
Ìaê»bba	FALSE
maábba¾ErP	FALSE
øaEñ©ebº6Úba	FALSE
AÊamâÂÑÖb®bÚöÍGaÄ§gØah	FALSE
Dabâbàa	FALSE
aäbÉd¯bªGPYJaô	FALSE
eaêbb6a	FALSE
¦aÁV¯ËldÝK¶£ábÕ7bDÞa	FALSE
UaæbÊ£fÝ¾ºß2òÖÕÍÈ4Çbba	FALSE
efaGIbÝMøõbÂa¢ÕFÄ¾ÒÀt	FALSE
6pË¶óða¹bbïgòÞa	FALSE
AíZaßboØÆbb±9a¬Ñè§9§QE	FALSE
Ò­a÷bUÌba	FALSE
abbßa	FALSE
ùqabÝbaDQ	FALSE
awb²9b¶Jka§ºnõÞ	FALSE
aIVé5bì®æbïEc§åoîZÐa	FALSE
TaEÙbÌF6baÄz	FALSE
ÒaôWv»RÃ¶£bøKÑ7Ñba»Äí	FALSE
¶Æoaf»¹bybtaÇ	FALSE
ÄåiPÆa5¬bäu³óbbaÐaGõAÕ÷J	FALSE
abba	FALSE
ÀaêbbÖVaßê	FALSE
abba	FALSE
ÅvÅ±áabÏb¶±a3JXMÔ	FALSE
Áa±Kw¡bbèµ×aE	FALSE
Ëß·Ôab÷ÔÓÖéÆÇ¡óbkaL	FALSE
TÞ£aueßåÔYb·1z«bñ¡E7wDVaô	FALSE
ðùãW¥½HÊÎaÖib¸bãMaw7	FALSE
aäbbVìªPÞaÚ¨n	FALSE
¥paÏbÔrbaáN	FALSE
uab¯õ«Sba	FALSE
äauwbîZE¶b³®¶aA·wB¯£Ä	FALSE
a±bbßgao	FALSE
¿°ÂÁaIabãøÄ¦äq¦bé×bÜa¹	FALSE
wÔéÅsØaYóbªGba	FALSE
za4XbÜÐ§bapD7¨Ëâ¨f	FALSE
a·µ§bæbqaS¾	FALSE
Îa¿bba	FALSE
a´bb·Na	FALSE
Ïbã§aDBÉAjÝbba¬Ü	FALSE
ìOË7­¢Sa¯bÛba	FALSE
Ða©±±dmMMbP´½bOÝanAµÓÀ®¦R	FALSE
½a¹Smbõ5ba	FALSE
ôÕ²6ËavÜ®ÑVÌ·øbCã3I·b±a«á	FALSE
·ìxÓan­Å¾bbaJu	FALSE
½abbab	FALSE
Nº2ÑabbWLe»eIÑð7aÒF8Þ	FALSE
aÏóewæÑ¼«ô£bQKìbvÎñIÀLaCw	FALSE
eCkabbÏa	FALSE
abba	FALSE
abzba	FALSE
ÙõaÁêãKØb´b¾»L«µPa7n©AËlH	FALSE
43ªËdèaÖbù×5Ú¬ò3bha	FALSE
abëbanÑ´æEÉ	FALSE
aÀb°±ßbëÛ¿éb9S©a	FALSE
abbÇa	FALSE
a÷bÂba	FALSE
¸T5åaPDbCLeae²b36½6¹a	FALSE
ÈaÕbban¥	FALSE
aêen3ÉbnpbÂÌxÙaëÂæòÇÈwi	FALSE
aWbÆ¨ÃÔdÑbÈÞnEg¦¾NaÒ¤	FALSE
abba±sÀ	FALSE
aªJbiªy¡Á¥îÝba	FALSE
aÍb1ç1C®ÄÊuµC1èåbUcaNaÞ	FALSE
abbaó	FALSE
ÕaYÕFb6Xba6äÍÐ¬ö	FALSE
¨abÃC¨ªb¨°a¾	FALSE
aeÕróbæöÉ²¡BÄW¦b¡sTa	FALSE
p¢®ø×ÓaÄbyzböaM£	FALSE
abbªa	FALSE
N¿aVÜbb«7aï	FALSE
¦abbìaQ¿ÌºÏÂ	FALSE
éy¢eaíbbmà®aOç	FALSE
HpaññáS´bøÕvj1FbÏ¦a	FALSE
¶DPcPªca»ukbKbia	FALSE
¶aIãb¥qbÎo¿ÝÒaîZbÜ	FALSE
¯EÖQñafb£c¨bOCÎÇÌSaJÂ	FALSE
SabwrðhÖ1QibbîïWbëÝaòBÔçÐ	FALSE
aÁál©b²Öbau2	FALSE
ÉaÎbba	FALSE
abb÷ÂòVØaR°¦	FALSE
abÎ©bÔÞÂRf¥ñam¼ï9	FALSE
ÈSH2ÅB´abæba½ÊI	FALSE
abba	FALSE
a×D¬bÅbca	FALSE
WAGanZbb¥®çA«ÍAadÂdg39×ùÖ	FALSE
ÑaMbó4èèh£hác¯bÀa	FALSE
¡a´Ñzä¤Wz×bb×ãöÇQÎaÊÖxK	FALSE
Èaî­ØYhbÁqbralið	FALSE
aâÆ7¨Ôp¹bèTµéSNÝyJßVgïba	FALSE
arº1×Ë99b¢äé×ÖyNob¶²9aðá	FALSE
abbTa	FALSE
a¨b6ÂÒboa	FALSE
abzbÔaXÑ	FALSE
agÝëexbLÁÙÛô§bâamMËD	FALSE
ÐabbÙ¦¥ÄfaÎVç³ôRE	FALSE
a¨bEbfa·zJ	FALSE
xqCab4b3Æ9ÃëÉíìÕÓaòÏ	FALSE
¹EãabùbÖCa	FALSE
òaìÐD­ÓbñgbAp¤qñ4ã±aø	FALSE
ÅÁabFbaÐ©	FALSE
aÆbbaÍsA	FALSE
aX9ÓbÑgbaÍ6X	FALSE
ÛabÒbU§ayw	FALSE
aHbbXMÍa	FALSE
a±JcybÚ©baQ	FALSE
Bñ¡Âabb¢©¤a	FALSE
phóaÉvböb¥ayt	FALSE
SaÍÂbYs¿bç­I¨ai	FALSE
a¥¤ò8dÊ·b¦nCmbQ°xa	FALSE
»¨KãPPå¯K÷aÅbbaµCÏ	FALSE
ïpaõò76b·b¦har	FALSE
¢EJoa÷bbFa	FALSE
óÍaâº¯RVbFKW¾iÐÜb³³°Tau°	FALSE
aäeòïAÒbÝbzP5aVN½¯ì	FALSE
È®ºbayözJbù»Öb°SâaïÍøðÇ	FALSE
Æ5aØ®È£BbÑÇbfRoçò°ó¼òa	FALSE
3äa³bãäêÁJÔba	FALSE
abîPîøbÉÇJ£a	FALSE
²GHbWÄ£§Ôae7b¾bc¸Aa	FALSE
aêbba	FALSE
£8ØJaînbba	FALSE
abÓbVaç	FALSE
ÏabbQÈoØa7®	FALSE
a·øbãÓõqlÝuVèba	FALSE
mOa±ß2Ð×¼Ábs1©æ¶cbG¢¿aëõá	FALSE
øabÉÀX§baà	FALSE
³ÍÀaäbzL9b£MaùR5SñÒ	FALSE
aÇbÝfÙAE³ubðfWIÑpYFðÛõâa	FALSE
ua¼Ïb2bðamÆ	FALSE
¥aÓçbÊk¢O¨ØìMbçaóÆV¸	FALSE
abbèa¾	FALSE
aêbê¡¹ßbkçËa	FALSE
acðXbpb¦ÛaïpDgÐ	FALSE
La®bWChba¯	FALSE
ÇÁÚa¶r«bba	FALSE
c»Ë7©äaZU«bba	FALSE
uµqÌaØ7bbkÒÌ¤a¹­Î	FALSE
aºKñ8bÎbyUaD¶ÖÞ	FALSE
abLba	FALSE
÷aÇbba	FALSE
abba	FALSE
«YopÊ6Y2¼aÆpbbéa¡pÍk	FALSE
1aùHbßbbËWaç¥É°±°	FALSE
çèahbRáTòÓbºa	FALSE
a¿ãV£òÜ¿ß9Þb¯XôÛ¾IbaZâQÙÃ	FALSE
afèpoaib¿âòÅ£wbB¾aOí¡	FALSE
azbba	FALSE
²ãlaFbjÚÅª1G÷ubaà1E¾lc	FALSE
Åàabäba	FALSE
GabÙçl8»µ¾lÊTÊbaf	FALSE
ÄÒabC«LUøbÇaJ	FALSE
abba	FALSE
Øa¯bbÃYa	FALSE
xraöQQë¹Nùbr«£ÍÀmbøÚ¸ilaA	FALSE
aÐb¸¸cY¶ð943y©baÆ	FALSE
pab¹JU¸ÊbmaåËÛIQÅvªeí	FALSE
ó·eañòbba	FALSE
sÞja³Eybr¯b¬aÏ	FALSE
awAbb£aS6Î¬Ã½k	FALSE
aab¹b¯³a	FALSE
ÇKßovÓßa¿gbZb7õ«asé	FALSE
½aáÚ´Vb­wGbæeaãÄBâ³	FALSE
abZàtàØÕb6a«óa	FALSE
aØN©ÏCb¹ÀêbÄXAÞa6e	FALSE
voa6Éfb£¬bÈØÃKçx¥BQÑE8kaN	FALSE
qaIbbL°a	FALSE
abbam	FALSE
abIwÜÜbDaÓ	FALSE
a½órbCI¬xÀ×ba	FALSE
íV±DÏ9aenb·Qùàzfba¡Rw6Û	FALSE
ab²­Fnba	FALSE
abr44ÚZbÒ¨ïaòQ	FALSE
×a¾37ðbjbB7ìa	FALSE
a§ÓbÃT¸±¡ÍÞÙba4ÄÉ¦ap±ié	FALSE
abÞÏTbo«xãaRÂ§	FALSE
ómia¯Rb±«î¡3ba	FALSE
ÌñÄ¸ÔaàbYböaåBuäóø	FALSE
xabEba	FALSE
abÙUòb³©Zwq4§Arag	FALSE
¶¡¤aõ¹õëFïbªbëÓº´îæaÆëð£	FALSE
XíaNJmbCbÖa	FALSE
öìaWàhÏw¤fsbbîaD°ñ¤	FALSE
abba	FALSE
sM4DÓ­8ipÌabè­bDaîqÙ¥Aï²	FALSE
abÛbN­a¡	FALSE
abêba	FALSE
Þab¤zbaJ¹Ìð	FALSE
óqatËßhénVPébÚÝR1ÝbaRAbb	FALSE
Åa­fbUéïºÅba	FALSE
åbFFCyua®oÄªíwÀÍyébbab	FALSE
ìabba	FALSE
ÕWÇabTibªPTÑaaÍ	FALSE
auI¶bÜÊPbóÑOap3F	FALSE
ÀãRaÍmÓabäáSìYæbôaïaÅ	FALSE
DaÕ«bvkiS´bRa	FALSE
abba	FALSE
GabIbae	FALSE
aSóbba	FALSE
p±Z4ÊaÝÖ4Ób«Wn°ò5Eba	FALSE
Va93RTéLbâ«ÆØbzaB¸©	FALSE
·÷uab÷f×Àï7ðñlQi¤bÜ½a	FALSE
Ï¯ùa±7Jb1¶ÖÕ¥õnba´r½Rt	FALSE
aIbbv¨µaÓ	FALSE
aoÓbbaÝ®	FALSE
aÖbb¦³ì9s9¡Za8×ÅÂò¡Ö	FALSE
abbaä°¦ó9N¾L	FALSE
PJäwaÅónx®bïÐ­ùàÛÄzIùcba	FALSE
abba	FALSE
pah¢Ës§·WpÞ¸«óXÚÓsbbëçôa4	FALSE
©GmaÝà­bÈÌbößaí	FALSE
ºÑJ6ab¿bÕÃ³ÌÔaÀ´nZìÎ8ÕñB	FALSE
aØHÛvbÛFL²æXá41Üb3a	FALSE
Byßa±¾bÇbÏÀ¨BAl¸oaðàº	FALSE
öÆ¼ùarbXbza¶	FALSE
fIµëôÉZô»ïabbÀaî	FALSE
¸abbMa	FALSE
µÛaÆ²bb4èa÷Êî¼Wº	FALSE
aÚÛbban	FALSE
aUñbbÇ3²òbl6§aÓ	FALSE
tfI¯óaGb¦bQ×PañáJ	FALSE
Zíï¹ÖaqÆbôÞnbªéa¤Å	FALSE
òB¾ÆaAbDb«Ca8	FALSE
¾ÉSjaÅbb°aCCdì	FALSE
abåboòùa	FALSE
a4âã¹àbÕ5ótjbarbHå	FALSE
aã»ÆFbVLËbaDÑi	FALSE
aºbìba	FALSE
ay5éR2­ãvn9bÄGÄÍbÑOaô	FALSE
aA°bVq¿7§Ñ·®ñ³rªbKmra£sp	FALSE
abçbaq¤µ	FALSE
âabQbaZ	FALSE
ÝPCÓqwìYaóbD¿ólb¸Uæq®a	FALSE
ÆFÙÛaPbå»ö¹bðia¾3H	FALSE
aÙQbba	FALSE
ÅajÚ×KâbÏEhÃSaâbQçCD6aµu¾	FALSE
Áî¼aÐ¥õS4ÚbÜõlÊ¼Zbua	FALSE
iÏãÊµ»´ÉÄºabKWÛbsça	FALSE
a¶Ý¹Q½LmrÆbÔuW»Õ½b­a°	FALSE
aÞÉ2ðÍbbéÇ÷a³÷y±·ºªÊ	FALSE
¿abbãæa	FALSE
ÕÉnøaíb­ÀÆbuä¶¾a	FALSE
ù9a·b¶Nba©Ûµ	FALSE
aBbbaiº	FALSE
©öW¤ÐíÉÔa½bb§»ÜÆù¬¿Ïda´	FALSE
§JaJÐP¨¯Ä­Cb¹VWbdJÐFba6¿Þ	FALSE
abbµaÞk÷	FALSE
abõôzõ°LÅàNô÷¸bRqÔaª¨hì	FALSE
aä3bâÌ6P¾¤OùbM¹Ïa	FALSE
êVBaì»ÈQ·Õ8ÒbY©×ba	FALSE
6aÐTMbbaTnrtR§a3©ÇIÍ¨JLHB	FALSE
Æwa»GbåÂDXòa×bPaÀK¾Di¥ßÛ	FALSE
±Gö3a¢ùºu­¬GÓHb»²b·a±m	FALSE
ßabbÙa°¡æL¹¢ÎÒÙ	FALSE
DöbvaÚbba	FALSE
ðÆ9a9lb3WwoùPìÎba¤	FALSE
Ü¨jabnbQaKec	FALSE
ajóQÚÂbkóÛbas	FALSE
BàazRpØbb¯ªWÀìrßa	FALSE
6ab5b¦¦ôÔªamÇ	FALSE
ÂÁaSÌèçêbñÐeba»Ð	FALSE
R9laèë­³ãbebÚô¥ßvía	FALSE
¸ÚrÙGæUÍXì¨aËÔÆbbSèÍ¬a½	FALSE
çabøbyaÞ»	FALSE
kaFlbÕxbÀÏZa	FALSE
abba	FALSE
Å°4ÐË4£®Baïb5aÎ½ï©¡Lb5jXa	FALSE
aÈXÍhEbPbÀuAYd9Äat	FALSE
ªÆW°abÃ8ãbïla½hêfù	FALSE
aÕbÎ»¦ª¸ªba´	FALSE
ÜabF4¼baµ¿zZò	FALSE
É¸ZLabà3bòövE¢P¸ÎË3îaßO	FALSE
raªÉc÷¾çibd¦bL9a	FALSE
aGbPZÖCÇEÁµdoïqÖb9°aN©LôS	FALSE
Ö2´¸a¢EbUba	FALSE
a»Ø¹bbQBa	FALSE
âÊQ©aL»ÃbOögïbk³a»	FALSE
abbaÒ	FALSE
abba	FALSE
ðØ4qVeaaìb6bàÃaÔ	FALSE
aW3yNcsyeµxU£¼3bãöb³gmar	FALSE
abãå¿jÌb¯882aRWï	FALSE
iabwbaËº8	FALSE
à­5¬Ba¾b¸ùáâbZÕÅ¶ÖÝoaá	FALSE
öa°¶ÅõbFbXat4I¬¬47òp	FALSE
ÜóOaoñËÎbb·Gfa	FALSE
QëêaðçbÍâbÄa¶Ï7	FALSE
aOÊb¤ba	FALSE
NÄÐabÈbeaÙ	FALSE
hô´tabbJ¬XÃn¤a	FALSE
Æªsõ3dSa4bfbap¤²Þ´D¡xî	FALSE
­¿ab´IbD¥C«÷Ga¢î­	FALSE
aRTb3Ë©ÜãbÀïÎÌºÞa	FALSE
£mNlau°tköruU¤ÏbbdaÑ¯5H	FALSE
´abbaAe	FALSE
Ð÷a¤¡æOÎObhbaPÃ	FALSE
R¢aáRYbÌ²b¦s1ÐÜaÝ	FALSE
aÎÖÞâbOèe¶Kibga³ZT	FALSE
LaÆêbÑrbOaÌ	FALSE
åUabuvNQÉÙBÑX¬àaF´ZbQÑar	FALSE
ÒÕG7¸azòºx»é­b8ZYbK»¿a	FALSE
ÂaåõTbÎbqaò¾ë	FALSE
vÎ·öQa±bbwa	FALSE
¯Ýalï¤¥yWò9Þ7¤ÛbbæébaP´ïC	FALSE
Faöõö¦Ñb¿SbæWaB¯J	FALSE
Bea¿ÆbbB±ÎtàKØ8wXaøÊöµÅø	FALSE
aªjÈFbbÄÕf´L§nã±±õJÙa	FALSE
