ac	TRUE
ghehfifdehfghbajgbeic	TRUE
deegaehfd	TRUE
dfeb	TRUE
i	TRUE
j	TRUE
cgigfd	TRUE
ajfd	TRUE
cegefgjijhcefabfgdff	TRUE
cb	TRUE
cgbeiicihgdiffjced	TRUE
fcdfdjgddjag	TRUE
jdb	TRUE
hagheicgjfbjgjbgi	TRUE
gbjh	TRUE
eggddjejfhdfbgid	TRUE
hchbdgfccfcagiedd	TRUE
edhcccebigigdgbdjgch	TRUE
hfjhg	TRUE
gecaigcbcdfhhgdfbidhbije	TRUE
hdciajjidjijfh	TRUE
ejfhfbjhcaieedibffb	TRUE
d	TRUE
ah	TRUE
dcbeaied	TRUE
cgh	TRUE
abcgb	TRUE
ibiahgjjadffidbchihde	TRUE
fdc	TRUE
hhhhedbfjffbihhd	TRUE
afdjbjjgc	TRUE
efcggjdbdhj	TRUE
hhijjh	TRUE
dd	TRUE
afehececdcigdabddgg	TRUE
ii	TRUE
ifdajed	TRUE
ehafadehbacgcacjj	TRUE
diefhfgechfejbgg	TRUE
hcjhgcaiaj	TRUE
edhijab	TRUE
hdidffgbjccifhegfj	TRUE
g	TRUE
jdeiijjiface	TRUE
idihicbhjfhb	TRUE
aifcfbhcjg	TRUE
hdff	TRUE
acfjcjbdcad	TRUE
cbicebe	TRUE
fgbhajidhchgjhaehd	TRUE
gfiajhfdebiedbdg	TRUE
ghadjbadi	TRUE
hjachgdfejcfdjjhhc	TRUE
d	TRUE
cieiifefffegcei	TRUE
jibjchccaeabdcebcjjfdgb	TRUE
ieibhfcbfgchfehcfjc	TRUE
dbhjeifjggbichehijf	TRUE
jcd	TRUE
gjefhecdbgaghihg	TRUE
jcjjhfbacehijh	TRUE
aicefigf	TRUE
ibdecahhbhjfijgjfcigjj	TRUE
jfeiigigjiaejgegjigjhgdjh	TRUE
de	TRUE
hhdiieiadfcbjdegdgcabf	TRUE
fab	TRUE
ejihaidbhcjbhedccf	TRUE
egihgfdefijd	TRUE
g	TRUE
fdacjeefcdejghhigdcc	TRUE
gffj	TRUE
fcifcfccfdifihbifh	TRUE
jgbfcgigdcahgjheee	TRUE
dfcgbhjebiefgdii	TRUE
iajdddadjcaifjbeafee	TRUE
cicbigbjgdedjgeifde	TRUE
djjiciggibhd	TRUE
jadjif	TRUE
ibddgadidjgiecffag	TRUE
dhhf	TRUE
jagfcdchejdddehibjbi	TRUE
ccjdcdjibebfjjfe	TRUE
dhgcechhbfhiaddfjfb	TRUE
daj	TRUE
dhehfacj	TRUE
hjcdejfeaedhhd	TRUE
cdcafdab	TRUE
ffbcfefafefh	TRUE
cfihecegdefdhiggjd	TRUE
ddh	TRUE
debi	TRUE
acdi	TRUE
ijgibigcbdj	TRUE
cgigcaihdeajhahbibj	TRUE
dbadijihaecijjige	TRUE
fjcicbedghgjibadeggfjfcb	TRUE
cddcbhdbcji	TRUE
cigbijgbghgjidbijicgjbib	TRUE
habdeejiice	TRUE
ichdfacgfffaheedadbjbgg	TRUE
jdhhhicgehcigidgg	TRUE
ggjiejiegf	TRUE
g	TRUE
gadcd	TRUE
jdabjibachcgdhijdfgehe	TRUE
cahhegbfcgfggfhcjabeg	TRUE
ibeejaej	TRUE
afiaihbhhcghj	TRUE
ecefh	TRUE
fdfdccicgfd	TRUE
cfgcige	TRUE
cf	TRUE
ijfhgfbcceegccecfhd	TRUE
fbifeijfegeh	TRUE
hchghbebcdi	TRUE
cgefhcffccffjbgeefcbffaih	TRUE
cfijhgeghj	TRUE
c	TRUE
adijihdjheceg	TRUE
c	TRUE
ihdebjgiihfdff	TRUE
cheihjgfhbabhdeabjjjgiaj	TRUE
heicdcdhhgbihgfbdc	TRUE
ebeahcgbaidd	TRUE
eceajccbejjgabace	TRUE
gdffbjbfceeidgabi	TRUE
hihfhjebcfjae	TRUE
cgjehjifjdfhe	TRUE
hgfibhajafacedfbhc	TRUE
chgehefbjg	TRUE
fchahdghhddehffdeeeejah	TRUE
edchfcbafcchjgahjgafbaec	TRUE
dgafhdfehgbjeiiihhfaiiae	TRUE
egffajgffgfhbgjdc	TRUE
gcceggicehbcb	TRUE
ebjadhfahjbchcebijdcggde	TRUE
jhjbagjfffi	TRUE
aehgdbabdedb	TRUE
ae	TRUE
ggjeebcjhgddddgdffcbcde	TRUE
cbgbheifcigcidfdadjgg	TRUE
ii	TRUE
djgjfedfhbdadbcjeiahdd	TRUE
ihgj	TRUE
ajdicf	TRUE
adc	TRUE
fgdeabfaebdgbffebahcicd	TRUE
aedbggedegjeceehegieeaihh	TRUE
ddecgcffeihdfdfcggjci	TRUE
hcjecgghfachefeajg	TRUE
hdddfjei	TRUE
icibejdcgdjdafdjdgjc	TRUE
debdjajaggfffgbcgbfgig	TRUE
fgeeibjhbhicbhbdebcbdj	TRUE
jcaehhcac	TRUE
icfbfhjdbehiibdifdachch	TRUE
jbgdbjag	TRUE
dhjcce	TRUE
jheccc	TRUE
fjcagjigice	TRUE
ehbhcedheied	TRUE
aegeccccicjgfccfaeagjg	TRUE
afhiceibfijgajjbh	TRUE
ghaigjfac	TRUE
fdcaieeafaidaccgafhhhfhb	TRUE
adhhcdigji	TRUE
jggefdfbhijhhebhcc	TRUE
fffbejdejhhej	TRUE
ecb	TRUE
ehage	TRUE
aigg	TRUE
dfacgafaedbfbacjihh	TRUE
ddiahf	TRUE
caffdcbjefbhgddbcd	TRUE
hdihf	TRUE
dcigheehbaiibgjafjfgfjhf	TRUE
facbg	TRUE
efb	TRUE
jjfihadiiae	TRUE
hgedhaeabggigbcfhafe	TRUE
d	TRUE
dchhhhjbhajiiai	TRUE
jgbehajchgjhchdfhibjgd	TRUE
acejbeaf	TRUE
ahdhefjjagcacache	TRUE
hehid	TRUE
hbhigihggcdd	TRUE
idhahgggfbdbhejghfgd	TRUE
e	TRUE
g	TRUE
dheece	TRUE
aiiidfhcaieegdcbf	TRUE
dddigeihdjbdfhhb	TRUE
jccegbdcaicifibeaeidbeei	TRUE
dfehdjjhidefijdagahaijjg	TRUE
acjdebe	TRUE
hgdjdhhg	TRUE
agdd	TRUE
fghajajjdfbihiidahibddg	TRUE
feafdheegbjdihhih	TRUE
cjigfc	TRUE
gefdddhddabcdegjhddhf	TRUE
deegbihjfhgecedagfgdhjfhf	TRUE
ahgcgfbfbeadjcfhgfdfee	TRUE
jidgffbchcfbiddijcb	TRUE
abcbajaebddbhdgdibchbebdf	TRUE
cfgi	TRUE
hhfbaebhfagifdb	TRUE
geffhhcfjbjfjhc	TRUE
jggfbaihbdff	TRUE
ajgfjabajcihdej	TRUE
ebfgeajacd	TRUE
h	TRUE
feicfcfigaeff	TRUE
diaihcieiicbebggeijae	TRUE
igffcjadedhihidf	TRUE
fgehg	TRUE
jhcahdgahidfeabaghgjji	TRUE
hddbgccbcdiibjfajdi	TRUE
ggcaif	TRUE
dffdhidgiigcgihibgahbgj	TRUE
aehfdcibcebicje	TRUE
ibadbgfijifbfebecicjifbcg	TRUE
gbadjgj	TRUE
ccffcjccacgiaeiijahe	TRUE
jacgceej	TRUE
hefhciijjf	TRUE
hiff	TRUE
dbcdj	TRUE
cecbg	TRUE
aiec	TRUE
jdhiiegh	TRUE
jcehgfbac	TRUE
fdbieffhjebadabdb	TRUE
caeejiahjdbggghfafffgbcg	TRUE
jj	TRUE
jcafgdahjcdhcibhgedcdh	TRUE
ijgjaei	TRUE
diaeihedgdcaggihdihbcffj	TRUE
ahjcfbacbj	TRUE
egiccfddjai	TRUE
gjcdiaj	TRUE
eiccbd	TRUE
ggjfdgdihhbgeiihbjdjf	TRUE
ch	TRUE
dgcjifc	TRUE
eajhiaeedijcejhcgidheeb	TRUE
jagajahgjehhf	TRUE
dihhhjeagd	TRUE
jfhdeafjifgjhbe	TRUE
jedacabccagjhgfaifaib	TRUE
hj	TRUE
eajiccfaiaddgf	TRUE
hdjeajgjafajcfdeig	TRUE
jaccefbcaedeafhijaeb	TRUE
hjfacbicb	TRUE
gfhdbjh	TRUE
fefjejgfihiadj	TRUE
cbai	TRUE
fdgbjiggeffjfbcaegceiceb	TRUE
feadbcgbgcfbieaebcehgc	TRUE
eagcbibfdhjjjgbhaihjjjjcd	TRUE
djgfeeadecdjeh	TRUE
jgjdde	TRUE
igfgacbfjiadfhhhi	TRUE
dcheadefhfc	TRUE
ffbjdbdgbajfgdgghahedjgh	TRUE
fdhgfjejcgabj	TRUE
dccigidichdeajadafbe	TRUE
ahadjehjjfehebibcgie	TRUE
cbghdcjbfdb	TRUE
giaffegceicghfbebcgcj	TRUE
faibdbecdc	TRUE
ibi	TRUE
cfgjeeebhffgifdccjecbj	TRUE
aeeiee	TRUE
i	TRUE
ggadbdefdfhhjbdhdj	TRUE
jceififfjdadbcahdabdjfcb	TRUE
gjb	TRUE
acddjeijeebigaee	TRUE
cbifdjafajbdjcigegdbgib	TRUE
hacajif	TRUE
heieijjjf	TRUE
aehcjbaeg	TRUE
efidibhhdcif	TRUE
ch	TRUE
hidajgegcgfechbaiafi	TRUE
dbi	TRUE
gacdacghb	TRUE
hgjbc	TRUE
fggcbcachjhei	TRUE
ahefjdcibcgeafcc	TRUE
cd	TRUE
iidi	TRUE
jiddabcfiejag	TRUE
hajhjbiii	TRUE
difbc	TRUE
cjhcfhheefhghagjdgbje	TRUE
ebcdeafegg	TRUE
fgeeebhdg	TRUE
ciifcifdacefgedeefigch	TRUE
jdacedecgjdaidjeaihfegh	TRUE
gibaiabgiaehebf	TRUE
ggiecicjhcacicebacejd	TRUE
gcfhaefcddddgjjgbdghbgjb	TRUE
c	TRUE
dbcaj	TRUE
hidicdeeicjjfjbfhbaii	TRUE
gjicjifcbigejiedfdgc	TRUE
gddgbcbhjhegidhghhehchcfe	TRUE
dcgaifif	TRUE
gchbghjjffjehefdebdhif	TRUE
jhcgfgdeg	TRUE
jhhbcbf	TRUE
ee	TRUE
ajd	TRUE
fgjjedeehggchcdggadgh	TRUE
dccfcbgiegehhb	TRUE
gdbgcddfi	TRUE
edfgjae	TRUE
ggjhjjabhieijehjfjgifaegg	TRUE
hhjhhcifhahcbhhbhif	TRUE
hiiacahjaciiigcdeddjcjj	TRUE
ifgegbjbgbcbe	TRUE
ccbj	TRUE
ggciffgejhafbi	TRUE
ebadchhj	TRUE
cbicfafhfbec	TRUE
icbdchcgfgdijjjajdgbhfb	TRUE
ficbijhijfe	TRUE
cbihccdgcj	TRUE
hbjeaiicjgjdagcgfdciegi	TRUE
dccffcjfhgi	TRUE
dcfehbcdbjif	TRUE
cieajajdebadeeiihgddhc	TRUE
dceigbigbah	TRUE
iiibfaffidjhajib	TRUE
chjcddhfbhdjei	TRUE
dfahjjgjifdcajfbdd	TRUE
giieieaiaiiahdfeaehcce	TRUE
jjhgf	TRUE
gbi	TRUE
hidjeghahfgfhcd	TRUE
ijdiicgebdgic	TRUE
fhdddbhhhegigbgdh	TRUE
dageibifffcfjaifbecf	TRUE
dcachifbdheggjgedhd	TRUE
iajcfce	TRUE
cbgjgagbciajjgcbiahbgbe	TRUE
gcheibifffjifbfdgifdf	TRUE
acfcjeddbd	TRUE
ijdceg	TRUE
hhjade	TRUE
abicgghebfjjhacihcbcfhc	TRUE
cefeigebgbcjfgagggd	TRUE
daghcfjbibgch	TRUE
ebhccbgdgj	TRUE
degafgdehfbcebhfefggjj	TRUE
feajcjcfjibaj	TRUE
fgjfedgjfcifbhfhjhjfb	TRUE
hjceihibh	TRUE
eebcdfafbgjcijgbjgjgfebid	TRUE
iebccfbjdh	TRUE
fbejacdbibijadiccaibehije	TRUE
acgfjffgbeibajgjcg	TRUE
jjhfjigdeahbhbddejjihfc	TRUE
cafcbged	TRUE
fhijjfecfbgcaegihid	TRUE
iehajegcjfh	TRUE
ddgafdgeaihhef	TRUE
iffffbfbijhjeibf	TRUE
cfafecedbjcadjcfcjaebihgd	TRUE
fdbiahfgbidjbgig	TRUE
h	TRUE
jhccc	TRUE
dbchad	TRUE
feehbdabccjfgafjjdejfcd	TRUE
jibdiddcc	TRUE
acdbhhccb	TRUE
eeeaee	TRUE
h	TRUE
cfjgccbjacgccedgd	TRUE
gfeihafi	TRUE
fcddbgjeeeidhahjeciib	TRUE
giji	TRUE
fjjjahbgaiijjbjfacdhjjebc	TRUE
idbffjeefchgihig	TRUE
eabhfjigjjgdajficdee	TRUE
dacib	TRUE
ihgcigefgggegeag	TRUE
jicficbhfdjhfegjjcehajdh	TRUE
agfhgbehdj	TRUE
hjhfejfhifbhiaegghagh	TRUE
iiffebjddedebefhfgajajaf	TRUE
hgdhcjadceddffjbeedac	TRUE
dfhiaihagbibhdf	TRUE
cacahfcfgifjddf	TRUE
hcificefhciigjd	TRUE
ebfeafchbgigh	TRUE
dgachjhbaceejhd	TRUE
gab	TRUE
acdiidaiebgcbch	TRUE
ihfcedigccegchdbdebeagfhc	TRUE
edffcibfiaiifgje	TRUE
gjiedgjgif	TRUE
d	TRUE
icceabdfh	TRUE
hdebhgihdjgcah	TRUE
cbdecbcgddhbcfdhihbccfcji	TRUE
fcfjdi	TRUE
jhjbiefecebfgibcaic	TRUE
eb	TRUE
efeghachdjb	TRUE
hg	TRUE
aeifhadagifcgifgb	TRUE
ifgg	TRUE
dihgbcacdcfcehcfecd	TRUE
adcbaeghchffbecdghggdg	TRUE
adhfcejegjcajagefddj	TRUE
jhfidefhjaehjhdhfgb	TRUE
fbidihigcidc	TRUE
ggdgiajfebciafb	TRUE
adecddche	TRUE
jfbjbjcfiefag	TRUE
gejfgggjghegjjhaegjaijfhj	TRUE
hiifiggfjfahebei	TRUE
ahdihdadjbihcf	TRUE
figegijejjeibegeh	TRUE
ejbcdigjejjfhbjibh	TRUE
fhghdhgeh	TRUE
gjbibgfeccbg	TRUE
h	TRUE
ifhcgcdjhag	TRUE
jeccjcffihgg	TRUE
gcj	TRUE
ebabaidcacadcdfai	TRUE
hceadgfg	TRUE
jaehggh	TRUE
jc	TRUE
jcefcddhedecbji	TRUE
ehajgjdedifff	TRUE
idcfdjeghhgfccagjijehcccf	TRUE
hafcebjffcibai	TRUE
ecgegbj	TRUE
ibibccgbcidbfagigjhgajgjg	TRUE
fffbcc	TRUE
gcafiagdgdebcadc	TRUE
hhfeabeecac	TRUE
iecbdjdjgfiicfaghiegfibhe	TRUE
dfbebdc	TRUE
aid	TRUE
ahijgfhcdffb	TRUE
hcgdddfbhhjgdjjdbaeaff	TRUE
ii	TRUE
gehcebidjcdjdbe	TRUE
ehajfhdeahihhbd	TRUE
jaibhdicebeabcb	TRUE
gcjebceigbhhcd	TRUE
dabdbgcjadbehh	TRUE
fcacihcjieachhhdjeagaeidf	TRUE
abegiahhddeggbeihgjaefbh	TRUE
ac	TRUE
dhjebiicdichc	TRUE
agieagcfbijgbc	TRUE
ihhdagbc	TRUE
djc	TRUE
ejaeibafbdefceaceagdhci	TRUE
hedeabj	TRUE
faeccfd	TRUE
j	TRUE
gfcbfbgjadfjai	TRUE
eiijejfbcdibacjehc	TRUE
hdceaiccgdbigcibiec	TRUE
eddhgeeadibcc	TRUE
cbdegidejcfbehbcffbg	TRUE
acec	TRUE
ifdfgddcdg	TRUE
iefjcfeiidbacche	TRUE
fbciffefbjdcie	TRUE
ecfdddcadccadgdhdcdci	TRUE
cabgcfei	TRUE
jebcaibaifegghf	TRUE
iciggj	TRUE
iifefhbfhdci	TRUE
ehahaeah	TRUE
ghbdgifaijfdcecgbeh	TRUE
idjfdibjeg	TRUE
afeji	TRUE
diafahiiacbgigibhijj	TRUE
fhdddefigbecdeiaibcijag	TRUE
hjgdh	TRUE
fgbeedfgjehgeidji	TRUE
geaihegbgabgfgaihifi	TRUE
jjbjjabcgjceei	TRUE
hfdhi	TRUE
acgbgafc	TRUE
iegfgee	TRUE
ddc	TRUE
bcbdbfbcehh	FALSE
hdhbfa	FALSE
aefjjbiigbddibbgfhaac	FALSE
aaahidjc	FALSE
gehabahgaidebbfdgfbaje	FALSE
hiaabaejdcggcdeje	FALSE
jjabdicigjchibaa	FALSE
bfbeffdfiejgaidfi	FALSE
bcgegcgiiciaifjffhefehgi	FALSE
bfijbjfedib	FALSE
bdgfjcideajceec	FALSE
fjaejaha	FALSE
bjhb	FALSE
dbejjgaba	FALSE
igjdfhicga	FALSE
cbgibjbiga	FALSE
b	FALSE
bjadcidgjgh	FALSE
ghfdccfhfcjeiehjdddgfgafa	FALSE
bihieeeddedfjc	FALSE
afbdfdcgcdjigdccaacdh	FALSE
iejiafbjjfibaahfbiifj	FALSE
ecbdfdiha	FALSE
bfb	FALSE
bbgijchdbjbg	FALSE
b	FALSE
bdadieb	FALSE
bea	FALSE
hgbhbjgjdhajihiddhbccacda	FALSE
bedgejjebaegggg	FALSE
bdgdfbejfg	FALSE
gbgijgddifbbeceicab	FALSE
ghebaia	FALSE
aigdjjcaaaidbdhhaic	FALSE
ahgcjchbjggbbga	FALSE
hbbihd	FALSE
iejghga	FALSE
dcbbebhabffjcdbehijjh	FALSE
beaadfaaebhhic	FALSE
bgabidiebge	FALSE
beifgfjbej	FALSE
hgjaibaeididghdeajaac	FALSE
bbhbfbbcghiiejfaejic	FALSE
didaihadidaiigciidbbgigh	FALSE
jjfja	FALSE
aeiadbegcffahbaahaeihbdea	FALSE
bjadc	FALSE
bddigjbb	FALSE
jdaaaicfbedgbjcjjgghaadhd	FALSE
ia	FALSE
jcfdibagjbdabahffbba	FALSE
bjc	FALSE
aajdcaecaiaajfeadhdifd	FALSE
baiefebacieaddb	FALSE
habdbihfdghbaa	FALSE
bgagcbcghegjcjchhbggf	FALSE
aggga	FALSE
jgjacgfa	FALSE
iagcjcdaiicfgheahdea	FALSE
jjgfgbejcbcbbi	FALSE
bg	FALSE
bb	FALSE
aaebegdefgiijhjfhgf	FALSE
diaga	FALSE
bcjcjdc	FALSE
bhgcdabggaiefbabhecbcb	FALSE
bejhihhgahhhaihbgae	FALSE
hadddjbbcfhb	FALSE
gga	FALSE
bgeejdeifebgfhajjgbi	FALSE
bc	FALSE
bfgcjbfdiecgjddjbhdjefa	FALSE
dieebbadabjhg	FALSE
figjagdbjiaagd	FALSE
ccibbdahjjidaiaf	FALSE
fccgaafjaefcf	FALSE
fehbiajbbfhdadjcehbg	FALSE
bf	FALSE
bjefgcafdjhegaehbfa	FALSE
idjcfhbhbjijdbbfhhegj	FALSE
bbjfajhffjfhcecjfegcj	FALSE
bdaacfhgcfbddgcef	FALSE
b	FALSE
hafieia	FALSE
aegfafhaagabc	FALSE
afcabfjaahifbgdaahhjicc	FALSE
defjdedfca	FALSE
bchifcbi	FALSE
ejedbhgbhcihijabbd	FALSE
dcdagjja	FALSE
bhj	FALSE
bdfgjh	FALSE
agaabgeij	FALSE
ceaafiejhcdbfihcaeja	FALSE
bbbddjeji	FALSE
heafciibbdhjgfddjf	FALSE
ifgdbafcbhjebcfggahdfdea	FALSE
jdeajidebdccfcjda	FALSE
bbfjjdhafgfcac	FALSE
eheaidgdigedfadhbjaija	FALSE
gecfa	FALSE
gadfijjhhbaaibcjidaajggi	FALSE
hiciideecjbbdbjeiehafbibe	FALSE
jhdiffcjfheia	FALSE
aheahjdfdeeibifcga	FALSE
bghhdhgagccaaebjghfb	FALSE
hchbjha	FALSE
bjeeca	FALSE
bcifcfigjbbgi	FALSE
aacfaiib	FALSE
bifd	FALSE
gifa	FALSE
bddfgdhcace	FALSE
eibhecaajad	FALSE
ffhdbeccgaiehga	FALSE
aabebbaffffiafifebjcjgfad	FALSE
bdjcfahefaaged	FALSE
dfdajdfdbbabegaiaahbebfd	FALSE
bajd	FALSE
b	FALSE
jaaif	FALSE
ja	FALSE
jafgifhgajbcbceabdefhha	FALSE
eibibbijhaadbjbgebfab	FALSE
bbhadhcbegbaiehjhj	FALSE
bbigfdg	FALSE
a	FALSE
bcfeefd	FALSE
bcgcbbhij	FALSE
dea	FALSE
hchhjbaeefjgdgcbbebjiihid	FALSE
bbbgeffcfffcebecbdghef	FALSE
aabaa	FALSE
ibdefibeaigjcgda	FALSE
fbifcjbadgjidfgahgeiaaeha	FALSE
cjagdiiegeafbbabeghbae	FALSE
ebhfhaagabd	FALSE
ibdaagffidhbjfcd	FALSE
aedffgiccabbaabc	FALSE
afhga	FALSE
ca	FALSE
ggedcfjcja	FALSE
baafidacidhdggg	FALSE
bjbbbeafgjgafbdj	FALSE
jbhhecjicgfhbacdafefa	FALSE
jbbjeghdbjaijgjc	FALSE
bei	FALSE
bccidg	FALSE
adcbb	FALSE
diecibijjdcaajfgedc	FALSE
baj	FALSE
bfebdfjaddceceiiggeghj	FALSE
iicaacbaifa	FALSE
bjjjdhdfbcdfeid	FALSE
dfiahggbahhjiiaaibghd	FALSE
aafhbbhhheccehgheigjgeijb	FALSE
hjefbhciehcjbhjiajcifa	FALSE
daijfaejhaabefgedfhchdfi	FALSE
hieiehdfbbe	FALSE
beehbaahfhged	FALSE
jagdfaahcebcbf	FALSE
fa	FALSE
a	FALSE
fjfhhjbbcaahh	FALSE
iiea	FALSE
gdbfbabeffdejica	FALSE
aafhibhecfbff	FALSE
bcbdgeighfigfaidcefidhfhf	FALSE
aegggedbbgceiaddceiagjb	FALSE
ga	FALSE
bbgachfijjigijbfjdifcjbd	FALSE
bejgifabgg	FALSE
dada	FALSE
bcifedchj	FALSE
hhdicjaajhadhi	FALSE
bahjje	FALSE
bdgbe	FALSE
eejbchagbgiea	FALSE
dghaeijfaabaifjai	FALSE
jbbcc	FALSE
hbbcbghjac	FALSE
bhhadagjicegc	FALSE
bdgab	FALSE
cfcibejbbidcbecjccbi	FALSE
aaecghjihibeji	FALSE
iddcgagfaachfffegjiafgii	FALSE
bgd	FALSE
icegaaa	FALSE
aafadifigdachhgicfdfbi	FALSE
gdja	FALSE
gfbdicfihijfcaba	FALSE
edfabhbbf	FALSE
daahhgbbgiahcgia	FALSE
bbih	FALSE
bafahfacbchjefcbbgbiae	FALSE
fgbieaaagg	FALSE
ghhdjiia	FALSE
fjfgbbhdidcjeifhjeeeaad	FALSE
bfhbachfedgbd	FALSE
agbfhgaacgf	FALSE
bdgchigfcjcjceiabcb	FALSE
bfdhjaji	FALSE
bcagihcfeacihdbcihfg	FALSE
djcaahfa	FALSE
jchiacbahebgafbicdhgjgbea	FALSE
gfgfbhfa	FALSE
ahiefbbidjbfegbfchfgfcfc	FALSE
bfbjchdfjdiedgdbebgcf	FALSE
bdgbifagdeab	FALSE
bfebifcgi	FALSE
fajchaifggcadabbag	FALSE
agihcafbiahhgaccia	FALSE
jhdjgcahfaibb	FALSE
ibbdgadaaebiic	FALSE
iedbcaaddabiaacdicbb	FALSE
bchbeebccf	FALSE
hfjda	FALSE
eecicja	FALSE
iacgdfghjfaecbeea	FALSE
gcfchfihihhha	FALSE
aacfhbha	FALSE
b	FALSE
bffhfd	FALSE
bbbdbhaegjeibehabha	FALSE
dfecifjeejjbfehfaaefgdh	FALSE
idecjhgbgfifbibaaidihb	FALSE
cbb	FALSE
gaabhjidbbiijidj	FALSE
jhfaebaadd	FALSE
bdefhgafaicghba	FALSE
ghbaiegffdbjhihhaafeeicai	FALSE
dbjecfefdbbaaj	FALSE
edcfbgbfffdcgjhbhhbbcbb	FALSE
dbbaegdhjaib	FALSE
bccjfjfhchchaaci	FALSE
jhjcidcjjjiibia	FALSE
hggagadjidbbabdibdaidbjaj	FALSE
hbidjcba	FALSE
cacabbaiaeghfcjch	FALSE
ajfaajfbejfb	FALSE
fgfhaacaecbdfcb	FALSE
ecfbcdfaad	FALSE
bdaafa	FALSE
ijjaghfaejafbbjhic	FALSE
cgciccdhgjbbhce	FALSE
ehdfhjjaafffgbihfifg	FALSE
baiebha	FALSE
ihiibbehhcajbf	FALSE
hgjabaadbaiah	FALSE
adgeffdhhhfhbaadhcgdfhhc	FALSE
bhfjifhbefcj	FALSE
aefehjejhjeiidheahiafhfa	FALSE
bjdfgcgi	FALSE
hgficdfchcdcjbfia	FALSE
bdhifhafcgafjdijdf	FALSE
bbji	FALSE
iciajdfagcgfdagaiaejca	FALSE
iaaffigghbfchdccaibj	FALSE
higbcdaheghaffibbf	FALSE
jehfcehebbeicdigfi	FALSE
begagbgj	FALSE
giia	FALSE
accijaijibbcaga	FALSE
hicgbjiccccfigcacgehdigaa	FALSE
bgafgaigbghhieafcbadbbc	FALSE
bggchaffeeh	FALSE
jbhjghghjadjjcfedjbagia	FALSE
jeeahbcga	FALSE
gbadejjaehfjacejjeadgejca	FALSE
bgcchhgieg	FALSE
hcbaaihggjffdcfagbhaj	FALSE
gdbbcfffeaa	FALSE
bdejijbebjbfcgecdccfdfeh	FALSE
aaadgbaab	FALSE
ifecha	FALSE
dibebbefdaeigdibjbij	FALSE
iecehbcfbagicieagidccaea	FALSE
hcbiihhgcgbagadca	FALSE
bgeafidffggj	FALSE
bjfchhj	FALSE
jbefcbbgjbbefacg	FALSE
bjfhjadfcffgcigigfiafibic	FALSE
djhjeibeefjbga	FALSE
bjifehbagggge	FALSE
dfdjjijfajagaea	FALSE
bajbda	FALSE
daaejdjhhgigafciacjehf	FALSE
aabadacgjegbjdeddecfej	FALSE
behbgf	FALSE
ehedjeicbhjjceaafje	FALSE
jicja	FALSE
hheiffebdbbhgigefeea	FALSE
biafegh	FALSE
jjcdjfbacea	FALSE
aidhgbfaai	FALSE
jcbgeggbdbijdbbfbibdbeh	FALSE
adbfdajaehgijejcgbhiaaig	FALSE
abfdegdjiefcighgadeia	FALSE
bjjdghiebebcgdbhh	FALSE
a	FALSE
a	FALSE
gafajfaagdaahccaadjhdi	FALSE
cifijibdibbdjhcfi	FALSE
bj	FALSE
hbfhcbbgafdhgejfcc	FALSE
idbehffaacgjbebigiegfa	FALSE
cefhfefdeigdhjaaehjd	FALSE
addfeefibbbfgdijhjf	FALSE
cheafbb	FALSE
ejfidehhehaafbebc	FALSE
bhdhegcjhegjfiehi	FALSE
a	FALSE
ijgbfa	FALSE
jjedga	FALSE
aaghf	FALSE
feaabgfihehfbjhdhiah	FALSE
aajdhjgja	FALSE
a	FALSE
acggcdaca	FALSE
bfhhbabhgdidedhg	FALSE
afacdfdia	FALSE
cahcdcgbbhgb	FALSE
eidiihedcfbgbbbgfi	FALSE
fbedcdeeddjdaadjaefibgc	FALSE
bbfibhddbdedfaif	FALSE
bgecffddaicfjibhij	FALSE
bidbihghbeiihiabdhc	FALSE
jbcejbfabbidcdffdhj	FALSE
bcbe	FALSE
bjdidcejbifffia	FALSE
ga	FALSE
jchdfhcaeajafedcba	FALSE
iejbbjidbhh	FALSE
ifgfagaja	FALSE
bgjgjfgdachj	FALSE
bfbaddehc	FALSE
djggdbgjfidiaabjceddcie	FALSE
aae	FALSE
baegffheecdhhggdcajicdb	FALSE
jcfeidfbjgbhbhdhjebfgcca	FALSE
bae	FALSE
fiaabcbggbddai	FALSE
b	FALSE
bcfjdegcacab	FALSE
a	FALSE
dcjafdfbcfdaafjgfjcjja	FALSE
aaagbbddjbhc	FALSE
haaj	FALSE
icchigieaccdgfeaidhcdha	FALSE
cbbd	FALSE
biegcjadff	FALSE
eecheacajfgeifdbcbb	FALSE
cfhbjgjihga	FALSE
cifefcgabbchhfjbbhic	FALSE
ibcebjfa	FALSE
jeadbffebca	FALSE
ieadddicjaeajiada	FALSE
efbebicbbbegaibdf	FALSE
iabbig	FALSE
idgaiaafediidadaffhbfghea	FALSE
bcfaci	FALSE
beaaabiagiigb	FALSE
adajffaabiheedfchaeif	FALSE
dggahabbbbdc	FALSE
bci	FALSE
gbcaba	FALSE
daffejaaifjfcghfdfbbd	FALSE
bh	FALSE
aaeae	FALSE
ibbdbbjiggajcidicge	FALSE
hfecfada	FALSE
ja	FALSE
a	FALSE
ha	FALSE
fgfjfbihjfbbaieigieha	FALSE
bbgbdj	FALSE
ggbjbba	FALSE
icihjaahhagafecgf	FALSE
dhejbaahaajfhiaijfbj	FALSE
fehijifchighjaaidac	FALSE
feaaijigfbabjffichbd	FALSE
hhga	FALSE
bh	FALSE
hhceaaiegb	FALSE
bbdaegaaaca	FALSE
bbehgaajdfcgfbbhj	FALSE
bfibi	FALSE
jigfca	FALSE
cjfdbceiaaaiijejhjagajbe	FALSE
fabbaadbhjibaefjfbhchcec	FALSE
daiigdaehaaicbfghjhbcfi	FALSE
cefbdabfjeaa	FALSE
ccciagddda	FALSE
aab	FALSE
cfaaecfjcdcfcdjeaag	FALSE
deabda	FALSE
jdjbcjgihidihjca	FALSE
bjgebedfdbecaaj	FALSE
ehejgbhiaehbbb	FALSE
ihbehgdfbbicffieij	FALSE
b	FALSE
adceadghacdcjjhicjda	FALSE
edhhjfdafhaajcggabafacbf	FALSE
dbjdacfjcaeba	FALSE
chehaaiecedbeif	FALSE
diiefhaajfidifjjacf	FALSE
agihihdgbbjdjadfeg	FALSE
dhga	FALSE
hahbghbca	FALSE
jebbejgfecagaj	FALSE
eaabibgjhgec	FALSE
bebafafagfhceaffhbfcb	FALSE
cedbcihifaga	FALSE
beeeiidcejdjghhi	FALSE
gfdegdfgcgbfhbceijcbbic	FALSE
bdafjad	FALSE
ibihbadfdaghadaadb	FALSE
aagb	FALSE
bhbjh	FALSE
jibia	FALSE
bfbdhgbcbcjiddgabidafafe	FALSE
bci	FALSE
bfj	FALSE
bgaeecaagbahafejdgibaf	FALSE
jgebaafjchbjgchijeegdcgjj	FALSE
cbiihdibfccbafghbihjjaa	FALSE
b	FALSE
bbajeahddh	FALSE
bfibagcj	FALSE
jiddjjcfhhia	FALSE
fadaajfbihjcfeichcgia	FALSE
bbdeejfcdhggjhgeji	FALSE
a	FALSE
b	FALSE
abheicfhcfbdfbbhh	FALSE
bidfbaedbddeaie	FALSE
eijccaaejdjd	FALSE
afbhbbijbhcdhggb	FALSE
jeidfhaahcaefjd	FALSE
fdeagadcaebbgif	FALSE
aaficbehfge	FALSE
bdhff	FALSE
jadbahebjeacdedba	FALSE
ecbjaiihgbb	FALSE
fhbb	FALSE
bagcgddfgjfdfdbicihjabggh	FALSE
ichdbbdiceaffbdjbd	FALSE
dgjjhdcgdccajdcjdbfbbig	FALSE
hfa	FALSE
bicdbihhcbbdfid	FALSE
dcadbhifeha	FALSE
dbbjcf	FALSE
ahjheehfadia	FALSE
bffg	FALSE
b	FALSE
bhdcibhjcdjghcffabhbfad	FALSE
beifdbbafgacfdhbjjh	FALSE
bbhieid	FALSE
aaicfcijhfaifegjhdd	FALSE
ea	FALSE
hbbfcdfgacghie	FALSE
biidfcgbdgggafjg	FALSE
hgjbegabijbfdehbbej	FALSE
igcfdggha	FALSE
efadbdgiabdidddha	FALSE
jabhhbb	FALSE
ieiifda	FALSE
jaa	FALSE
bi	FALSE
faehbbajchajafecidficd	FALSE
bdgcbiefcg	FALSE
jfhedebbajiddahciaaidgg	FALSE
hcbfigdaadbiijdiijbihdbdd	FALSE
bbijdebgjdbibe	FALSE
jifachhbbacfe	FALSE
igibcedfabjbdbidcefifeaa	FALSE
bbijgee	FALSE
hgbbhagiifeg	FALSE
fedeebbdijjeafab	FALSE
ia	FALSE
ihaaaebifh	FALSE
hhieifbicgaae	FALSE
idchciibfjbiahfgehcgbb	FALSE
ggbaafhdb	FALSE
bhfh	FALSE
ejfhcefdgajcefehdaeha	FALSE
bfdgggiifafgjcdgag	FALSE
b	FALSE
beehdccdc	FALSE
fhgcibeabdadfa	FALSE
becj	FALSE
eaaabdij	FALSE
cecbgeeia	FALSE
cbeabbaeebehg	FALSE
bebahedi	FALSE
dba	FALSE
fba	FALSE
be	FALSE
bfcbijgegicb	FALSE
ea	FALSE
