iijdhhcdhhajjah	TRUE
jfbgcg	TRUE
dhbbjchcjedibicgbcdi	TRUE
jgcfjhcgcgiebedfbgebih	TRUE
d	TRUE
ddbhfaadf	TRUE
ijceahh	TRUE
d	TRUE
eeafccdda	TRUE
de	TRUE
cbgacefhjfciajgdafh	TRUE
a	TRUE
ijdgjfghjdgahfc	TRUE
eiifajcc	TRUE
iehjgcjgcfiejaa	TRUE
eiieajiciegajfeheh	TRUE
h	TRUE
ddiiehgcf	TRUE
ifbjiiifbef	TRUE
fada	TRUE
eecaf	TRUE
heib	TRUE
ig	TRUE
facj	TRUE
gedfiffcddfdbaggfda	TRUE
hdhihgcbhehfa	TRUE
fjcjeejijedghgeeacc	TRUE
adaiffjdcjdjcgdcdgjgj	TRUE
jcgejf	TRUE
gjhddcaajefeihhiagejd	TRUE
jbbjfecfjhhbdi	TRUE
hhgbbbgebgbaeggidgjfgdffi	TRUE
iibeeaehdafjefjeciidch	TRUE
dbfejd	TRUE
cdjfffbcfjjdgfbcgajfff	TRUE
djeijhbbfjibfgeafdg	TRUE
g	TRUE
fgjhbgaheej	TRUE
ighficbjhaifjdjifaedaf	TRUE
cgjfefajgi	TRUE
dbaedgha	TRUE
ehcecfae	TRUE
jhgg	TRUE
icbdcbbiig	TRUE
egeijfbgadiiadedcahg	TRUE
edjeffjfegchigihdhaaehfh	TRUE
c	TRUE
gcieicfiigejiaaheffe	TRUE
fcjibhjdfhghaffcjdhief	TRUE
fdaccgcdhaje	TRUE
hdgficifeiafjaaggefgjhf	TRUE
afjafgf	TRUE
ejhjjfgfcfdafdcafehjea	TRUE
bidfdbaice	TRUE
fegbdfgjhjghfcggdgafa	TRUE
ihdcdhbghhajafdedadfahcf	TRUE
cdfdjbbjgiiebjjijdbaidh	TRUE
dh	TRUE
h	TRUE
bbgcdbhce	TRUE
ejceeicia	TRUE
aedfjeddeeaghdiehfied	TRUE
dadafdefa	TRUE
fcfdcjgjjiggjcacd	TRUE
bfcggfhcbhjdaeggiihgjacf	TRUE
hcifbbggihjj	TRUE
ffdecdc	TRUE
fbbccdgcbiiiifcc	TRUE
gehjfjedjdjfbdfaicf	TRUE
e	TRUE
bjbjeciiiiaic	TRUE
jdbe	TRUE
bbchibhdifjhbidchaafdedej	TRUE
ccbcghjigbdgfeca	TRUE
daejddjgiageajecegca	TRUE
ih	TRUE
jeegjjehgicdhcghbf	TRUE
a	TRUE
gddbaajhef	TRUE
fdfhhebddfdgdj	TRUE
hibhhheehfdgeejbc	TRUE
hf	TRUE
didehhgdaaci	TRUE
fgjgdfadefhcajchciagej	TRUE
bfidfifhddegijffgjfebbhh	TRUE
ccbec	TRUE
caah	TRUE
hejeiihbbgcegcid	TRUE
dijchji	TRUE
ecfbiecbgjfigg	TRUE
hgfiig	TRUE
giifcceefejacjg	TRUE
cbicdihggccijb	TRUE
jegehhcghhbaaccg	TRUE
fbbjdbi	TRUE
eaaahfdidegh	TRUE
jebcghbdbjh	TRUE
bdddbcggfbgieejcgfjd	TRUE
ejcgfa	TRUE
jgjfdaedfce	TRUE
ijici	TRUE
efiheeedjgdbejjbbeficfii	TRUE
hfdigdjddjhfbajaeihjgga	TRUE
g	TRUE
bedbcbddhbbfhie	TRUE
hddffgdegj	TRUE
hbfbeibhahdag	TRUE
i	TRUE
jaidgciai	TRUE
hegdih	TRUE
fjbdibjebiccjhhfjhbfdbe	TRUE
gciaheij	TRUE
hchebbebihdbbgdcecffghcga	TRUE
jefjfehfbacaihjgaaeee	TRUE
hjhc	TRUE
fjjibefich	TRUE
ibchefgeacafda	TRUE
aieggcfjfdhg	TRUE
dcefhcdhebhijbjcidi	TRUE
fb	TRUE
bhhfe	TRUE
dehfbgdb	TRUE
jcdhgbicfjjc	TRUE
ceifgdcaigijcjjhhegjjdcc	TRUE
cjcbhijbbd	TRUE
ejfjeaeiagffghhah	TRUE
biigcfiehbhjgeibbi	TRUE
gigfjedegciffafjahfdcg	TRUE
dehfah	TRUE
fiihgicddbgibejheahgi	TRUE
jhijbijifccaf	TRUE
gbgfiefiaegcieh	TRUE
ijjdjj	TRUE
eegcgijfegcegejbjhcf	TRUE
ib	TRUE
icjhahic	TRUE
ehcadijg	TRUE
fhaaaegjhedgae	TRUE
gbhfbhfcfdcbdgfbgebghdg	TRUE
idc	TRUE
dggbdebbafjfe	TRUE
ifdghjebhbehfadf	TRUE
ibhjjaj	TRUE
ffjchghhidjcj	TRUE
ieadidcc	TRUE
fddcgbdffgbbhcbchcci	TRUE
cjhdgic	TRUE
cjhccgcfaaahiiad	TRUE
aiaaaic	TRUE
gahiejgaj	TRUE
fjggjbbgdacc	TRUE
cbbfbggbbifbbfej	TRUE
cbhieebghcce	TRUE
cdeefdcdc	TRUE
di	TRUE
eccciaijcjehhfi	TRUE
hhbbae	TRUE
hdbdicjfjjejaaf	TRUE
edeidcbjiifdigbghgbajdeij	TRUE
fchhdchhijjjggfhdijaghjjd	TRUE
giebghcghhcfiddhc	TRUE
eidaaajgiidfjchefjdccc	TRUE
igdgch	TRUE
jafahdgjigehfh	TRUE
idfjcfiejhcbhdegjhcdi	TRUE
hijidi	TRUE
jecighidicjijhfddc	TRUE
igifeeibgiedebdfjg	TRUE
jaiij	TRUE
a	TRUE
dffajciifiijiijjaie	TRUE
ddhebgffbgcdghdcifgee	TRUE
jbafehcgjaddejgc	TRUE
jifdbeifbhffcgi	TRUE
hcgbgeh	TRUE
biijeicfjg	TRUE
jdhijg	TRUE
ecg	TRUE
hgag	TRUE
dfdgjhbhbhejj	TRUE
bigddaggg	TRUE
dbcbhgfifgjghgiefjajgfjg	TRUE
bcaciiegjii	TRUE
dbejfeihggfbbcehdbia	TRUE
egdegfaj	TRUE
jbfcchfddcdddghahdg	TRUE
gechbdiecgafjdfdc	TRUE
hebaaiidie	TRUE
ccea	TRUE
ihjbgibfedij	TRUE
jbdihhieaccahfede	TRUE
bbeidacfc	TRUE
iefgjedceii	TRUE
fdijici	TRUE
ffcejajidjacfejieigci	TRUE
bjjgidbgdfjhchfifdhcgcaej	TRUE
ecddffcehjchdadhefeh	TRUE
dgcijfccecfgfe	TRUE
egih	TRUE
iebecjcicgcijicbccij	TRUE
g	TRUE
hfgfccffcgfajhjaggdj	TRUE
fbbhhacjgjc	TRUE
acaggefci	TRUE
cjgbcaigjdfjffjgieg	TRUE
fffehdgddigffhdcecb	TRUE
eefjhebffgcddiaj	TRUE
agcfeffeefdgcjgffjeej	TRUE
ei	TRUE
iic	TRUE
jgjegichifeigebcjjd	TRUE
cifjhgbhhhddc	TRUE
ihijjifd	TRUE
ajjehicfiifghfccicgcjjcjf	TRUE
iddigaccjedhad	TRUE
djaj	TRUE
ggdhhhiggaiehgfigajdfa	TRUE
djfdffghbaia	TRUE
acifg	TRUE
dhbbgbejbbjebaigdfehf	TRUE
ggafacdgjf	TRUE
gfbhfehaeechfeedihfafdg	TRUE
aficdaaighgfajefc	TRUE
bgdhejgcbedeahaa	TRUE
hc	TRUE
cdbadhghjhdcgjhc	TRUE
ae	TRUE
jachjhjfhg	TRUE
b	TRUE
fibhgfhdgihdcbidjegcghec	TRUE
ijjifhaeiad	TRUE
ghgjhhjfegbbhjagcgecdf	TRUE
bifbai	TRUE
jc	TRUE
dhh	TRUE
hbeccggijhbjdbd	TRUE
ibdicfbdagchcgeea	TRUE
ddbccceehjfcccgbbe	TRUE
hidacffaadhdcicdhgfd	TRUE
d	TRUE
ic	TRUE
fafddiieddgagececgi	TRUE
gffgibcdchfffiigefed	TRUE
ciffj	TRUE
geageiifdchcea	TRUE
jahdae	TRUE
eha	TRUE
hgcfdeaeacea	TRUE
hjbcdj	TRUE
ggefgfifdghaiijih	TRUE
biegggbbbddihhgefege	TRUE
jebhibjjbbjc	TRUE
gcgeb	TRUE
ghhfggcdedbiihfigjc	TRUE
eahea	TRUE
jib	TRUE
cgijieiafdeeaacfighd	TRUE
djdhcifbdbdhja	TRUE
jeehdicjhd	TRUE
ggdbicibhffc	TRUE
hibgbgcjjgifghhdfbhid	TRUE
ieidjhehghjfjchacjfd	TRUE
gefg	TRUE
ahah	TRUE
dh	TRUE
bdfef	TRUE
cdehjaeai	TRUE
ihdigeafadjiiaicdd	TRUE
hdejgdieahdcihdiij	TRUE
ggedggfhaha	TRUE
cjcjfchifcebghjjgighijic	TRUE
ffbejfhjcjchff	TRUE
jciibfdge	TRUE
gfdhjbihaidjedfdf	TRUE
hhhjgd	TRUE
i	TRUE
hjijjfjdedhdbehcifidh	TRUE
cjfgafdgjceghjjca	TRUE
jffcgbbfjhaceidfaccciigad	TRUE
bcbfigjedddgdh	TRUE
geidfeeahhh	TRUE
iiegdicdejcbifbfegbj	TRUE
eff	TRUE
icbdfgidigcihaddg	TRUE
jjfjffjg	TRUE
gjihjjggfhjcgfhbbfgihij	TRUE
bbagajici	TRUE
afeeg	TRUE
gcdbgbbeffjjgedhb	TRUE
g	TRUE
fce	TRUE
fcibghed	TRUE
gcghifcigihdf	TRUE
cbfdidcdjbdfadcj	TRUE
bcbccjijgjgcbejehh	TRUE
diidccchbjjcjiaai	TRUE
bbhedfbcefcebga	TRUE
bfgefccjecc	TRUE
jibce	TRUE
ebdhbfdffjdhgb	TRUE
jeecgddhc	TRUE
gdcfdciebiibb	TRUE
ejjbhg	TRUE
ghbdbefijcgdjgjhgdcijcfi	TRUE
bgjbbjeehfhe	TRUE
dfbggehjffidegfjij	TRUE
ahefjecgchji	TRUE
jgedhedggaeeedhjdaaidjgh	TRUE
geghbggeiicdi	TRUE
fc	TRUE
jbedjdiibadgegfc	TRUE
bah	TRUE
hfcaeddf	TRUE
bcfig	TRUE
ahjecedihii	TRUE
hgi	TRUE
gcgfhbedfifjcbc	TRUE
jec	TRUE
ihcijfdffdagd	TRUE
bhdhdha	TRUE
baedjfedjadcdijdef	TRUE
gjjhf	TRUE
gjebhhfhjhicjbidfd	TRUE
ghhfbecdacfdghejihiaghe	TRUE
cgcdidjebeggchbjgai	TRUE
aaiiehjeeiihahiahe	TRUE
hceicedhjbea	TRUE
ijfgifgjhjgcijbdfbbafj	TRUE
ecdcbgeagfcifegigceah	TRUE
hichedefiie	TRUE
ddbcchjgbjafjgffidjgfj	TRUE
jgagcg	TRUE
ifeb	TRUE
bjdddddebcjijhfibgdeegfc	TRUE
hhdig	TRUE
bjedjacjgejiaiidac	TRUE
hfchgfcafcjfa	TRUE
aiaigeichccffj	TRUE
fba	TRUE
eccbfjdiijibhffjfidjjbbic	TRUE
gejddbefjja	TRUE
aggjihjcaj	TRUE
gcehd	TRUE
edbifbgijhjjiej	TRUE
cjghbcggccfhdaei	TRUE
ddececcijcdjgjbahh	TRUE
fce	TRUE
ciffhdfhjfbfcjeaehdeadah	TRUE
beigjgieghibjiajfigfijfc	TRUE
gggeechehgad	TRUE
edfgehdff	TRUE
chjjjbafd	TRUE
jidfdhbgh	TRUE
eighfbdiiaaffaiacghicej	TRUE
hbejigbffcddhicghaaie	TRUE
badeahc	TRUE
iigjgiehfhhfcgcjd	TRUE
eiajfe	TRUE
debeigfjbbhjehcegcidecg	TRUE
bahjgjgedajagchf	TRUE
ifbcjfjgdbcghedgbhd	TRUE
ccehfecjcbbjefghbdddjaa	TRUE
aaejhhaefeccd	TRUE
didjieiiiebajhejij	TRUE
bfdhebhbbdbjj	TRUE
hffdbachheddfcc	TRUE
dbidiedcfejhjcgbgibhiccja	TRUE
cbcjcbjbebfiejfaaiejaeg	TRUE
cjefbfbfbchjeaaaccgdghe	TRUE
ddhbgfhfjcebif	TRUE
gggedeefdiafeifehdj	TRUE
ghbjdcbi	TRUE
feadc	TRUE
ifahai	TRUE
aggfegijafc	TRUE
icif	TRUE
bcjecedbbccdfiddbjeibcegh	TRUE
hgdehdbjjbgd	TRUE
fgghcfgdiadhdhgf	TRUE
iicaggjhhjgj	TRUE
aeddfjgjhfhdhchaeggaidi	TRUE
cecdigijeidaaheajdefajd	TRUE
idhhejfbgdbjdejibh	TRUE
bf	TRUE
jegbcdhbfjeddffecbdaicfei	TRUE
iggj	TRUE
eijfigfj	TRUE
gfdjggedbba	TRUE
eja	TRUE
hgecfgjgafecghdje	TRUE
ieeiaeeadi	TRUE
jfffeefj	TRUE
jieifbjjfehcfbaeja	TRUE
iigffgbggaaahdcf	TRUE
bhcgdjdgchfjiegjgedig	TRUE
h	TRUE
gbjeeedhcgjdgjchfjig	TRUE
fjjagiehgggdcafcafcecfieh	TRUE
cedadcffechfaggejigfda	TRUE
agaidgiahiejj	TRUE
ghgcedffbedfbhbhjibfa	TRUE
edibafieejjhhejgg	TRUE
daiiiggdihicgdchdg	TRUE
iddcbea	TRUE
dafahahdedejefjcaeghhiahh	TRUE
i	TRUE
beegcidbffafcejfcdcahag	TRUE
gb	TRUE
id	TRUE
ddicjaiegjijahdehffhfahe	TRUE
bebhbhhfhhejbjh	TRUE
jchgfffaijgggdifefjehche	TRUE
cbgjgefjgcjfbiihigfdfdib	TRUE
bcfiidbhbjeafhje	TRUE
cdicjcaij	TRUE
hdjjdbheaeagedidjjhhjafah	TRUE
fgeeiggfig	TRUE
cbjhgibgjijhahiijdcjefhg	TRUE
ebccdaigfjfegjfjaa	TRUE
fiebbcbjibfiafigehf	TRUE
egjcffhefhicjbghihhgcje	TRUE
jggjbcb	TRUE
hfiggfji	TRUE
cciedccjchb	TRUE
hhhffjediachga	TRUE
jdhfcihc	TRUE
cdhebeaddajhhfc	TRUE
bjijibdijdjiafaid	TRUE
gajee	TRUE
difdefiibcfeahheddeigce	TRUE
hdefchfbifjg	TRUE
fdjjdge	TRUE
dfjffbc	TRUE
gdia	TRUE
jijbbehgejehddiggdcjjfjdj	TRUE
digjejbhejcbbgcgfcjaigc	TRUE
gjjghcbjgcifefe	TRUE
bffgbciidjccfcjicajggg	TRUE
gdfibdgjdjacjcijjacccjhcd	TRUE
hj	TRUE
fhgjhceecgchhdbdjafdgdidh	TRUE
afhiggfieedeadajfdghgi	TRUE
jdcbfbbfijdjddj	TRUE
aiecddfagjahfedhf	TRUE
ibbbhgjeggiiaadef	TRUE
hjchbbbbaic	TRUE
icebf	TRUE
didcdfhgefdeg	TRUE
jgjhhhjiejfiifgfdijghcda	TRUE
cdjiifdhhb	TRUE
eh	TRUE
bbdiecihijjghedcgicebb	TRUE
e	TRUE
acjdafdicfdahdahcggigi	TRUE
hgfbfjdfddigacfjiaj	TRUE
aeageeeacigehihhdhej	TRUE
hfhdgbbaecjjifchihdgiccc	TRUE
hhiejdjgjcgjj	TRUE
bbbchhiheibbbjhjdie	TRUE
bgcihfefhjgichgihgdah	TRUE
jfdejhcdic	TRUE
gfhgdigbhheafh	TRUE
cjhgbbgeifhijig	TRUE
fgegaddejhagcgdaehajgjici	TRUE
egd	TRUE
cgijf	TRUE
hfcfifagifejagggfafiiajca	TRUE
hgaaeijacjdchaf	TRUE
fgdfcfff	TRUE
edficidcgh	TRUE
ebbdcgaidfiej	TRUE
ceifghddfggjcjghafjccf	TRUE
djbjjcjhidejebbdigejich	TRUE
higadhicejeega	TRUE
bjhajcf	TRUE
cbeijbdgah	TRUE
bfdiccbh	TRUE
cieefbdcihcaficdhcd	TRUE
fcfijhaegieifiaecgajf	TRUE
ibgh	TRUE
ehhgebjihcejjbbh	TRUE
ccghcdgiehecidjbhefcf	TRUE
gac	TRUE
jja	TRUE
hdfghha	TRUE
ibjdicgdgfcibhfefcjgia	TRUE
eiejehaafagaefdf	TRUE
ejh	TRUE
jjha	TRUE
gcecbfbdbgceiaeaeccg	TRUE
cfdhfdebgjg	TRUE
jjbagci	TRUE
bdgccecgfg	TRUE
idh	TRUE
dcdbfea	TRUE
higcidfhacg	TRUE
fhb	TRUE
dfec	TRUE
ihgifdhegadfg	TRUE
hhcedjegbhfgjd	TRUE
egjcgagggaaaaichbce	FALSE
ibfbabahicbbefgjidb	FALSE
ab	FALSE
ddggijhdgbiigfdhafbb	FALSE
iaiceegihcfeaaffbgihbh	FALSE
iab	FALSE
abfcjjgdeaeib	FALSE
fbiaficb	FALSE
jabbfgbbaidhdb	FALSE
ab	FALSE
addiejgdabdhgbfccddbca	FALSE
hagffieib	FALSE
ajfecbffachgaj	FALSE
chiehajiiejibeei	FALSE
fhbigafcfcgbihb	FALSE
aeaibcjjeheifd	FALSE
djeffabcg	FALSE
cgiedjaieejgbagja	FALSE
acbfhf	FALSE
fafecgdgaaifdhfccb	FALSE
aaaajb	FALSE
acbb	FALSE
acaagjeeieaejgbiijec	FALSE
ahecebg	FALSE
gbdcdigfaebg	FALSE
ebfgdbhbificahhibejiahhea	FALSE
hajbh	FALSE
jaeaahajdhaedjibb	FALSE
jhaibhb	FALSE
bhfaacddiaggiaheeabdib	FALSE
fdhhaffb	FALSE
eeheaecdfjehifhbbhfb	FALSE
aghdhbb	FALSE
daeehbjhbi	FALSE
cgcfhfjcfeabhehaafb	FALSE
aaghbd	FALSE
jaggdbbagdcbfjdeghi	FALSE
adcb	FALSE
ab	FALSE
dadhabbeajbbbabdc	FALSE
aghahhdahbbjhcj	FALSE
jabeggiidjbh	FALSE
aaiba	FALSE
efaahbafedb	FALSE
fabeabc	FALSE
cehab	FALSE
ghaacbdibj	FALSE
dibbfabh	FALSE
aahfbdd	FALSE
hdjgffbjcecaiddigchefba	FALSE
agfiafddibhhh	FALSE
gheaceacghbfhhicbecce	FALSE
cbab	FALSE
abaa	FALSE
faicbdcjgjhiidafghcbfbb	FALSE
ddcfafeaecahjigjdabjhhh	FALSE
abgbidibcicgghia	FALSE
ab	FALSE
gbbecccabbbej	FALSE
afeegehabiiifhehciafbcdd	FALSE
hadbcci	FALSE
adbdgcgbahccbibbeiea	FALSE
bdaaffagbgchgjfgh	FALSE
aggabb	FALSE
aabigddiic	FALSE
jadhhibf	FALSE
ab	FALSE
gchcibjjaeifdebcjjdigic	FALSE
aagadjibcd	FALSE
aijbicjaeaeacchcbjbcbifb	FALSE
habi	FALSE
hadecjhadafdafbj	FALSE
gchafjdgb	FALSE
agbcbd	FALSE
ehafbffcebafbcg	FALSE
gafgccjhedbhb	FALSE
gbhdaciejab	FALSE
dddfbadhcbfbhebdifjeabae	FALSE
hbeaejhfebcdhcfifbafd	FALSE
jahieeiacbhcie	FALSE
caedgecifjbijidhdij	FALSE
jedbaiaabibhajii	FALSE
fdafjiebdghdifdj	FALSE
eafjgcfaegdaghfgdijbhd	FALSE
jacdiafcidggegecibfhb	FALSE
aeiggibibegbfgehfadbijedg	FALSE
hagb	FALSE
abbi	FALSE
hab	FALSE
ab	FALSE
fgfdhjhaejbeijfjadjbhi	FALSE
gcacdiicbdbgfh	FALSE
abfafeadcgcbdabdfdgiidaei	FALSE
ab	FALSE
aaifbjbaaggahfhjbbhcagfga	FALSE
iaagjchgaefbefbhiicb	FALSE
ab	FALSE
edihieffceiahjeeefgeaheb	FALSE
ab	FALSE
abejefb	FALSE
hcddahhgbce	FALSE
eiheceafcjhcggbdbgh	FALSE
bfjjcahbeg	FALSE
fibab	FALSE
ajabhae	FALSE
fhadbgef	FALSE
aicbgeacbgjb	FALSE
bciaffbegabhbbihfiedif	FALSE
hbiafabigigaebdfi	FALSE
abjffdfejbhahbjigaccjbb	FALSE
chfdaiijbfacijaee	FALSE
acjcgbgjafdiege	FALSE
adbb	FALSE
ab	FALSE
gfjichjejabgfc	FALSE
hijcagiebejaacciieieebhb	FALSE
adaeehfdceccghcbejfhha	FALSE
fdhiaagbdfcfgjgbdibjhhi	FALSE
eaadbcgbf	FALSE
ffadba	FALSE
ab	FALSE
gfafcdb	FALSE
haeeaijijfbdee	FALSE
eaeejchbacabjddig	FALSE
edeabahehbccabcaaede	FALSE
jjbddhbdhabjfbcgajbb	FALSE
ihbgeiaccdigb	FALSE
dbaehafahjdabfgicjfjaf	FALSE
efiajb	FALSE
aiadecgibh	FALSE
hbaahegbjgab	FALSE
icijajgdbbcdf	FALSE
gddjgijfdgfajeiedgba	FALSE
eagb	FALSE
badddccdafadahabd	FALSE
jabbdiggdhfebiggjbidddhe	FALSE
jabgaibfedhadffjidbidcgfi	FALSE
aehhbhaehb	FALSE
dabafjfeabbhhbjd	FALSE
ejejgaefgdb	FALSE
eaeijgeibjebbhhagdi	FALSE
iaiddgbggefhbgbfbdghh	FALSE
aabb	FALSE
abcba	FALSE
fagcdafffbgaighibfe	FALSE
ehagebjhbbhh	FALSE
fiadbdb	FALSE
dagaaidbi	FALSE
jejhaeiajbdjafbdibdiebd	FALSE
dfdabbebejifdhcjdgedddf	FALSE
aib	FALSE
ahffiebacfhjchhchbhhg	FALSE
gafiebf	FALSE
ahijieabbcdiiecbie	FALSE
aagecgedgdiab	FALSE
adacdffcecggbbbbhjafbbgi	FALSE
adaibhfbcgcdbbgjae	FALSE
hicegbaiicaeagaffhjabaf	FALSE
ab	FALSE
feabei	FALSE
cjicadjicbaadbb	FALSE
fgaibgjhbcbbga	FALSE
abhgjihiaeb	FALSE
ahb	FALSE
jbaheiibcbgbdhacgjfcbddjb	FALSE
fdfhhbaabg	FALSE
beabded	FALSE
baedgb	FALSE
hebdbagabii	FALSE
iabedicigfhdggbh	FALSE
adbdj	FALSE
acjibbab	FALSE
jeefcghcdafccbhj	FALSE
gachfbhebbdich	FALSE
hacaeaaidgaabe	FALSE
abbghh	FALSE
iagbciegfaiccjibd	FALSE
faddabjccbbjb	FALSE
jbebgidcfabf	FALSE
jfeafghahiddcbff	FALSE
ab	FALSE
bafgbhedhg	FALSE
aiabb	FALSE
ibbigaifhaicbbefj	FALSE
eagfiaegbbed	FALSE
jaabdgeffajbdafejcej	FALSE
eadeibbhfbadbjcdj	FALSE
eagiabadafi	FALSE
ab	FALSE
dab	FALSE
afdbd	FALSE
eabcje	FALSE
afbgabgj	FALSE
dajbfdjaidhgaiagabbcah	FALSE
hbfaajdfgbh	FALSE
aahdbfbfbfcgabb	FALSE
fhfahcbecbhjbhfdhdg	FALSE
djchafeba	FALSE
iiccaahgabcbibfjcgbhih	FALSE
fadabba	FALSE
gfejbaefhefbfcgejcjjeg	FALSE
ibbdadgdgibjfabjg	FALSE
caajbhjgji	FALSE
aahdagfjcabfjg	FALSE
cabihbgcah	FALSE
jabcf	FALSE
egadbbjbfecgf	FALSE
heedcfaffcigibfbhjedf	FALSE
chdagiafccaidbdbei	FALSE
acjb	FALSE
hjcacbfaihaffbbbcfb	FALSE
cafagbhaafgaac	FALSE
dddhgijaagcahcbhdjed	FALSE
ab	FALSE
hbjaiabiihc	FALSE
abbhd	FALSE
ab	FALSE
ab	FALSE
bagegabbj	FALSE
gcieadabj	FALSE
aifebcabba	FALSE
egjadfdceajfbeg	FALSE
diicacjaabh	FALSE
dab	FALSE
abb	FALSE
fdfccjafcdabiegdibj	FALSE
gaajgebijbgcdhe	FALSE
eajdafddbi	FALSE
abhffbabajdc	FALSE
bdbahdbcjbcggg	FALSE
aceccedidcbjjfjacadbga	FALSE
giaejhdfb	FALSE
dijadfadbdf	FALSE
adgbjicdhfhihefjdaegjciah	FALSE
ehaccebfgbhbggddgg	FALSE
iiahhbbad	FALSE
ciicaggdfafdfffb	FALSE
cihhajbgjieiafj	FALSE
gacbcgacgcegiiffdbafchbe	FALSE
facgheafagfjcijcdddabbega	FALSE
febgfdbacfdabb	FALSE
affaaejffjibeajjdfaeb	FALSE
dadgbffibbieedieibfgigd	FALSE
edhhaacfecggjijcibjhaie	FALSE
dbbafbd	FALSE
ahijdbhg	FALSE
hbceagddajbbjahdbiijjibji	FALSE
aabab	FALSE
abcdi	FALSE
abgaa	FALSE
ab	FALSE
ejhcdbhdjagaahhbaejb	FALSE
jbajhahdgcgab	FALSE
abe	FALSE
adhbe	FALSE
ab	FALSE
ab	FALSE
gjihajbjdicbfagafjja	FALSE
ebdejab	FALSE
caebgebijcee	FALSE
ahjb	FALSE
afifffhbagbabfeibjbhc	FALSE
ieajbbdajbbb	FALSE
cebjaejabjbeadj	FALSE
ab	FALSE
jgfhjabb	FALSE
bab	FALSE
fbdcfabhib	FALSE
cddabeabjajgjbadfdcegedg	FALSE
cjgeeeeffabedhdjchcbbaadb	FALSE
ajibahggjefbeej	FALSE
ab	FALSE
dejijaeegjdbgaacbhghdcbje	FALSE
fbjbiccjgafacehbab	FALSE
ab	FALSE
cgdficfjaajjjadbeibbhe	FALSE
iahdbhic	FALSE
bab	FALSE
ab	FALSE
jejcaebb	FALSE
fajcegabechfeafjejeijbji	FALSE
cbcbcfabhbddgighhfde	FALSE
egbjfaajiaidhgfchjedafdjb	FALSE
baidcdidhbeg	FALSE
iddahgbfahbfjg	FALSE
bhahaafdhdabdd	FALSE
heahacgaehdhacb	FALSE
cefdbdehdaafggfbf	FALSE
abh	FALSE
effibifjcbajedaaahafb	FALSE
dabjeejdahddgbbjbabid	FALSE
dggabagfdhaffddddhbh	FALSE
gedacbeg	FALSE
hedahhibaijchcgadchfbd	FALSE
jbaceagciibhcbidcbhhechbf	FALSE
jcjiieaaidbed	FALSE
deeabjeda	FALSE
ghaabebajhdhfhfc	FALSE
ab	FALSE
ajabbbja	FALSE
ab	FALSE
ab	FALSE
adejhahjadahiaaabbcbeji	FALSE
acbb	FALSE
aaheibaiiaibbib	FALSE
iacabdbbhaabhafgfgbii	FALSE
abcihgafefcdh	FALSE
hhab	FALSE
fffafccaaebecf	FALSE
dahbeajhfadfcagbbjd	FALSE
hjiaecjabdieiegebcjgj	FALSE
abeacjci	FALSE
bigdjfiabgdcbhejfejjebeb	FALSE
jgjahcdbca	FALSE
dhdidejaab	FALSE
jibabdbcdcbbige	FALSE
afibcj	FALSE
hieajibec	FALSE
diahagejeafbi	FALSE
hehacbjafgcfibidjfgec	FALSE
jgjiecaacgddjjhbcg	FALSE
ajbbhbdcgajdibchdfbjaah	FALSE
dab	FALSE
abjjag	FALSE
daejaiiabbh	FALSE
afb	FALSE
hgdciibefdigcacghecib	FALSE
aaaabdgdcbijjdfjiejadeee	FALSE
ahfbib	FALSE
ifagbcjaigjjehfgfj	FALSE
cjcaacdcdeggificfabccibd	FALSE
jefihigacadfbceead	FALSE
ajabdbabb	FALSE
ggabjaibijggbbefaggccbcc	FALSE
hhabhhfebe	FALSE
ahcdgheabfchfbcgidcaccbg	FALSE
bcbibcajijdagcdbba	FALSE
jiiicdbifgcejbfiabedbdh	FALSE
fihbbbabdjhfjebbiibhcdh	FALSE
daahfiaccbdgahha	FALSE
gcbgahccejccgabccdcebdhh	FALSE
hcehcehhhebadaejibjgj	FALSE
ibcgchebafdabagdjhejbc	FALSE
abecfidc	FALSE
aacggjhjjfbi	FALSE
ggbgeahbecfg	FALSE
afabbbibb	FALSE
afahdb	FALSE
acedgjfbabibec	FALSE
dabjj	FALSE
aiaabgfgcegegcbhbeg	FALSE
ccfjabiebiecbcif	FALSE
jbafgbida	FALSE
adbd	FALSE
gidghfejafhajigib	FALSE
gaaahghbhbbdd	FALSE
ajajbbigfijfgdgcdcgd	FALSE
gjdegahjddb	FALSE
jacaibeiehddibfeg	FALSE
jdhabdbb	FALSE
dghcaiecbfjjc	FALSE
fab	FALSE
achceacbefbfa	FALSE
ajb	FALSE
higajfjcaidhibieg	FALSE
hgiafdjbhbj	FALSE
ccigcibfcgahhbjdbbcdjcjgh	FALSE
abb	FALSE
ggjjhhhaiabe	FALSE
aiabcebidgefhfag	FALSE
ajaiefdjggddghafbegebeba	FALSE
abhfc	FALSE
hgaeihbfeeabhfeffieabb	FALSE
eaahbe	FALSE
dcafiggbijgiagjibhabi	FALSE
cghaajbhgfje	FALSE
ifgbjjagbbjj	FALSE
hfbdabafgej	FALSE
iajbfbfgfbga	FALSE
ab	FALSE
djageagfgjedibcbadfccjj	FALSE
iiajdbjibgd	FALSE
iadicfajggidffbgdfcaebigc	FALSE
cfcagffidfdfab	FALSE
ggdfdjjhabjjfadib	FALSE
ceafdadjbcifeicjdbedhdh	FALSE
ab	FALSE
ab	FALSE
jhabbgb	FALSE
gfeaafegbeaeebiaba	FALSE
faeiaeafbjabibacbgghha	FALSE
ecfabdaffcjb	FALSE
hdgccjdgeagdagjajhb	FALSE
hcagbeheeccfh	FALSE
ab	FALSE
fadjgiaehjefhfgbjiggg	FALSE
aeifbfcigfbjbij	FALSE
ab	FALSE
eiegajehjjdbaebhgbc	FALSE
jjajfabj	FALSE
jehbajaegfaieffbgg	FALSE
ab	FALSE
ehaceaacaeccabcg	FALSE
bgbigdbafgahdab	FALSE
djab	FALSE
dgcddedfegecffdeaijbg	FALSE
cjfagcebgchbefbffbbbfcceg	FALSE
gefgfagffahjafbg	FALSE
hfiaciaggfbabiafgejj	FALSE
agfeibf	FALSE
fdfdgcijgafb	FALSE
ifcgbdajbccaheabjdb	FALSE
iiacfdjbdbb	FALSE
bajfefacfdgiihb	FALSE
jjagaabdcifgh	FALSE
adfifcdaabjhaagibjcbdi	FALSE
fbheicccaiijafahcbhbbbid	FALSE
ejeifebdgajafccccfbc	FALSE
aaaiceb	FALSE
jfjacjcfb	FALSE
aabdb	FALSE
ab	FALSE
aeeaedb	FALSE
aegbi	FALSE
dffccfbaaabjabbbijgb	FALSE
facb	FALSE
gaacajaefadbfhaffaafh	FALSE
ihbibafihfbcfcab	FALSE
icdbfhcfbaefjcbabj	FALSE
gehaba	FALSE
fciabijadfejdd	FALSE
afabdfegcgdb	FALSE
eajgbabacfdachcdad	FALSE
ifchfjajffadhjabcfg	FALSE
dihhbjcaibbccdacghf	FALSE
djgabcacafhhbbefhd	FALSE
aibf	FALSE
idbaifbfhdhjd	FALSE
gaejbbeaaihadeiiehijebdgi	FALSE
abag	FALSE
ghahdggfbjc	FALSE
abe	FALSE
begabghchiheghcggb	FALSE
agbeajhbdeecifib	FALSE
fggjcihahab	FALSE
hbffbijdadaegib	FALSE
adjgbffgj	FALSE
baebcfabcb	FALSE
biijgjejcdbaffhadadibfcfi	FALSE
dibdafgbbehgjcgeiebghgcfe	FALSE
iicbjafgihffgdbjgdhfhbj	FALSE
adhjaebajbehgfebafbjjbg	FALSE
cijjaiccgbbiehhij	FALSE
ebhjdfaejhbffefada	FALSE
ab	FALSE
dafifdeegadgcdcchbbgii	FALSE
heabidiegaijbiegfef	FALSE
cdibiagdjb	FALSE
hfaacdfahbebedgfeeb	FALSE
abb	FALSE
aabbbdcb	FALSE
jedeabjaadbfhaibfafjiffeh	FALSE
ab	FALSE
dfadfb	FALSE
caccbjgcibjahhdc	FALSE
gaabg	FALSE
abhbddfiaeiheebiiejd	FALSE
eeaabhgfadbccachdgbghc	FALSE
fjedadadaejafjb	FALSE
edfibaidbfcijaefigfifdhg	FALSE
jhbgjiabgbhedjehb	FALSE
facafdgahgdcb	FALSE
cicaaabidbeghagjhb	FALSE
hbjabjbfd	FALSE
ahb	FALSE
abahibja	FALSE
acbcgigfcj	FALSE
fabga	FALSE
jgcajhgb	FALSE
ffdcjhagiecaaffaccecjgab	FALSE
ahaddgcadbaaedadiadgfbj	FALSE
fajhebigg	FALSE
gabb	FALSE
ab	FALSE
dbfacfdbhccbhbjfhh	FALSE
gahihfdfabedcjbch	FALSE
abffhacgjchihfhgbe	FALSE
ibfaib	FALSE
afhcjbeafijbiehf	FALSE
abh	FALSE
eijiciieahdgbhhbjihcj	FALSE
ab	FALSE
abcefg	FALSE
ajgeadhighgdbijbjfbj	FALSE
ab	FALSE
ab	FALSE
egaeibh	FALSE
chaabahjieb	FALSE
ccbgabdaffbiidf	FALSE
dafaeadab	FALSE
