ifcbiihhcbh	TRUE
gegedbfahaheb	TRUE
bddgbebah	TRUE
ggaieejiafg	TRUE
a	TRUE
fbbajed	TRUE
jcidhbgdggdffdfhd	TRUE
cdddibdadif	TRUE
ccabjjdhc	TRUE
aijcfeghebdbjg	TRUE
hehccdbbdjbiabfcgja	TRUE
ecabcidgajebidbcdhi	TRUE
jhaehhbafjddjd	TRUE
hchafefddfcgbhe	TRUE
ggjbfh	TRUE
jfgdjccdcaibedff	TRUE
ffiadieiihbacfjjdgbjg	TRUE
bfdgbjheeeddddjcb	TRUE
agicgdeaf	TRUE
ejafiabd	TRUE
g	TRUE
d	TRUE
cjjaeccgfjehbcijd	TRUE
bdcebjahcddjcd	TRUE
ifh	TRUE
fjihdggbbjbcc	TRUE
jhbbhgifbdajadcfcdhffi	TRUE
ddbebhbjfcdejda	TRUE
gbjejgibjaddbgc	TRUE
cifd	TRUE
cgjhddgffedecegegig	TRUE
ghjjeebiifccjadadfehecb	TRUE
icbfdihdiejabhbhiac	TRUE
jfjccieccjcfbbgcdd	TRUE
cfcdfjhahfgffhhdcafbfgjfa	TRUE
cacihjegddffahcajgihc	TRUE
gjcbc	TRUE
bfd	TRUE
bhihfbiejhd	TRUE
gh	TRUE
bah	TRUE
biibdadfae	TRUE
ceigjbjfdifai	TRUE
cbedbgichffbhabd	TRUE
eggaadibacbfaecfhhgi	TRUE
b	TRUE
dgeebaajficjjfdcebejeibf	TRUE
fcbcc	TRUE
ccee	TRUE
hdhjdeahcfaahgcg	TRUE
ihabgaiagbeciaiceddaagibb	TRUE
djdcbdfigicdcjcfjafded	TRUE
hdfigadefhchacaii	TRUE
aagcfb	TRUE
jfe	TRUE
cfgiecfdcbgfebhgfcibe	TRUE
gggdicdcbhjfida	TRUE
ga	TRUE
djbigacdjacdbeefe	TRUE
icdjggaahfiegdejhfceagda	TRUE
bdgjecic	TRUE
iefb	TRUE
hjeefheibgdgj	TRUE
decgecadij	TRUE
adhcefe	TRUE
dgafigifjadbedghh	TRUE
fcfhbjfecd	TRUE
fejhacgdeej	TRUE
eabagahfbdigjjgdhccc	TRUE
fcbcgbcgd	TRUE
h	TRUE
fhb	TRUE
aebhdaaebeddbbfjdhgdahg	TRUE
fjgfgahdebdgcj	TRUE
idchaccfg	TRUE
cdjhjhb	TRUE
jacfhchbbhfdhfc	TRUE
jhfdchaddegi	TRUE
diaab	TRUE
acfeccgdadjhcbhc	TRUE
gchgdabcehha	TRUE
hihhgb	TRUE
edgehgcbaahhgdccjgjaid	TRUE
gcdghfabigbaefigjbjchdf	TRUE
jeecfedeecadbicdgfibffghf	TRUE
ccccicaiejf	TRUE
bcfhiaa	TRUE
eidaadfhdcdiacdbgg	TRUE
aefd	TRUE
jah	TRUE
djebagbie	TRUE
jhd	TRUE
bjhccfdhebfjjghahg	TRUE
hjgdfbgdgjdad	TRUE
fgj	TRUE
eg	TRUE
dacdachbjjaihjjga	TRUE
deaaidccajhgjjbe	TRUE
gbicdefde	TRUE
fgehcdaadidaigbcaiihjaffd	TRUE
cce	TRUE
jbgji	TRUE
bbaggbafgfdcbfjdicdij	TRUE
jb	TRUE
feidibeeb	TRUE
cbcihgb	TRUE
djfeeccifiicid	TRUE
hghbhbebeaaehhdd	TRUE
hhcbejadgjfdjddff	TRUE
ffadjd	TRUE
gbfjddfgjchhfbjeabfeedaid	TRUE
jeieffhahjihebaccjdbcjfgi	TRUE
diheaeehgb	TRUE
ghdehchieeijjaeiejejacd	TRUE
bedbbgejebbjcffbagc	TRUE
dhgejjfc	TRUE
dbgjdgfbajgbjegiebdfd	TRUE
chffad	TRUE
iaifhba	TRUE
hcddddgejhbbi	TRUE
aebcaeaafejieadbjehfeif	TRUE
idegechcgjbcechh	TRUE
jh	TRUE
dfafeibibfjhggfgbhfbjje	TRUE
fcjgeijdgicfh	TRUE
jdeajfaaejghchjcchcgeid	TRUE
ejcggjh	TRUE
cgdjejig	TRUE
ijdc	TRUE
gfgjhhbjcjcbafg	TRUE
hgdc	TRUE
hbcdbgeffgggjdfhbghcfbif	TRUE
efjefbeiaig	TRUE
ffcgggjfedgjajibiagd	TRUE
cejhhffjg	TRUE
bjfgchadffcf	TRUE
eehicfij	TRUE
jeafccaddfejbfdcjafghcieg	TRUE
eggjbdjecceeejdid	TRUE
ihibdidbhjajbhf	TRUE
fjaejbcjijddgcchaag	TRUE
gcbb	TRUE
hhcefgfjdfcjhheabi	TRUE
dheebcahiebadibjfddccc	TRUE
cceaachbfgbgdiejcafchb	TRUE
bghchcddbbjgbibhgfbhh	TRUE
id	TRUE
ja	TRUE
hj	TRUE
abjaadghdiihcgbihbjacg	TRUE
chfcebdijhh	TRUE
cdjhejca	TRUE
chdhca	TRUE
dahaddcigbfhggacfiigeb	TRUE
gdbg	TRUE
jhdbiechii	TRUE
ggbbdfhibbjfcbhcifedajii	TRUE
jhdf	TRUE
ahdheffegfcgi	TRUE
hhegjcfhceaddajggb	TRUE
baheg	TRUE
cghejbgfjj	TRUE
hdfhdehjaajhbji	TRUE
hjhdjgfegicdjdieeihcdh	TRUE
jgafbihfgicchfhacgdaegb	TRUE
aidbgbcgj	TRUE
ei	TRUE
adifbcafggjhhfhjefccbdie	TRUE
bhbcdahjcbdgjifecjb	TRUE
cddhacjddd	TRUE
eajfiahbhhgjai	TRUE
geahiidjaaeiajfhid	TRUE
jbce	TRUE
gdjgicjjejdcdhbjjbcgifjjc	TRUE
heffahejhe	TRUE
cdcjgia	TRUE
fiaeciedcaibjfda	TRUE
adihhe	TRUE
hbfjifjicddgj	TRUE
eaadjdajcdcbibggheheda	TRUE
ccecjegchacbjde	TRUE
afdhjbdafbec	TRUE
hfbeeefcbdhcfghd	TRUE
iiabagbicjdeafgideida	TRUE
ghfjebjaheag	TRUE
jdgbh	TRUE
gadihg	TRUE
adeghdhiiehfgaebddhegichh	TRUE
eefbeahaijhbebjbbfeabedi	TRUE
ffehi	TRUE
eecajahjfdhcjegjgijaf	TRUE
egdjadidaiidjehj	TRUE
eaddffcbidbgejebjfjf	TRUE
fdegghecgfdcbj	TRUE
jaaibfbbhdegai	TRUE
jggafcgihecc	TRUE
bjbijgibhdgjiggfajefggje	TRUE
eggdgfhcaaihcddgiighbc	TRUE
cfjc	TRUE
jcedbffjfihbaddhaij	TRUE
icabdbbebejbccfdjajdicecj	TRUE
fefefjjaadgddiadcf	TRUE
eddgigccdidbbe	TRUE
jh	TRUE
ijifcc	TRUE
gabgbgggfeceahihabfj	TRUE
ffadgfgciaibcj	TRUE
gagea	TRUE
hjabjgfaehgagiich	TRUE
bedbf	TRUE
feajdgbegahd	TRUE
bjbghfbhfabed	TRUE
a	TRUE
igaegja	TRUE
bhac	TRUE
eadfjcjhf	TRUE
iehbbibahiaaaaf	TRUE
fdjbbfbbddfjbdggdgcf	TRUE
d	TRUE
ajdaegjiffdghbffgjg	TRUE
igafdbcd	TRUE
gbiadccadgjbgdjbfejabgc	TRUE
jddgiaefbidffbaaiahcd	TRUE
abhchgdbbghgebacbfja	TRUE
ejebfahddbjjb	TRUE
jfhfcbeheedjgjjaa	TRUE
djjehc	TRUE
fjeedfjihcgibbiciheie	TRUE
hfjhiaagdbaidgi	TRUE
fgchfecg	TRUE
eeifdadhcjfcadacieajcabe	TRUE
ighadbbdbcfeeiaie	TRUE
dibjbfhiefdfagieeeh	TRUE
ceccejbj	TRUE
abeej	TRUE
aicb	TRUE
cibjjegccejjedf	TRUE
ehhbbece	TRUE
hfhfgffhifcggibabbgccc	TRUE
abefjdg	TRUE
bigafjhbid	TRUE
hfhfajaaiabgdjiihdbd	TRUE
dega	TRUE
jj	TRUE
biaefdcijdahjdfffigfchb	TRUE
fjeefdfiaiagffhajbccfeai	TRUE
je	TRUE
ijfbfcjadacifbjadciba	TRUE
addbbidbdgceaaeccdbbbgai	TRUE
ibicbcgdgjgjhibcje	TRUE
aabdbbehjajjagegjjbcgahe	TRUE
fdfgbjdifbf	TRUE
acdjeccd	TRUE
iaaaahahdeicfdfcbef	TRUE
agajghejbjfjcjgig	TRUE
ea	TRUE
ahifhcjbbicfajaiijb	TRUE
bjhccbfgbfacaehb	TRUE
ccjidfaheeidhidjcdhagjjbc	TRUE
cjhgdhfhijahijcief	TRUE
iaieaeebhffj	TRUE
gdbccjbedjf	TRUE
ideejejhgcecdidjicf	TRUE
gfhehc	TRUE
egiaifiajeh	TRUE
ahcgccdje	TRUE
ifaedaaaggccjhijbbdbaie	TRUE
fdghdfiaeicfjjdhjcjg	TRUE
jjaheicagjeifbdeiej	TRUE
hejgcjcijeejfdeafgghahgh	TRUE
g	TRUE
dca	TRUE
ibacig	TRUE
fjhdffcfjdfgjdehdceaih	TRUE
jicebajfhicchfhbjf	TRUE
ihihfibbfabffefe	TRUE
efgdhjefei	TRUE
bbcicfijdghfjhcdejbicdbbj	TRUE
jfffhgjibbeab	TRUE
chhaddgifiajfgihidjdbaj	TRUE
bgbcgcjgdbigeffaf	TRUE
afeeahdjaihjaafaeddhcgcd	TRUE
gcgibbjhhbd	TRUE
bihacebccebfggbai	TRUE
ghafgidbjafbafejgcgddicj	TRUE
abgifejeifhdehicfh	TRUE
caidcbhccegeb	TRUE
g	TRUE
fheabbggeeffifddhe	TRUE
ijghifbagbghc	TRUE
jbghgaj	TRUE
igjdhfjegecfifgeab	TRUE
jcfdgeegficbfj	TRUE
a	TRUE
hjfhfcbfjcjg	TRUE
cfjh	TRUE
fad	TRUE
hjgcdgdfcfgh	TRUE
ihhaecdaejaefje	TRUE
ahgjjejhcbiejhjdfddefha	TRUE
ijifjcaifefadjfafdhf	TRUE
chbcjdcgahbfjjebeihgadf	TRUE
jdfddbdegfebce	TRUE
gicifdh	TRUE
bajjafae	TRUE
h	TRUE
haiiajdjfg	TRUE
gd	TRUE
ade	TRUE
hedecffcjgc	TRUE
fdffcfjcidhhijgcbecidd	TRUE
aebhiedjhabjjcffjjhcbj	TRUE
g	TRUE
ffaghgbbeaebga	TRUE
jfgeaa	TRUE
bdhiecjfhc	TRUE
agjbediejhfdb	TRUE
dbjhj	TRUE
i	TRUE
bbgicbiciigjebdehddaaf	TRUE
ehggbdfdfeajdigegh	TRUE
gdcbieigjiehafbcfedabgjj	TRUE
ecaifbheidedfgdfcejh	TRUE
hai	TRUE
jjgajicgefdciafjfiihajdhf	TRUE
aadjbhcb	TRUE
gde	TRUE
ejdifeccfjjaeidjab	TRUE
ajjjfbddd	TRUE
dgjhcdejgcccjcgheh	TRUE
hgeagigdjdjifehighgfd	TRUE
ghcbajijagiachbdggb	TRUE
ebcdchfcacefjdeegejhbcbbi	TRUE
ecbbghbghfeaehiab	TRUE
cbgdgddjajbh	TRUE
degejggifcfehbecjffhjbeaa	TRUE
bdgfcgiedidbfcegidei	TRUE
fdjbgcaabdbfgjggi	TRUE
edhihcfdfi	TRUE
ibbegg	TRUE
jjcadiahdjbbjhjgd	TRUE
ahdehgaabjabhibegaababf	TRUE
hbhdgfeacf	TRUE
bihhjfb	TRUE
hhgdajiihfcegjfbiiafc	TRUE
fhjfffbfgajjaibcagfj	TRUE
egcbhcbdchbejaef	TRUE
hffghbeagfcceefgcdb	TRUE
jgaeechejdhcbcjhaad	TRUE
dddcdbjhibgeafb	TRUE
jiihbgb	TRUE
fiffid	TRUE
jfjhdigi	TRUE
f	TRUE
chfedgeiebgbhbg	TRUE
bciiichcbjhd	TRUE
fjgibgjghihih	TRUE
ccajijfiafjjgjjcc	TRUE
gadjdegaibigdhbf	TRUE
adcbajeiaeijbaeahadegjhh	TRUE
jbafihjiagbciadabagd	TRUE
hfficacfjiibjeg	TRUE
iadbaecefh	TRUE
gabfch	TRUE
igfagdeebcijbeafhghgghh	TRUE
heddejiifdabaeij	TRUE
gaaed	TRUE
abjbdbfcdbhbggjbifahiae	TRUE
agjijibcfiacbif	TRUE
iff	TRUE
hdajdaejdddggbfbbjahh	TRUE
agfbjehbgjaajjgaggiagheh	TRUE
hb	TRUE
bjbb	TRUE
dgfbdjcgbd	TRUE
eaibjdabihbjagfffhj	TRUE
ijaagiajefbjheccfcgjdhdd	TRUE
jehg	TRUE
hgdhgcbgbhjhdhjejfgcfg	TRUE
jccaebjddefbdjbegghhhjfec	TRUE
faefjjiajcdief	TRUE
faecibgdbcccfhagegfgjeed	TRUE
gafha	TRUE
gfgbaafg	TRUE
bbcjibggjjfech	TRUE
cijaccajgdjj	TRUE
afjcjj	TRUE
ihcbhedg	TRUE
cgg	TRUE
gcbiehhehgifieff	TRUE
gchjcdcba	TRUE
ijd	TRUE
ibhhiabjhhgcbfadgahea	TRUE
hjbhgg	TRUE
gdgbegbibja	TRUE
i	TRUE
hb	TRUE
ddbeeehjggigbehfjiiigjb	TRUE
bdcihaicagdgh	TRUE
gicedececgabeejhcahjiajeg	TRUE
aejjdehcccecb	TRUE
ajfibaeijidi	TRUE
bchahaabcaghcb	TRUE
jgigefaabih	TRUE
jggajeedieh	TRUE
aacfijiiecdc	TRUE
jabjjg	TRUE
ajeccgecdajfdiiie	TRUE
b	TRUE
fheiideccigdei	TRUE
eggcdgghc	TRUE
f	TRUE
dhbcfejidegfbbdhcbafgjbdc	TRUE
hebehfhjfibecaag	TRUE
fedihgc	TRUE
ijdcagffjjfehhjcgafeeb	TRUE
eahbhhaei	TRUE
icbdhbhff	TRUE
ajddgcbbbceajgfggfbabbc	TRUE
gcbbihiabccdiffcdh	TRUE
ibjdejaaagebgafhag	TRUE
bfg	TRUE
ejag	TRUE
jfcheffbacbhebiadbfgac	TRUE
dhbaecjbjijadg	TRUE
djaejjggehcagdgiibg	TRUE
dgcfhcejfbbgaebcfhbga	TRUE
ijbbjcd	TRUE
hgabebhhejgejbfbgiad	TRUE
dadhbcccchgdfac	TRUE
egiihbfdahfafecjeefaie	TRUE
acadajah	TRUE
fcj	TRUE
hgahiabfgji	TRUE
icafffaa	TRUE
ffhci	TRUE
ahffeibcic	TRUE
feehc	TRUE
ffciebfhdeddbcj	TRUE
gjicgefggijb	TRUE
bgeff	TRUE
dgjjhded	TRUE
agcdba	TRUE
ccdegejigcecji	TRUE
fdajh	TRUE
ejfb	TRUE
gajhhgeeabijgdebdbbfcbj	TRUE
jacgbfjeiihga	TRUE
j	TRUE
bceabcecdbgagaddddh	TRUE
icacbhbfc	TRUE
biajafgdadgadhjabgfjj	TRUE
fadfhjg	TRUE
diccgcfcjedh	TRUE
bdchabh	TRUE
bajhgjchhafbbeedjaiaieacb	TRUE
cjgedjijdfacejig	TRUE
bgghedcfajajbhdhgidjde	TRUE
dbcihggeiae	TRUE
cchfgahdedeffhhggcee	TRUE
feffdbdegighgffb	TRUE
hciagbbgddcjjahj	TRUE
ahcjjbajgfii	TRUE
hdfeaagjch	TRUE
cfifgegfdecd	TRUE
cgggchdbgf	TRUE
ehefgfdhgcjdh	TRUE
ai	TRUE
iahgjaiajbaefe	TRUE
eacbjdcaffdcgcbdhejca	TRUE
aicjfeeaaejc	TRUE
gbjiechh	TRUE
gdfegbgdagdhgcgjcghg	TRUE
ge	TRUE
cdhci	TRUE
da	TRUE
hdjibfhjjfhgigc	TRUE
bi	TRUE
i	TRUE
faefjij	TRUE
cedfgfhehbadgigaaf	TRUE
gidcb	TRUE
ehehjibgad	TRUE
iaigbaibajjdcjbiccii	TRUE
i	TRUE
cefcadj	TRUE
eedbg	TRUE
hhhj	TRUE
feedccifcgbjdchgjcgbjcje	TRUE
hccgfgffd	TRUE
cbd	TRUE
ahhdeaciiajadbjgefcc	TRUE
heiggcegiff	TRUE
fgfhidede	TRUE
acfbjhaedjhdhhbdaf	TRUE
cafhdehchbfbachddidje	TRUE
hedaidebdgg	TRUE
jgbegbeihiiahjjeebfg	TRUE
iheichddgfihjjaggieiicbee	TRUE
gjibbcjbiejfeifcacich	TRUE
faaaaaaaaifdfcafdeid	FALSE
bbbbbbbddicaia	FALSE
bbbbbbb	FALSE
bbbbbbb	FALSE
jaaaaaaaaefh	FALSE
bbbbbbbhehf	FALSE
bbbbbbb	FALSE
iabbafbbbbbbbbh	FALSE
dijdffaaaaaaa	FALSE
bbbbbbb	FALSE
bbbbbbbihjjaecfchgcccidgb	FALSE
baaaaaaa	FALSE
bbbbbbbggdaijig	FALSE
bbbbbbbb	FALSE
bbbbbbbgbga	FALSE
iiijjchcbbbbbbbbfh	FALSE
aaaaaaaa	FALSE
hcficadiaaaaaaa	FALSE
icbbbbbbbbbc	FALSE
bfgecifhechaaaaaaa	FALSE
egccagcacfeaaaaaaaa	FALSE
aaaaaaaaaiccbfjjfeeec	FALSE
caabgibccciaecjaaaaaaa	FALSE
idccdaaaaaaa	FALSE
hagbbbbbbbbdfbh	FALSE
bbbbbbbfdegicdbhiadjj	FALSE
ijfagdedjgaaaaaaa	FALSE
bbbbbbbiiheffjceichbi	FALSE
ebagbhbbbbbbbbgacabejfb	FALSE
gbbafiaaaaaaa	FALSE
aaaaaaa	FALSE
bbbbbbbcff	FALSE
bbbbbbbb	FALSE
bbbbbbb	FALSE
bbbbbbb	FALSE
bbbbbbbcggffeccaej	FALSE
bbbbbbb	FALSE
ajfgbdhhjeahchbbbbbbbbb	FALSE
gffciafihaibaehdabbbbbbbb	FALSE
iibbbbbbbbeebiaeeefacacc	FALSE
aaaaaaaa	FALSE
bbbbbbbdhbiibgachbc	FALSE
aaaaaaa	FALSE
cgiajchgdfbjbjaaaaaaa	FALSE
bfffjhdccdbbbbbbbbjchibj	FALSE
bbbbbbb	FALSE
bfeijcbdfieebaaaaaaa	FALSE
hdagcifbbbbbbbbf	FALSE
aaaaaaa	FALSE
aaaaaaaa	FALSE
eahjcaabbbbbbbbbdbjh	FALSE
bbbbbbbecjceedcg	FALSE
bbbbbbbagbjfbgjacbgjb	FALSE
hhbejajfhdgbafaajjaaaaaaa	FALSE
aaaaaaa	FALSE
ibbbbbbbbe	FALSE
gggfjiaaaaaaa	FALSE
jchaaaaaaaaa	FALSE
bbbbbbb	FALSE
bbbbbbbbjcdhcjccghcfaai	FALSE
aaaaaaaa	FALSE
bejaafaaebbbbbbbbg	FALSE
aaaaaaa	FALSE
bbbbbbbbijgche	FALSE
bbbbbbbfdcicifeef	FALSE
bbbbbbb	FALSE
bbbbbbbegjigechfiaeaejhf	FALSE
bbbbbbbiih	FALSE
bbbbbbbbhedci	FALSE
bcabffecjicaaaaaaaadie	FALSE
bbbbbbbidihbhchjbie	FALSE
bbbbbbb	FALSE
bbbbbbbbgfbg	FALSE
bbbbbbb	FALSE
bbbbbbbhgcbhgjdaiefajab	FALSE
gibbbbbbbbdha	FALSE
aaaaaaaai	FALSE
cdhejcfbbbbbbbbj	FALSE
aaaaaaaajdijghhdfidhiaeg	FALSE
ecbgcbbbbbbbbef	FALSE
gfaagijiebgdbbbbbbbbj	FALSE
hahhddiafaaaaaaaa	FALSE
bbbbbbb	FALSE
hidjfhbbbbbbbbcaieeag	FALSE
jhhhefhjaaaaaaaageiaijji	FALSE
cdjajaaaaaaa	FALSE
bbbbbbbfgdhhihihhgfcfjd	FALSE
bbbbbbbfjdegdgafe	FALSE
eaaaaaaaaghbdjih	FALSE
faaaaaaa	FALSE
aaaaaaa	FALSE
bbbbbbbehddbe	FALSE
aaaaaaa	FALSE
ijifjigfdhebbbbbbbb	FALSE
bbbbbbbbdcaicjhfb	FALSE
aaaaaaa	FALSE
hehhchcaaaaaaa	FALSE
aaaaaaa	FALSE
bbbbbbbgejadh	FALSE
bbbbbbb	FALSE
cifiebiaaaaaaaa	FALSE
dffiabaaaaaaaabj	FALSE
aaaaaaaajf	FALSE
bbbbbbbbaeiajhigdgihb	FALSE
bgchaiabfchbbbbbbbbbfgbda	FALSE
bbbbbbb	FALSE
aaaaaaa	FALSE
bbbbbbbbbf	FALSE
aaaaaaa	FALSE
bcbbiaaaaaaaagiegede	FALSE
cajbdaaaaaaa	FALSE
iiejjfbiaaaaaaa	FALSE
bbbbbbb	FALSE
fgaaaaaaaafgdfbid	FALSE
hgahfgjihcihiaaaaaaa	FALSE
jbbbbbbbbbeccjdfaaggea	FALSE
aaaaaaa	FALSE
ichgaaaaaaaaidf	FALSE
bbbbbbbahghaja	FALSE
aaaaaaa	FALSE
bbbbbbb	FALSE
ghdjbbbbbbbbdgbbie	FALSE
bifchcaaaaaaaabibcf	FALSE
bbbbbbbbbiibdaefeiiijj	FALSE
gdjaaaaaaa	FALSE
bbbbbbbbbighjhjicchfegcaf	FALSE
daaaaaaaa	FALSE
bbbbbbbgj	FALSE
aaaaaaaagchh	FALSE
bbedjifagcebaaaaaaaa	FALSE
jjdjaaaaaaaahjgbbcaegi	FALSE
bbbbbbbbbgg	FALSE
bbbbbbbb	FALSE
bbbbbbbcaaeecddfcaiehab	FALSE
aaaaaaa	FALSE
gggaaffbbbbbbbbeec	FALSE
bbbbbbbfe	FALSE
ibbbbbbbbd	FALSE
aaaaaaaafacegbdhaag	FALSE
bbbbbbb	FALSE
aaaaaaa	FALSE
bbbbbbbeggfafabcefffiah	FALSE
bbbbbbb	FALSE
bbbbbbbfggdba	FALSE
djbbbbbbbbjihaeaffcgc	FALSE
aaaaaaa	FALSE
cgfafijcdjbgifdcfjaaaaaaa	FALSE
bbbbbbbfcfcgghiiffffgc	FALSE
giaaaaaaaajcce	FALSE
fdfbbbbbbbbbigf	FALSE
bbbbbbbbddhddgafbigdchf	FALSE
aaaaaaa	FALSE
bbbbbbbfahgcefgcfgcae	FALSE
bbbbbbbcbfihbg	FALSE
bbbbbbb	FALSE
caaaaaaaabh	FALSE
bbbbbbbfhcddjdiaejhcefeia	FALSE
aaaaaaa	FALSE
gefhgdfbafaddbbbbbbbbjab	FALSE
aaaaaaa	FALSE
bbbbbbbefaahijia	FALSE
aaaaaaa	FALSE
bbbbbbb	FALSE
bbbbbbbjafebgbjegg	FALSE
aeihjcicjaaaaaaaa	FALSE
aaaaaaaa	FALSE
bbbbbbb	FALSE
bbbbbbbbgcajcc	FALSE
bbbbbbbbchgh	FALSE
aaaaaaa	FALSE
bbbbbbbeiiec	FALSE
jchebbbbbbbbef	FALSE
edjgbdjecfebbbbbbbbce	FALSE
bbbbbbbfeedfebgga	FALSE
hbbbbbbbbbdjgf	FALSE
agbbbbbbbbhbhgcidf	FALSE
fhaeidiadbggaaaaaaa	FALSE
bbbbbbbegbbiifac	FALSE
bbbbbbbajbabcibcebcece	FALSE
bbbbbbbjc	FALSE
gidjefjhhbbbbbbbb	FALSE
jjhaaaaaaaaaafgfjcbeijf	FALSE
ibbbbbbbbjddbibhbidbedjf	FALSE
cgeiaaaaaaa	FALSE
aaaaaaa	FALSE
eaajaaaaaaa	FALSE
fhabbbbbbbbbbia	FALSE
ccehfjiggejibaaaaaaa	FALSE
bbbbbbb	FALSE
adfadbgiahdaaaaaaaa	FALSE
haaaaaaaaaaddfbiehfffe	FALSE
bbbbbbbfabdiaajecbibfhdi	FALSE
bbbbbbb	FALSE
bbbbbbbbfb	FALSE
hhjijaaaaaaaajeggcacgd	FALSE
idbbbbbbbbdbbhigejfdbbbdi	FALSE
aaaaaaaahjjfcbigadc	FALSE
aaaaaaa	FALSE
bbbbbbb	FALSE
abbafgaaaaaaaagc	FALSE
aaaaaaaaihd	FALSE
fgfacaajcfjebaaaaaaa	FALSE
acgfddabgcieaaaaaaa	FALSE
bbbbbbb	FALSE
edaaaaaaaacjji	FALSE
bbbbbbb	FALSE
aaaaaaa	FALSE
aaaaaaaacegee	FALSE
bbbbbbb	FALSE
aaaaaaa	FALSE
bbbbbbb	FALSE
bbbbbbbejadded	FALSE
bbbbbbbgigfdb	FALSE
djdhacaaaaaaaa	FALSE
ddaiefeaaaaaaaaahegjcabfb	FALSE
aaaaaaa	FALSE
aaaaaaa	FALSE
bbbbbbbgiceiifgegidafjf	FALSE
bbbbbbbdcdhdejiihjehf	FALSE
aaaaaaa	FALSE
bbbbbbb	FALSE
jaaaaaaaaig	FALSE
bbbbbbb	FALSE
jebbbbbbbb	FALSE
aaaaaaaa	FALSE
dheaaaaaaaacjhhegehbj	FALSE
bbbbbbbbjcjggbhgggg	FALSE
hbgbcaddcdaaaaaaa	FALSE
aaaaaaaadeccdejibh	FALSE
bbbbbbb	FALSE
cddedbcjcbaaaaaaa	FALSE
bbbbbbbbaadfjaeheffa	FALSE
jcjgbaaaaaaaa	FALSE
bbbbbbb	FALSE
gaaaaaaaaaebgcjcic	FALSE
bbbbbbbecdddajjhfda	FALSE
ifafddehjdejbbbbbbbbcec	FALSE
bbbbbbb	FALSE
bbbbbbb	FALSE
aaaaaaa	FALSE
igeceicebjbaeeaaaaaaa	FALSE
jdfafdahaaaaaaa	FALSE
aaaaaaa	FALSE
aaaaaaa	FALSE
bbggbfjhbbbbbbbb	FALSE
bbbbbbb	FALSE
bbjhagafdjccbjaaaaaaaajd	FALSE
aaaaaaa	FALSE
bbbbbbb	FALSE
aaaaaaa	FALSE
gaaaaaaa	FALSE
babbbbbbbbdccbifgbfjbi	FALSE
jaaaaaaaaiggjga	FALSE
eeegeeeajfgcjfcdaaaaaaa	FALSE
bfhfhaabbbbbbbbicjfjccc	FALSE
aiejiefaaaaaaa	FALSE
edjaiccbjafjjbaaaaaaa	FALSE
hehbjejdgchciihaaaaaaa	FALSE
bbbbbbbddbfahgjehdggec	FALSE
aaebaaaaaaa	FALSE
bbbbbbbicb	FALSE
cdjfabiaaaaaaa	FALSE
bbbbbbbchghijjfcddebdhgj	FALSE
aaaaaaa	FALSE
aaaaaaa	FALSE
aaaaaaa	FALSE
ebjcaaaaaaa	FALSE
bfbbbbbbbbh	FALSE
aaaaaaa	FALSE
gfegbbbbbbbbaa	FALSE
bbbbbbbcjich	FALSE
bbbbbbbhggbhacfcj	FALSE
aaaaaaa	FALSE
aaaaaaaabajdb	FALSE
gcihbjhccaaaaaaa	FALSE
ddgaaaaaaaah	FALSE
fiibcaaaaaaaa	FALSE
jhhaaaaaaaaebidiaig	FALSE
hbaaaaaaaaacacjc	FALSE
ccbbbbbbbbdh	FALSE
bbbbbbbb	FALSE
dfaaaaaaaa	FALSE
cafbjjfebjaaaaaaa	FALSE
chgheiffijegadbbbbbbbb	FALSE
bbbbbbbaggehaidcffgjfedf	FALSE
bbbbbbbbg	FALSE
cjiccfcehaaaaaaa	FALSE
igagchjffbbbbbbbbbgj	FALSE
ehbffaaaaaaa	FALSE
bbbbbbbebeijdgigddcjdf	FALSE
bbbbbbbibcgfjbebih	FALSE
acaidbbbbbbbbb	FALSE
aaaaaaa	FALSE
abacbaabjibbbbbbbbbb	FALSE
aaaaaaa	FALSE
bbbbbbb	FALSE
bbbbbbbdbhf	FALSE
aaaaaaa	FALSE
fjecjaahiddaaaaaaa	FALSE
bbbbbbbhgafdjgbjjba	FALSE
bbbbbbb	FALSE
ghefefjgbdgjbgfcjaaaaaaa	FALSE
aaaaaaa	FALSE
fcbbbbbbbbjdccj	FALSE
eaaaaaaaaa	FALSE
fhhbehabebhebbbbbbbbbg	FALSE
bbbbbbb	FALSE
aaaaaaa	FALSE
dfabbbbbbbbi	FALSE
bigfifcbicbhjbbbbbbbbd	FALSE
dhbabeebaaaaaaa	FALSE
aaaaaaa	FALSE
jjbbbbbbbbjaiabhecjj	FALSE
bbbbbbb	FALSE
efbbbbbbbbfef	FALSE
bbbbbbb	FALSE
bbbbbbbbh	FALSE
bbbbbbbbg	FALSE
bbjiiidhfdigadhigfaaaaaaa	FALSE
aaaaaaa	FALSE
aegdeaedgjfjjeecdhaaaaaaa	FALSE
bbbbbbbji	FALSE
bbbbbbb	FALSE
bbbbbbb	FALSE
bbbbbbb	FALSE
dgbbfgbedaaeebbbbbbbbjcd	FALSE
bbbbbbb	FALSE
bbbbbbbbb	FALSE
bbbbbbb	FALSE
jbeafbgbgbabfabjibaaaaaaa	FALSE
jcibibfcaaaaaaaaea	FALSE
fagdcjbiebeddgaaaaaaaaegi	FALSE
aaaaaaaagfbji	FALSE
aaaaaaa	FALSE
fdahfaaaaaaaaicgj	FALSE
bbbbbbb	FALSE
bbbbbbbbdc	FALSE
ibfedigbbbbbbbbede	FALSE
fiacebbaiihhjjaaaaaaa	FALSE
bbiccgbbbbbbbbjge	FALSE
bddaaaaaaaadhj	FALSE
aaaaaaa	FALSE
bbbbbbbhfhbhahe	FALSE
aaaaaaaabgccbcdaje	FALSE
aaaaaaa	FALSE
bbbbbbbejbgjbjahjce	FALSE
bbbbbbbacaedcdhacjacf	FALSE
bbbbbbbbh	FALSE
bbbbbbbbfa	FALSE
ifhfbbbbbbbb	FALSE
bbbbbbb	FALSE
bbbbbbbbgafd	FALSE
ibaaaaaaa	FALSE
bbbbbbbfbjjfbhdfei	FALSE
bbbbbbbejidfeahaagca	FALSE
aaaaaaaa	FALSE
bbbbbbbffgb	FALSE
aaaaaaa	FALSE
bbbbbbb	FALSE
aaaaaaa	FALSE
cchdbhihaaaaaaa	FALSE
bbbbbbbeccecd	FALSE
bbbbbbbdeiahgicjgjfc	FALSE
eaaaaaaaa	FALSE
bhbbbbbbbbbgcheehch	FALSE
aaaaaaa	FALSE
fcjhhdgiiffdaaaaaaa	FALSE
bbbbbbb	FALSE
hhjchgjeebaaaaaaa	FALSE
ibbbbbbbbdjgegeibaabc	FALSE
ggfgicfcfjbbbbbbbbccjdc	FALSE
bbbbbbb	FALSE
igfdbhfifecfcaaaaaaaadjch	FALSE
bbbbbbbbbb	FALSE
bbbbbbb	FALSE
figbbbbbbbbadbiecbbbdge	FALSE
bbbbbbbeagbfdiggecji	FALSE
cejicdgjgcabbbbbbbbf	FALSE
bdaaaaaaaadfabcbfhcaiegc	FALSE
dgdadifdbbjhgjaaaaaaaaib	FALSE
icgedffhaaaaaaa	FALSE
geihjedcaaaaaaaa	FALSE
aaaaaaa	FALSE
bbbbbbbfggdaaih	FALSE
bbbbbbbdcajeadhedb	FALSE
bbbbbbbhed	FALSE
hjifefhaaaaaaaad	FALSE
ieaaaaaaaa	FALSE
ejfggaaaaaaaaabcdeddehe	FALSE
bbbbbbbafgd	FALSE
abgbbbbbbbbabhjfahigiihdh	FALSE
aaaaaaaa	FALSE
bbbbbbb	FALSE
abigaebjbaahfiaaaaaaaagce	FALSE
bbbbbbb	FALSE
bbbbbbb	FALSE
bbbbbbbcahb	FALSE
bbbbbbbgddhbaejjcaefcfeh	FALSE
ffhbiiaacbhbhciiaaaaaaaa	FALSE
baaaaaaaa	FALSE
aaaaaaa	FALSE
fcjbbbbbbbbgedcbh	FALSE
dfjjhaaccfdfheahggaaaaaaa	FALSE
bbbbbbbdccchciehj	FALSE
bbbbbbb	FALSE
aaaaaaa	FALSE
efhceaaaaaaaa	FALSE
cibgahbbbbbbbbhfghfaac	FALSE
iaaaaaaaaiagc	FALSE
bbbbbbb	FALSE
bbbbbbb	FALSE
bbbbbbbgh	FALSE
hfbgbfeeccjgaaaaaaa	FALSE
aaaaaaa	FALSE
bbbbbbbb	FALSE
ddieaiejbdedbaaaaaaa	FALSE
bbbbbbbcficaaaj	FALSE
bbbbbbbhea	FALSE
aaaaaaa	FALSE
iiebejgieaaaaaaaajceg	FALSE
jjaaaaaaaacfahgagjeehf	FALSE
bbbbbbb	FALSE
jgeeijdbdfcbhebbbbbbbb	FALSE
aaaaaaa	FALSE
bbbbbbbb	FALSE
caaaaaaaa	FALSE
daaaaaaaaaa	FALSE
aaaaaaa	FALSE
bbbbbbbcj	FALSE
gfhaaaaaaa	FALSE
bbbbbbb	FALSE
bbbbbbb	FALSE
gacjgjfdaaaaaaaa	FALSE
aaaaaaaaa	FALSE
bcjhbbbbbbbbjgeeihcdeifa	FALSE
bbbbbbb	FALSE
bbbbbbb	FALSE
aaaaaaaaag	FALSE
aaaaaaa	FALSE
bbbbbbbd	FALSE
bbbbbbbafeggbb	FALSE
bbbbbbbcgffhifcedbchihg	FALSE
jdidjgdgfbbbbbbbba	FALSE
edeaaaaaaaa	FALSE
aaaaaaa	FALSE
gihjdecjaaaaaaaa	FALSE
bbbbbbbb	FALSE
bbbbbbb	FALSE
cegaadcffgbacaaaaaaa	FALSE
bbbbbbb	FALSE
bbbbbbbffcjgcjfhaeejfed	FALSE
bdaedifdjeijcafjjeaaaaaaa	FALSE
hdchibdadbbbbbbbbabh	FALSE
hichajaefggaaaaaaa	FALSE
cheaadhbchagjficfaaaaaaa	FALSE
bacehhfiaaaaaaaa	FALSE
bbbbbbbhbhedbgih	FALSE
aaaaaaa	FALSE
bbbbbbbgjgjeabaaahd	FALSE
bbbbbbbabffj	FALSE
aaaaaaa	FALSE
bbbbbbbbbhjdd	FALSE
dbbbbbbbbbbd	FALSE
bbbbbbbaadagdc	FALSE
bbbbbbb	FALSE
bbbbbbbbe	FALSE
aaaaaaa	FALSE
bagdaaaaaaa	FALSE
hjbhfgdbbbbbbbbcgbgebaa	FALSE
bbbbbbbedieffdaae	FALSE
aaaaaaa	FALSE
jehdaacbeaaaaaaa	FALSE
ibbbbbbbb	FALSE
igddfjhfjffaaaaaaaa	FALSE
gjaaaaaaaaaggfgbc	FALSE
bbbbbbb	FALSE
bbbbbbb	FALSE
aaaaaaaagea	FALSE
ccaegefgbdhebbbbbbbb	FALSE
bfaaaaaaaabgfgehcaceihcag	FALSE
bbbbbbb	FALSE
gecjaaaaaaaafie	FALSE
bbbbbbbhegajahcjcgbaicie	FALSE
bfehefcaiabfgjiaaaaaaaa	FALSE
bbbbbbbahebdba	FALSE
aaaaaaa	FALSE
bdhgfadhfejaaaaaaaaacd	FALSE
jgjaeigdaebijjjhbaaaaaaaa	FALSE
bbbbbbb	FALSE
bbbbbbbfjjec	FALSE
bbbbbbbjcfjdifejbfieg	FALSE
bbbbbbb	FALSE
aaaaaaa	FALSE
aaaaaaa	FALSE
icehdihjgcaaaaaaaa	FALSE
dfaaaaaaaacafagc	FALSE
bbbbbbb	FALSE
eaaaaaaa	FALSE
iijgbeaaaaaaa	FALSE
bbbbbbbbddf	FALSE
