bfejibccejhfjj	TRUE
hhdih	TRUE
hhdhcecjhbdjgecfhhhade	TRUE
ih	TRUE
j	TRUE
hii	TRUE
fdicgiagac	TRUE
ceebdigdd	TRUE
begfecdag	TRUE
hidbhdcacjacgadaehe	TRUE
ei	TRUE
hjcdhfbbdcdfidah	TRUE
dcebjdbaibcegffachjbbf	TRUE
ibjf	TRUE
idg	TRUE
ihbdiedbihcjadgjhdaaihdbh	TRUE
jigheaegiejfcgeaae	TRUE
hghejfbjdggaadd	TRUE
dgbjdehibaaedfjif	TRUE
jjhijbbhcddbcjj	TRUE
gceajjg	TRUE
iefjecibbcbbdejecahfbiijf	TRUE
gifgfhjhgah	TRUE
chhejghdjahejhddeeffhagj	TRUE
aaebi	TRUE
bcejeieibchdjgccgdchechah	TRUE
jbjahgdiecaihcg	TRUE
cfjeigcgeiffcfhajbb	TRUE
diegdgiigbdidcbgijbcijef	TRUE
ggideghdfbhdjjabechafeed	TRUE
cbjfiedigdhibhffg	TRUE
jgjbgicdieeieaieffiahfdi	TRUE
fjccehahifgifhbjegegdifc	TRUE
hbcbgdejj	TRUE
h	TRUE
gcegjhcbacj	TRUE
fffhgffeicfjfafdhifhhbi	TRUE
ecejhdffffcdjbdchh	TRUE
fcggghehhjbi	TRUE
cbbgfidfcijef	TRUE
hbbcfididdjdgfggjebahgb	TRUE
acffdijaed	TRUE
bcfibgjbhcfhhjfhcjajgd	TRUE
dfghiebafbgcdgijedaebgdd	TRUE
eehghgcjbbhd	TRUE
ihcijijbhcfjge	TRUE
ebcgbjej	TRUE
eadga	TRUE
ehghhhdcahagdiidhaec	TRUE
cfacegjaifeagbggjdedjcidf	TRUE
haei	TRUE
ajhgjighaeggif	TRUE
hcfgfca	TRUE
aaiegahdifdgcif	TRUE
dcfhjjhfbjcgcgadcaeafafc	TRUE
cffjbggdiahfh	TRUE
afidfhjbheihgiafhhgidgdjb	TRUE
idjgceecgcach	TRUE
ihciedechibhjfjaeffiehdf	TRUE
deccfbediddhicdjc	TRUE
ggbbfaaccdcejaajb	TRUE
c	TRUE
ccbfgejb	TRUE
bajcah	TRUE
biefi	TRUE
gihebcgddcajfbfichcbcjhdd	TRUE
eig	TRUE
cfibaigabbfig	TRUE
ihehgcdhdcdbeedfaeigge	TRUE
ajfagcbjcecdeibfg	TRUE
feceedaccbigai	TRUE
efdfbijbjgjbaaa	TRUE
d	TRUE
jjfiacdffaeficgeifjbg	TRUE
chj	TRUE
djiiiieabejbi	TRUE
aaciedghfdeefcbihbjih	TRUE
gdfdjecigiicfhcidbbdaig	TRUE
ai	TRUE
gdbddj	TRUE
beeghiidb	TRUE
jjafdggg	TRUE
ahebchjcc	TRUE
gbciichifabiji	TRUE
adgieiafajh	TRUE
cciadffcfjahigjji	TRUE
ghfcgjgbighfgfhhfhgcbaida	TRUE
aeiefccaheggjheh	TRUE
cijbagfiee	TRUE
gfbhaefeacjbhcdgceig	TRUE
fhfbgabdhhaichcieddfcg	TRUE
aicdga	TRUE
ghjbaaehbeida	TRUE
agabjheg	TRUE
iaafbbehbjcbdefhijbeh	TRUE
beebjdjfdiaif	TRUE
eabdhfaabebbidehhdgdggbhj	TRUE
aeef	TRUE
ggaa	TRUE
eibheghcajgeehfjciejba	TRUE
jejeiccaaehfdi	TRUE
icid	TRUE
cbfgfhgbighdhebhhhibea	TRUE
cjiggcfadddajcffcfja	TRUE
gcibfaejadbgdjfhfjbb	TRUE
dijbechehcedbjgbhhahdie	TRUE
bj	TRUE
iiff	TRUE
iebihiaijgacejhief	TRUE
dficdacc	TRUE
eihjdjcjjiabcbbegb	TRUE
bf	TRUE
hebeefdegfifjaiiejggfeh	TRUE
abfeajgf	TRUE
bhjdagbeiaajeec	TRUE
dbjided	TRUE
i	TRUE
ccjcdjigebibbjebccah	TRUE
hbcgceccbbceibfhgi	TRUE
jhfiddeajfciafdedfbi	TRUE
ceidiffbfhidjdegga	TRUE
fjhbjdafh	TRUE
d	TRUE
jah	TRUE
gibhi	TRUE
difdhghgacacjjhjji	TRUE
aicaggfccbiidbeecfjgc	TRUE
jaffhghdigdeig	TRUE
bbcb	TRUE
ieeihecidjbjjcgbbj	TRUE
gbiicfchbccgbbhi	TRUE
ccffigdahiid	TRUE
fhjjdedb	TRUE
ejdjhcb	TRUE
decgeiifeicaacbgadc	TRUE
dfaihaighhheegbgcegde	TRUE
ibdghjihaecdghghiaaccd	TRUE
aibcicj	TRUE
chejfjijdhceibaaiefjf	TRUE
ififgcjhibbibacacejch	TRUE
hcgibccadggifgejjdh	TRUE
idjadieheidh	TRUE
hhjeffjaidfc	TRUE
ffeiaddaeijjabgjbd	TRUE
cjb	TRUE
iadadci	TRUE
jbdecb	TRUE
ejbeccijdahfjieeihjebjg	TRUE
eb	TRUE
eii	TRUE
aigabdcjcaagjdje	TRUE
gcfffcbihde	TRUE
ichaaf	TRUE
iaicgdiebdfajaebfehedhie	TRUE
ag	TRUE
ebehdgac	TRUE
bhhbai	TRUE
jfaciacjidbfghj	TRUE
daegdhbffe	TRUE
cj	TRUE
jg	TRUE
jijdegifhbadegc	TRUE
agfeehjdejh	TRUE
chefhdjabebihdhbdiffejdhb	TRUE
bihbfeajccjidideccjfaag	TRUE
ddgjijegab	TRUE
efigfbhbfaehdhhgjeeg	TRUE
ideiagg	TRUE
eceajhfbggfbebch	TRUE
ageheifibiafeafbb	TRUE
bh	TRUE
jgej	TRUE
bdagfhjdejciih	TRUE
gigdhe	TRUE
fjeiifbegdchagcdbfjaajfd	TRUE
ebacdgdjfb	TRUE
adiggadcafgbeihibh	TRUE
igfbacgdahjefhc	TRUE
jabhfegfcbfheeefbfh	TRUE
cffhajgjdjgbcdgd	TRUE
jjgeeffebfjjbeiagfcffb	TRUE
idhchjgjbajgigabafccd	TRUE
ifbecdhjgehcbaca	TRUE
gbiicicgafaaf	TRUE
dejbfihjdcee	TRUE
jfidehfchcagijcgf	TRUE
hdhdcbdhfdfdgeggehjgifhfg	TRUE
bideifhcdef	TRUE
jddfc	TRUE
cebibhfdeajiihagijcecjia	TRUE
bgihibije	TRUE
deigjgihajchcecgc	TRUE
iagbachaaficafaehdbic	TRUE
beccdigheejbfcfbffa	TRUE
jhehccjebjehj	TRUE
dbfdijghccccdehae	TRUE
ggffjeahafd	TRUE
bbchahcdgb	TRUE
biebjfhe	TRUE
aibbfccihf	TRUE
ijb	TRUE
ifb	TRUE
fbjaffgbhbdcbbjhf	TRUE
hcfbacigidfgbgcigdad	TRUE
fjieggiddjeeaf	TRUE
ib	TRUE
cidgjbjbifibifcf	TRUE
bdfafgghhidjgfbahgifhjh	TRUE
ajhihdfdeeg	TRUE
ijiaggbiaia	TRUE
ahhjgadbbd	TRUE
hhifajbidhcfgjgadfcaieaec	TRUE
gccgeechfihfhbjiidgdhbibe	TRUE
hihiege	TRUE
eejfjgacdacbfehiffcg	TRUE
ajjbcbigfejccbicfbg	TRUE
afdghfbbhgjcccefdeefc	TRUE
gbaeebediheaigja	TRUE
geidghdjeddgfh	TRUE
dichbagdjdeacadfhhgiib	TRUE
jfhcjefhdijdga	TRUE
cdidihfbcjfb	TRUE
jejhchebjidaaje	TRUE
fhdddbgf	TRUE
ddibacghbj	TRUE
fjbhjcheghiijhicbb	TRUE
hadfdjdda	TRUE
jfjagcffca	TRUE
jbcecfdghijfejgfii	TRUE
gahjihgecfdafdiiedgjfgcgj	TRUE
eadjhdajfecaehfejcf	TRUE
hchcaf	TRUE
aacegeffbjacchejec	TRUE
iicabbjbijjbefgbegfeh	TRUE
iedbd	TRUE
cbjgdg	TRUE
gfcfadecdccddghd	TRUE
gfgdfjhid	TRUE
bffajijdefcj	TRUE
ggfaeiha	TRUE
bdgefbcf	TRUE
jjjdg	TRUE
fiihbiicijhjabdb	TRUE
jfaigebahhcf	TRUE
dfbj	TRUE
jgbdahbcgdeeeidc	TRUE
edbbfcifdbig	TRUE
difegdcgehghcheddhejcbb	TRUE
fbfajijefjadgidhafegbhj	TRUE
aedijaghdjaafhgadhib	TRUE
ibheicidbfjcdhbcef	TRUE
df	TRUE
fabibbcdbfejijeedch	TRUE
cabafejjhffij	TRUE
gaihfefaeaaacabeg	TRUE
dfe	TRUE
jbjgf	TRUE
d	TRUE
edgce	TRUE
cbacdfgedbiaajjcdji	TRUE
cejbfibdifcgfge	TRUE
cijhbfeccaebii	TRUE
hacecdjaigie	TRUE
aefdibbghcddgcjghihdbgdjb	TRUE
ghdibhfcb	TRUE
fjjchchgbacbaid	TRUE
gfa	TRUE
jdcjbfebhijeebhdaigddjc	TRUE
ahhgh	TRUE
ghf	TRUE
dbehhejcjjjhhieh	TRUE
jfddjgghajd	TRUE
fhidbdhbfagfbfhhe	TRUE
hegc	TRUE
ijhafegjcgcicgihcddgaij	TRUE
dbbdedejfjf	TRUE
hcbaddeajbhjfebgfh	TRUE
ihajedijhfddbffdc	TRUE
hjdjgaad	TRUE
jefdahcbhcdgcefijdh	TRUE
afhaigbgjifjca	TRUE
ffdgddhdfahadbaageehgi	TRUE
hbddca	TRUE
ibdjg	TRUE
fg	TRUE
jfgad	TRUE
egj	TRUE
behiddhbb	TRUE
jg	TRUE
dgbjebfgfhhfdei	TRUE
eeacjdcajajjficajfc	TRUE
ibhc	TRUE
aheedfchafh	TRUE
higabdjccghic	TRUE
jiac	TRUE
fbcdehdejffaadggdbf	TRUE
efjjbgcicahgdjidefdaj	TRUE
gichfcchhchebaibaffa	TRUE
eiiibdai	TRUE
eccifhbffbdabiag	TRUE
cihdeibjib	TRUE
gijjgcfdafeiggefbejiffhjg	TRUE
ggjgecjhdfeiedegbhcijdab	TRUE
ddhg	TRUE
afjbacdhifbdgf	TRUE
dhichcfbihaaj	TRUE
bdfaaghgdhfbhccji	TRUE
bddciebeidfffdi	TRUE
ejidghajgfhhfbihiea	TRUE
hjebhfhibejedi	TRUE
j	TRUE
chgihhhfcbjdjhfih	TRUE
cfbejfaaafcjeddgdd	TRUE
bee	TRUE
ggcfjajieced	TRUE
jeiedheaiibjajfhchfhibdbi	TRUE
ijcjeccaidfgfhjfe	TRUE
djhiijbhiajcdjbgefig	TRUE
ggg	TRUE
cffch	TRUE
jiaagjfjgjgi	TRUE
fjdecfbdcadccadcijdbcjd	TRUE
efcij	TRUE
gefbabbig	TRUE
ff	TRUE
ceefdeehjfbcgiijaac	TRUE
cjdc	TRUE
adfija	TRUE
eahjjfjdgeaafd	TRUE
abigfei	TRUE
fgaeagjbefgeffeeaceabgj	TRUE
ghgce	TRUE
ac	TRUE
feegejbcfba	TRUE
gfiaeegfdehbfjdfjdfa	TRUE
igeacffhihc	TRUE
cdhdghehijhdcg	TRUE
chbghg	TRUE
ddffdediidijaaecfecj	TRUE
ggfadfihdeaffjafcchchc	TRUE
ecjhbibdhehcfahfbfdjgbec	TRUE
ghahgjaee	TRUE
cbhiegg	TRUE
dheiah	TRUE
ieihgjgdjfdd	TRUE
ede	TRUE
cddajeiijigfiacejhgge	TRUE
dfejfiaijciacdej	TRUE
dbefdcijhdhhihfeaffb	TRUE
cgfdbda	TRUE
jjcjjbhccagcfadeibhfdfcfg	TRUE
a	TRUE
hgahidaacibdj	TRUE
hafi	TRUE
ghicjghifbgbbcigfhi	TRUE
jjacac	TRUE
dfbebeaabgicajibbbi	TRUE
jaed	TRUE
jfadeeheih	TRUE
fhahbffgdiigdaahdiacjja	TRUE
acbaeehdfgcjc	TRUE
fjhiddedag	TRUE
eedija	TRUE
f	TRUE
gddaadjghdfdecaeefejgd	TRUE
bfgbhbhcgcic	TRUE
ighbicjhj	TRUE
db	TRUE
gjbgdbda	TRUE
didjcbg	TRUE
gfbbchhjhhcbhaeddgbhdjafh	TRUE
e	TRUE
aiecffb	TRUE
bfdichehfjjegehghb	TRUE
jefiabj	TRUE
eebidjjjibggcihiajeejeeg	TRUE
eaaddgfj	TRUE
f	TRUE
eiacgcbiefebgii	TRUE
hgfebdjbiddfadgdbjaajah	TRUE
adegf	TRUE
eghjfjgfahjhe	TRUE
dcijihhgadbaaj	TRUE
ajecbffdj	TRUE
fjageajfhbeiajfjgfiagj	TRUE
effbaejdjg	TRUE
a	TRUE
ha	TRUE
agdjjgejejbhaihjjb	TRUE
dcchfcd	TRUE
hccgghbh	TRUE
fhhhdiadhibgicbfjgdeehgi	TRUE
cgicfdhfehaeaifh	TRUE
gggaafadfedjdeigicc	TRUE
acgbccdghgfceccfgigdajgf	TRUE
jifghhhgdhiiiaghchjdh	TRUE
j	TRUE
hj	TRUE
idihhbfjhgec	TRUE
f	TRUE
cgcah	TRUE
e	TRUE
icdgjejahebbg	TRUE
hhafhhbhj	TRUE
ieaaiafgibddhb	TRUE
ijfghe	TRUE
bhihjdhhjcaeffbhhjgdffja	TRUE
cheihhfccac	TRUE
ccfbdchhe	TRUE
hjdgaffhjb	TRUE
dfghbbgfciidfjgh	TRUE
cjcbihhifc	TRUE
dhfffhcdjeeibighbfcabjj	TRUE
cchhbfiabh	TRUE
dhhb	TRUE
agdijgfebccjagiccigjji	TRUE
cgeca	TRUE
daedeife	TRUE
a	TRUE
hhbfihahbdcegdbhgbhgb	TRUE
ehhgfjgg	TRUE
hifdfhcdad	TRUE
hgjchaicbadgajf	TRUE
egahffidfbicggcjcdfd	TRUE
ggeceffbicjcj	TRUE
jjf	TRUE
cffeecghgicijfbbaehab	TRUE
jejibggijbicbgfcjbcj	TRUE
aeihhfabaagabbjb	TRUE
eiac	TRUE
afeidhfgjbfjd	TRUE
cfhadjghgfjeaibagddhgdb	TRUE
acbacefegffgfbcjjfji	TRUE
gffbjfb	TRUE
bfg	TRUE
ggcdaacagefhghdcjhjfi	TRUE
ihgdhaaicaeaddgdd	TRUE
aiggccccchibcdd	TRUE
iahbgbjjihf	TRUE
icagfcc	TRUE
icgiieaicaaaefiddifegif	TRUE
hg	TRUE
ccjcfbjgeghiechg	TRUE
biibcbbeb	TRUE
figbfggfaigdhehdi	TRUE
cjdjhi	TRUE
jchchj	TRUE
ggceheeebdg	TRUE
jcjjdjjfbhbbdbbdig	TRUE
ieijdbc	TRUE
dadgchcjhcg	TRUE
bfhgcjcfggdeccgdejddad	TRUE
cfdffacig	TRUE
bcbicfiebfejbje	TRUE
bcfaicdciehfch	TRUE
hijddgcgafigf	TRUE
ijhiecegfciheejfjfddbeh	TRUE
gfijba	TRUE
ciajhgggiifgifdjjbaeafcg	TRUE
eecdgdd	TRUE
hbbcegejddhiabbheeiii	TRUE
heg	TRUE
ggdchcbahccjffaggajejdiic	TRUE
bejhicbdjbhbjgegbihicbfg	TRUE
bfcja	TRUE
f	TRUE
eaefeiabaf	TRUE
jefhdhchfabj	TRUE
dcgcdh	TRUE
cihhfaafcbjeggjhge	TRUE
gidgfcihhjfhhefgcadgdc	TRUE
dcg	TRUE
dgcigcgagbah	TRUE
ifhjbhicjgebgbjfhcga	TRUE
j	TRUE
gbifihcjijhifbhbbjh	TRUE
f	TRUE
iecfghcaagaddgjgghgfb	TRUE
cfgafgegdhf	TRUE
gfbjahhgcgeecbghhghhdg	TRUE
jjejdeeaajh	TRUE
jgidjjbb	TRUE
geehcihahabcefebihighehf	TRUE
hfbffhbbcgffhcaecdj	TRUE
hdej	TRUE
gbdbdgjfggfgfhegcgfhca	TRUE
jcdgacfeadcegifa	TRUE
fjgjghcehigcbegfjidchg	TRUE
ihddcfdhicfb	TRUE
jiggajagedeiafcfgdiafigjd	TRUE
cjchgjjebbabefhcachji	TRUE
ijfebgeeddhgceiajdje	TRUE
bfjfiajagdhbf	TRUE
bbjgjfacc	TRUE
gcdbbijfjedfabj	TRUE
efabiad	TRUE
ciiabbjhihjjbhbcj	TRUE
idebhfijdhfg	TRUE
dfib	TRUE
fhbejifjjfjieef	TRUE
abebha	FALSE
hbdabdihebadf	FALSE
ajggcbaabdhghifbdaebga	FALSE
dgabcbcjghbfigaieijjagi	FALSE
gjadbjbabbahbdaijehbegbf	FALSE
abbaebaababghdajjj	FALSE
aajgdcbfbbdgidhjag	FALSE
bebabgaabba	FALSE
edajbgbaa	FALSE
afebibjfgdbjja	FALSE
caacjjebiaibjiha	FALSE
hadcdhgaabedbaehgbaa	FALSE
gaeijbbaafa	FALSE
ihbeajbjgbeehadhfddd	FALSE
eaihbbicah	FALSE
hibeabdbabgba	FALSE
abbahgb	FALSE
abddbgadif	FALSE
dhcagacghcfafdfgibbgebfa	FALSE
aeajciaehfabgjbhabgjefh	FALSE
jifgbaabba	FALSE
dabehbebgdda	FALSE
eeadajbbegeebbdfaabg	FALSE
gacafgdhgddadjfebbba	FALSE
gababbdagiahhdah	FALSE
ghbfgaebbbdbifejahdah	FALSE
agbbegbdeahj	FALSE
aajbgeaabegjaadcgbeagdb	FALSE
abbgaide	FALSE
jbjaifjgibhbjbaag	FALSE
egejgabdcbbihaeiaiddaehhf	FALSE
abbfiihbagdgaje	FALSE
abbaa	FALSE
deeagibbcidfeijaa	FALSE
cbfebeagbegbaaj	FALSE
edaieadhdgcbbbfafa	FALSE
aabhbaa	FALSE
jabhbdaaaechbdifaj	FALSE
aabgihbca	FALSE
ihcjabba	FALSE
igjabjfdbddbagbbac	FALSE
abhbfad	FALSE
fjhfjabcfbiaibaha	FALSE
iiadbfibja	FALSE
abbea	FALSE
jhfahhbjhefhcibdedabai	FALSE
gjihababahcefahiif	FALSE
aiachjhfgbebjbhagbciebdac	FALSE
aebbihbeia	FALSE
dggabbddgdehaig	FALSE
fifdbaaceabcbfjdcebaheb	FALSE
cefaefcjbgbhcbafgd	FALSE
abbba	FALSE
gebgjdjjahdabibbbaadg	FALSE
abbda	FALSE
hiabaaedibcfhefccgbhae	FALSE
iabfcbcdbba	FALSE
fabhbda	FALSE
aabbghac	FALSE
ceagdafabfagbbcjiidaegade	FALSE
ejhcahdibbbfaee	FALSE
cigajfbjajbacbiihjf	FALSE
abeba	FALSE
abbjababd	FALSE
fhfabeba	FALSE
abba	FALSE
eabaheefba	FALSE
ieahbbgbahajecfjibigb	FALSE
abba	FALSE
iajhebhgiahefba	FALSE
abba	FALSE
abba	FALSE
ajafffbbba	FALSE
jihaiibbecbaaahj	FALSE
hababbbcfhba	FALSE
cfcabifjgbhebaiba	FALSE
abiiba	FALSE
habidjecbgbhdeihhbbdcdbca	FALSE
abba	FALSE
abfba	FALSE
abfba	FALSE
faaagaejbjbbaea	FALSE
heieiacabcbadficaefbededd	FALSE
ffgabcbafa	FALSE
agbba	FALSE
abbabdfb	FALSE
jabidbjaebi	FALSE
abibicdbfga	FALSE
ahibbgbidihdbadahef	FALSE
caecbceeaiafjbedah	FALSE
abagibbgebahca	FALSE
dafeccaaeagigbebcbdadidd	FALSE
bebjfjjagjabdbggbdebcag	FALSE
hbefacbabah	FALSE
afhadfafbbagebaicjj	FALSE
iabbdaebd	FALSE
eagbhibjaebadae	FALSE
acbbbbiaa	FALSE
fjabbbbaha	FALSE
ifdfgjdhaaijcbbajaea	FALSE
jaaeehcbecbjcbjefdba	FALSE
ebahabicibejgaibhifha	FALSE
eiacficjbcbafbeagab	FALSE
fifaaebba	FALSE
abbdfea	FALSE
fjhajihjebbcaceha	FALSE
aaghgbgejahhbbihedhadfe	FALSE
gabihacgbgbfai	FALSE
bageggeabbcbai	FALSE
bijjabibajgafccdh	FALSE
abbibag	FALSE
abfibbbfabjj	FALSE
ahhfcbbac	FALSE
abebeafda	FALSE
aagebaafihjbbbeahh	FALSE
dfcaibbigacfjah	FALSE
afgdafbhchcbab	FALSE
abbfddicdeedgiiaaa	FALSE
baaedgcdicjhbefibcfa	FALSE
gbhbachcaejdghaabbhegaej	FALSE
abgbagaj	FALSE
dficaadaicfgbjghefbgaag	FALSE
afidffhcabjbhgdbbagi	FALSE
abibeae	FALSE
abba	FALSE
jadbjbfjga	FALSE
abejbeidgfhfddejegafb	FALSE
cjifjbabejbah	FALSE
chebcccafibbagcjc	FALSE
abfbbbbaga	FALSE
babbba	FALSE
faejffdbbacgja	FALSE
aebgjbifbajhca	FALSE
abba	FALSE
abbia	FALSE
dfjcjcaajcbgdcibebahe	FALSE
cejhaafabaeahbciieacaei	FALSE
ccaiejcbebajigieagf	FALSE
abbaec	FALSE
fabbaf	FALSE
cidjbadbjbha	FALSE
abba	FALSE
fagiiaicaabaefbbgfbeagh	FALSE
abba	FALSE
djdabedebaeegf	FALSE
fabfajgbfbjiehdjajcahh	FALSE
dafdbfbjeaaiafdb	FALSE
aacbdhiebbigajcggjagjfbi	FALSE
idbabbdhegbbca	FALSE
heiaabba	FALSE
iafabjcgbhai	FALSE
fejheaijbacdjdbfbcbafefaa	FALSE
giaejcbjbfbedigdbabgeefa	FALSE
abbba	FALSE
gabhbgga	FALSE
abbaicbe	FALSE
cabba	FALSE
cjddhcfagfbbba	FALSE
ddcdbidafbhcadbfbabiaaijf	FALSE
jciffabebcfaehgd	FALSE
ajbbbagf	FALSE
dhadebjbdah	FALSE
agabbgaa	FALSE
adbbja	FALSE
afcfbgba	FALSE
afcicgejbbab	FALSE
iejbaffgbjccbigea	FALSE
dbijebcaajbbebhecfaji	FALSE
ecbabfgba	FALSE
jajcabbagababhe	FALSE
jahbjbaafiahfcjjefeacf	FALSE
adbchccjhbfafib	FALSE
jeaefcedbafgcedcbbiaihdg	FALSE
cdgaiabbcjfgeebda	FALSE
habbfgfeegeaafbffagfgb	FALSE
ahbabbbbfjadh	FALSE
aabeba	FALSE
cchbadjadcbeba	FALSE
adahbfcbgdabbcbe	FALSE
jaegebbbffbad	FALSE
eaafbcbceaf	FALSE
cbafgbcaafibajgefi	FALSE
daceabbagjgadigc	FALSE
iaiiaeacccefggbiebagfcf	FALSE
abba	FALSE
fjajbbga	FALSE
aeabbag	FALSE
aeahbjhghhibebaha	FALSE
hecafeabahebhagaaebde	FALSE
hdaibgbbdage	FALSE
aaadbgdfbfac	FALSE
abbbadgjegdagddjgfacd	FALSE
gajdeggebjhfabfidghecha	FALSE
hdaagajefcbjhbbga	FALSE
acbhjbbaffdgeb	FALSE
iabibba	FALSE
affbbaacjah	FALSE
hfdbfcegjhiiabebeaafbhgj	FALSE
abba	FALSE
iaejggbbah	FALSE
eajfbeabdigcajcbbeca	FALSE
jajbhgbgebgaicedjibdgh	FALSE
adabgbeaeccfd	FALSE
gachbbbaabbbaceec	FALSE
jhafecbaijdcbgieaagibhed	FALSE
fcdhjaeabbeaadj	FALSE
igabjbafbabgghhbchab	FALSE
abbfca	FALSE
ajabbhhdigccjgcibhjaehcaj	FALSE
iachajaiibbiffibgjihaa	FALSE
abebdifac	FALSE
abdhdbcifiddbiaec	FALSE
caaechhdaebbaiggjdb	FALSE
gciaggibbaejicdacd	FALSE
dcbaibbigahhafieeacda	FALSE
bfcfgdabgbbcfabgiga	FALSE
abbjag	FALSE
cagccbbebacdad	FALSE
acgjbbghaaeff	FALSE
abcba	FALSE
abbabicafhdjciha	FALSE
jahahcbbeaaah	FALSE
jfaahgbjdhibfbebeab	FALSE
abeffbdhdeaaaec	FALSE
jehfaabbjebhahehaffbhefba	FALSE
ebajcbbbfjbdgejafjjhfadj	FALSE
aebhbda	FALSE
chacgjcbifjhhbfhagi	FALSE
iacfacjjcgihhebbiebaj	FALSE
abba	FALSE
gafijcbba	FALSE
jagdfdbbdbjca	FALSE
idadeibbbbgjbdadcfeib	FALSE
efgebafjgbbijabe	FALSE
cachcbgadhhcaedaebadddj	FALSE
jagabbia	FALSE
eaghaejbbfbfbcabacjgac	FALSE
eahbdbjca	FALSE
abjhbfhdgcfea	FALSE
ahbba	FALSE
eacfgacbbebbagbai	FALSE
afbba	FALSE
aadhijbbidaddhbechaig	FALSE
igeagcbbdbadefgdaafia	FALSE
hajehgijiaefbabfedicbadj	FALSE
abbgfghjbjagciiffchejih	FALSE
dhabifijgddjiibbaga	FALSE
jcajejidaicbba	FALSE
djajdcbbefbhcaiidd	FALSE
ahjejbcbcedba	FALSE
jdbgiebaabfcbda	FALSE
cabigba	FALSE
aibgcgbdjfffjeada	FALSE
caabgcbah	FALSE
abcbai	FALSE
abba	FALSE
abba	FALSE
ahbcdjaacdifgaffhabfdabd	FALSE
gabiiba	FALSE
abba	FALSE
ggjdabbibaa	FALSE
dadcebbah	FALSE
habeba	FALSE
aaafchibdabddba	FALSE
jbgaafacejdfbjhbjafej	FALSE
babjbdag	FALSE
acbiibba	FALSE
bahbijhaebeea	FALSE
ehiieeabbadgedajhgij	FALSE
abba	FALSE
abbabj	FALSE
fabba	FALSE
gfdegaabjcbbiadfijfc	FALSE
bjadbgbad	FALSE
iiaibgfcjhbaeajgc	FALSE
abba	FALSE
agbagbdca	FALSE
cbafbbga	FALSE
ajfbbbaadbagbgedaehjhjcba	FALSE
bgabifghhibjachdbihegbia	FALSE
aagabbhccijiififdicbafdj	FALSE
gagebbjcea	FALSE
adfbicbjdefegbeachi	FALSE
abhbac	FALSE
geajebbafbfdcadabggi	FALSE
abihgbaaif	FALSE
afbifgibajfba	FALSE
dabba	FALSE
bahjhajbhbiihddfaijajiibi	FALSE
bajefghfdfbbfidaif	FALSE
acbdebjceba	FALSE
jagggabdbbeeieaddidifhfjc	FALSE
dhaajebdhdbfbfcca	FALSE
cbabgchacebcbegaih	FALSE
aajgbegbeiifhbcaaaigcifch	FALSE
aibba	FALSE
habcbadgjhjaehb	FALSE
aibbaj	FALSE
iabhbbcaab	FALSE
afbgbegeghhdbdgabajhge	FALSE
jeabcfccgiafghhjbiafjj	FALSE
aaeahfaabfagdbahdcbaccdcj	FALSE
aadbbba	FALSE
abeebabjf	FALSE
abbgbfba	FALSE
acbafebbbdfddaaa	FALSE
ibadgbfbaaie	FALSE
abba	FALSE
jjigdddaffjbfeifbfebabai	FALSE
jgaaahbjjfhbcdjhbdahhbha	FALSE
abbadgj	FALSE
abjbbcah	FALSE
ebhfdcabddcbihhah	FALSE
bggjabbbagj	FALSE
dabjhabaejadc	FALSE
eeabbha	FALSE
abbghad	FALSE
eaabjfidiebebicjjha	FALSE
agjbhbfad	FALSE
fifabbhdehjabddf	FALSE
gfdhabfbggaad	FALSE
jgabba	FALSE
agchbebihabe	FALSE
jdagbafdbac	FALSE
ejegahbcjjdageibbbaa	FALSE
ejagbbdbjbbaadieajf	FALSE
bdabafhbgfbgjajhhhhdeh	FALSE
cbbcfeaibebafa	FALSE
hihabbjbcghcbiaai	FALSE
abbaceggfbaa	FALSE
egaifbebagd	FALSE
djgabba	FALSE
dabihbgjebfa	FALSE
gghjdcidajiicibhhhbdadiji	FALSE
dafdbjcbbaae	FALSE
dagjdhjbejbfihabhibidf	FALSE
jfaidgchfbbaahce	FALSE
ehaiiadgbjbdhgdabichdgfha	FALSE
cbgaigbjcbbiafjf	FALSE
febjedebgbbabedadeebbaj	FALSE
baabjhbajb	FALSE
agbdbbajhg	FALSE
bgibhdaijbdefgabafj	FALSE
fajfbffbdhaecac	FALSE
ibdciedhefceabedidabca	FALSE
ahbdbceiagbffiijae	FALSE
ajedabgabhebcgaaccfefgjdc	FALSE
ahibfbcjabgih	FALSE
biabdjgbedbbejbaif	FALSE
egabdefcdbdgchbaeiaj	FALSE
gdhcaeajjeahdbbaiiaegeb	FALSE
abbaib	FALSE
addbabhbjiaicdc	FALSE
geagdbbbdaebbfhgad	FALSE
abbjadi	FALSE
abbaa	FALSE
agjbfbdaj	FALSE
cbjeagjdibbabibgaabji	FALSE
afgffcbcbdhbaajfgde	FALSE
djijdcaahbbejaa	FALSE
biahbaabfjcba	FALSE
dcdjacgiahabbaeddfacedh	FALSE
abba	FALSE
abdaabchjhbjbacbcbija	FALSE
gjabibbbbeeiaiigjj	FALSE
abba	FALSE
iabbeahbdfea	FALSE
cachbbaffa	FALSE
abaidbdba	FALSE
ehabcbdadh	FALSE
bcfgabfjgcabbah	FALSE
ahadgigbbaiejjgfejgiadbhf	FALSE
abdbfa	FALSE
ajdbdfadbaihib	FALSE
ahifjcefbeiabbjghbcda	FALSE
iaedicabhdehjejibgbbjgjba	FALSE
bicidabbhaa	FALSE
idaighbdefbdca	FALSE
ieahijbadbia	FALSE
ghcjgfahbegbifbihafebaa	FALSE
hajffcdcabbhjecbebdaja	FALSE
afbgba	FALSE
hbabihddbaibdhjaded	FALSE
chabebcajaia	FALSE
fgbgabbjahjefcigbahhg	FALSE
dabdba	FALSE
abbea	FALSE
baggabcbeea	FALSE
cgiabbbfaca	FALSE
abbachfcjebjigacidjc	FALSE
ibahbibaijcca	FALSE
bahbbfhgibajdhbjaah	FALSE
jfajabhbbcbbcijagdb	FALSE
gbagbbhdjfcbhgibajjahb	FALSE
abjbcia	FALSE
abbjacbghbbehechcba	FALSE
aabdcgbcdeagdacih	FALSE
efabjehbjgeggadbajhg	FALSE
fgiacaebbgcfhbcacdafgcbc	FALSE
aeibbdahadbi	FALSE
fgffeabgijbjdhidddfccajc	FALSE
aaccfbafjcjgjjiaabbhdaii	FALSE
aebdjjcgcbdjaf	FALSE
jagebbedba	FALSE
abajbjebaac	FALSE
jbjjhggajadbbbhgada	FALSE
eaaaebbbjhiefaaejf	FALSE
ajdecfbbbabaggie	FALSE
adjhcgbiidghbdca	FALSE
gjdjaiaaegdbibggahibia	FALSE
abbag	FALSE
feababbjaaa	FALSE
adidaifbacgbfbbhbaaec	FALSE
daibbai	FALSE
ajfbihcjibaebgjcagdc	FALSE
iahgbgebhcbgebadeaabjhei	FALSE
bajbbacc	FALSE
jaabebdahagie	FALSE
ffbeaiaibbagba	FALSE
aaeeedbiiibbfeaddjiace	FALSE
ghacfbgbhbjga	FALSE
ehaibbfjaadecj	FALSE
hgaheihbbbadccjijhhchh	FALSE
ceeabhabbhghajbicciabff	FALSE
jehabgabdfagadcb	FALSE
ghdciefeeaijahbdebegfa	FALSE
abafegdbbehgbia	FALSE
jaagabedhjihjiabdbad	FALSE
cbahabbcbjicdcbdigda	FALSE
bbfhhcbgajhihcajbibbbha	FALSE
hdaacbddbfcdeafb	FALSE
ideidhdaebdbfeaa	FALSE
eabajbajaedc	FALSE
haebbbbgafdg	FALSE
ehabdbdbdfhabeef	FALSE
gabbaj	FALSE
hafhfbbhhba	FALSE
dhdceajabghibabi	FALSE
abgefhebbbeecaadbdfihje	FALSE
ajabheagebbiaiehefgjeghdf	FALSE
