O¦vã¢ÃèøàÃ¿	TRUE
KV	TRUE
jOkp½ÛdÖI½Ëé7J÷îµà1Þmym	TRUE
u®äèwtÃÚGoD	TRUE
Éò±MøÓÃÖd±Ý×4ÏÄ´QíZ	TRUE
eÍ³ÃÉoW½íÜ¡ÎÅh³	TRUE
áYØçAOFÊuKv5	TRUE
¼àöt´C	TRUE
u½ëwË»¿ØBÇ¡ÉA	TRUE
HjG¥Ï¤éT¤«ªxó8Qº	TRUE
yoÒJVjËÛÓ¯F	TRUE
ÈãFëzÁtgcºÜ5î	TRUE
ÑÝ7¬Ì¸Ôø1êö¯¿Fp÷©·xð	TRUE
aQÌ¬PåèMOm¡ã¿bÓêd	TRUE
çzsnâgsÌKAÀ1	TRUE
ç	TRUE
CØñ¨áÌwËöNY	TRUE
¹81l3½Ñ	TRUE
z¬x£wo°îÞßËÂmßÙ³Q8Á	TRUE
ßÑí°Í¿M¡	TRUE
Ñbó4o²¦°Û4WÕV­©C	TRUE
ÂaI¼ÜjÈdzoõíìÅëÐuN²I	TRUE
3È½¯ãk°F½Y¯hð¬pxHº	TRUE
tÑVC6LÌ¢ÆÌÚIp²qByDë	TRUE
gW»Þ±eòNÌäÇm1Z÷X¦ÖæFUdjo	TRUE
íî2r÷fá¼C÷±Îá	TRUE
±º8d¾uäOäGM¡¡8VÉsçNÓlè9x£	TRUE
ðÒîÐ«ÐLGæQÂÁê×ªcóÌ¬2ÈªG²	TRUE
Æ±Suc9ÔÑPgö¯CaEPqª¿2©Ý¸	TRUE
4ÕðH¸ÝéOTHéEôØ¬ùÒÑ	TRUE
YÈà	TRUE
âøKÅ«¾ØÍºËÊÊ¿©Â1öIy	TRUE
¡näó×gÖkóZ4	TRUE
Ãhj	TRUE
Áàmr«yÃÂÔUEdõÌßÚåÒ°U¢bM·ð	TRUE
Ù²YéæCQÐWÙèç	TRUE
ÖCa«íöq­	TRUE
ÞGÙWÂÉtéÅ¨Õò	TRUE
XDP¾£àwÕôGlÁôyËËëzøÊæ¥	TRUE
í12Cìù·d·æÊ³ÂïÎ½B	TRUE
1kKÑËUZÆì®o×7	TRUE
Äq±®ÊBC÷óIÁék²w	TRUE
áàjâGz¥Äßpçz·¤Ìh§×Aí¿eÐ	TRUE
uªØQBÔJ»øÍÙT4¼ìJô¿©iG	TRUE
ê×ÒÀÁ«²ùDÉàO	TRUE
Z»ÈAÑá¬EI×ÕèAçµ»Ï¬S¥1½Y	TRUE
Ñ©âYÌê¡ìbóò÷6×¯ÍÉFCiÉØ	TRUE
h¿ÉÞ¨ÑÁpgà¡	TRUE
Evsø£¸ÈÊpwÉA1rJ¨YÝ	TRUE
OXö£jäøiDî¤ïskMÕACNpOÃÐ	TRUE
ìÃÈ«¹mÐ×§®S®LàÉ	TRUE
k¨©p6îe·½	TRUE
E«ØÆ·fG¨Â×ôÒß3EyÓYR	TRUE
Âtr®¹S¬	TRUE
ÝPÓtË	TRUE
zXÂ¥¾®ÆmrÖÓzWà	TRUE
rIõjÁ¼eK¼ZÖPwÔø³	TRUE
Y¼CóÉ²ë¯x	TRUE
5ÑíI½¼ÓÔµgàêx7sÄqq¦	TRUE
´æ¹é	TRUE
öVèvTÚ¥¸BVIAªJtçÕ´Ëg¢ÄÈÌH	TRUE
zÙÖ	TRUE
ïÇùÃ	TRUE
Ô¬lò¾L5Ý1¹1§ÙK	TRUE
2­t	TRUE
ôdðõqV6	TRUE
Ò8ñÝNw2á¦zs4àl8¢Cö9åY	TRUE
×w1LOöÂeÜ´Þ¸	TRUE
9UsBb8B2n¹T¼·¿Vnïî6	TRUE
ÕÅ´»zAòlÜêÛy·¢rfÇóNâER±bS	TRUE
M÷¼ZiJá·Cñ³ÓolrÍÓ	TRUE
lñôiøVÃæÝËm	TRUE
eßmoøw¸¬Á6Åî8LOX9cð16	TRUE
mB¿Û	TRUE
£yÔâ÷¨§«pà­B°7÷	TRUE
áà±âÛ	TRUE
HÌ¶ÑåØtÒT¨ÁgJcê	TRUE
Ëèx¹röChtbÎÈM©íµºÎÂ»K¯ï	TRUE
uåBp7OFãrÅXu	TRUE
ñtDá´wØðOð7w	TRUE
C1yu¡f4ðßa5Ýõq±Aî½¼Àg¼pÕ	TRUE
¤5À¿N£o½ÃØñ¸ÒxàYs¦	TRUE
÷CÚÑyFÈ	TRUE
yÂfÄ£ês	TRUE
Ç¬4PÉàzß¼v¶¶3ªDÅõ7¥n	TRUE
ãh8ÑÃ¾uÀC©BCõôÍsTWÀ	TRUE
4íê	TRUE
TøïS	TRUE
¸éÌu³Ûº­ÕL9¡±Ö	TRUE
å5î¤³òÕr¥îÜêÒáÔg8b	TRUE
ÝÄõdõÙ	TRUE
ÂmNñ¨6¾KÕR´Cµñt¼ÂrÄp	TRUE
²	TRUE
64WGø÷¨äA²ïä¹ÝaÊQtä¾¯¹¶	TRUE
¬ÖßspWG	TRUE
ZFÕgw¶÷à4EçK8	TRUE
GgLBFMY­ÂéCI	TRUE
ÕZ³ËÚRæ¹8ó1Ø	TRUE
sXÆhøsÅëÃÎUGe¢1ø	TRUE
Ë¤íÌ§Vðh³kc	TRUE
8êå¢¤¿Ýb5×·Ù´N8	TRUE
¼E	TRUE
×ÈòÔzZî	TRUE
tùë©EÌrÃÕ×«XL¤òö¡¯8ø	TRUE
PæõöUÀÞ	TRUE
PÉ¸IEmmsMLÛ8	TRUE
¤Qâ°k±Dhk¼Y¨y7	TRUE
©bv¥»À«ô¾Å¥H©lv»	TRUE
¶ípf86âOY°ó	TRUE
±4vní¥ó«¸ÖÚ­ÍÐ	TRUE
GNrÍ®×Bð¾Y3©©MBÇlKj6	TRUE
oïbÔÂÚZegj	TRUE
OTU´Ögçe	TRUE
Ä7²Â¶Oß¿ùÁÕÜãÎ©ÒÓYY	TRUE
H¾¤gãpc9äIÊí²ÐÊUÀêØåÂ5Â3	TRUE
éöf¥1MOv¯ÜG9µ5×Ý¬Úè»	TRUE
ïUvÔåÊF»­	TRUE
htNÌVøkICì	TRUE
h»¬1ÊAmM	TRUE
æcC2¶Y	TRUE
ÔªØ¯Vf1¬Ñ¡Ä×ùéÞÜëE2«	TRUE
¦¾º§	TRUE
ÔÀI¹£ÙßR»oOïOðÉ¦Þ»	TRUE
ÃÞº	TRUE
9®gëgÂ¨l«Ë¤	TRUE
GéÜªÊGJ¿ù¥ñhã£Q	TRUE
ÇÙ¤ÇÊ	TRUE
b»M¥¸Ç	TRUE
Õpô1	TRUE
æ±Y°V­UôíÏ×o¼Ó¯Â½ïBâq	TRUE
5	TRUE
ø¹ë5LâÃ¿ë	TRUE
çÈCt¤KÕ÷íAÒÄVöjwÃä	TRUE
ó2ó¨¶ÏohÅKÂËãåòZëß¿9Éà¹ÂÙ	TRUE
Røâ­QE·C4vÒ¶ò	TRUE
ÃçC«µìäÙZJT2áL´ÜÖ£	TRUE
NùÇÏæ1ÕÖ¬áÃ§qìW´LlÏ	TRUE
×ôÛ8ÆÛ	TRUE
åÌ	TRUE
ì¸ï7pìÒØ	TRUE
íÐ¡Üî¡g5kQn¯ø¨õÉ·©§óU	TRUE
ãÚÓµæOÄ²ÑY©®S¯êHV	TRUE
v¾¿øé9¯¤X446óßÖÑ®çagÂÁõ÷b	TRUE
f×F¬µÍrs¾JaÅ§¿vqËDk4Ãæ2Â	TRUE
zq¹¹É¦	TRUE
§cZ¸	TRUE
®E©ÙK1FjF6¾òäáïÆª4EÍE5N©	TRUE
Æ	TRUE
¶½ñw½¬vcçpÅÝbîfèg¯Åð¹¡	TRUE
·gôXê£8Ü6êjîñÚÓºëÄ­BA¾°3R	TRUE
¯³ßëÔXäÞÝTËlæËoÈZPNµ¤¡B	TRUE
¤ÐðkkÃ´ù½mºDâó8¶A	TRUE
òJ®ì	TRUE
ßS¥ÜÝMyä	TRUE
­ÙË¥èY°Hò¨Ö×6À	TRUE
LÊ®UËùt9óÉÕøÌÛ4î¼«¶ÁÎ	TRUE
ìj	TRUE
øÑÃë§ø®Üc¨Èç	TRUE
ÌLßÓS±²P«ìvíLpø¯ê	TRUE
¢gxÅhË±1é7ÖôW³YyiË	TRUE
co¢lK²asdàYßBôte¦·Ûë	TRUE
ªÅEIÍDÕ¹±Ähó¶4Ù¦×Ï	TRUE
ÑrKWKÓÌî²	TRUE
¯öo«ªt¢ËòÐÂØÀè²Lh	TRUE
¶e­äÂm¾ãSÔ¶o­	TRUE
Êæ¹ÕUyVÆÂC³MMxeó×èÅ¥	TRUE
Äm1­êÝ4³ß7ñ¸ï	TRUE
jN®À®	TRUE
¢	TRUE
¯÷ùÐr£9òèÅXëõÂäÃÌëËÛ±Þkô¶	TRUE
DÚ6®kg÷ëLij÷1	TRUE
KðBÍHÇÑÓhí¬×z	TRUE
¦swÌ­¯åEæUîB¾ÆãøÕ¬¤	TRUE
BÔÐëD	TRUE
f¤ÞÌqòó½ÏÉU¿v²ñØ9ìKË9ßp	TRUE
kªZÉ°íæÜª7DL©C	TRUE
1×Ì1ùKÍ	TRUE
Ç¿óq¡	TRUE
2s	TRUE
j¥lftWÙÍyÔ2Èf«¥§L©he¬	TRUE
Êi£ê»´ùW	TRUE
SCDezö7kp´ÔóÄ«­	TRUE
e¸eô	TRUE
Ïïp¥¼æÚÅÃzWmóqvÎ»	TRUE
6åR	TRUE
ç®«ôlÅtÈù×¿ÖÅä	TRUE
Å	TRUE
ÌYjôpñÇbµXÎÊ	TRUE
PÉ»ÀwçImÈ5¨	TRUE
µDÆQM©á÷Rw©öpá4ÐlñÂªÙOõsÏ	TRUE
ùÊ	TRUE
¸ÀÒcã«ßFmÌ	TRUE
ccGlÃæF¤XñiJ3T¥B	TRUE
ÐSí9cDÍHÕÇg¶qÏâ¥´¼èõ	TRUE
£­ÌºðíÌáÍo»acliÓ¡ñê6d	TRUE
ÔaRÍn¦ÄvGq¼U¯ÔõsñäBø©·	TRUE
õ	TRUE
¢p¸IkÑ	TRUE
WÐÅÂ3	TRUE
ôªè÷çÐSÙUÄ	TRUE
ií2Uù¨á	TRUE
CNQMÔ¾¦÷¸g	TRUE
Eæ	TRUE
Ö×qñ³QÈgP	TRUE
i´¨EQèÂ5togz²ÑtrnÔÇHË	TRUE
ÊÌñàu	TRUE
VUÝgÔAe	TRUE
Y½æ6ÔAc7esxµoI¦ò¡I	TRUE
òO¤	TRUE
«î²ãÚLhªk«løNWwµFeÇ	TRUE
¿»Ù	TRUE
Dî¨õ¦zdDW«áÔÁï8uèa·®ð2	TRUE
ÛB­ÀiJq×lÛs¸Ù	TRUE
±mA	TRUE
JÛãNíF®ùvFC®¯dâ°I	TRUE
zl·´QÃÅÆkdÏõøsÙ	TRUE
Ê»qiì§yÄP	TRUE
3íAWFI½ë×ã	TRUE
¶ïèOf¢f§áGGLOÛEÃiyf	TRUE
°Sò7¦ñìZLÈk®øXÛ	TRUE
·ùÒóHëy	TRUE
QôSögb½ëÕcDBXJOSæSõÍÛI	TRUE
Gj¯Ër¦®Eêv²e	TRUE
×ÕaTLöà´ÍMÞUy	TRUE
Tdñõ¨±tñU·V¸¾nÖÞnÍíbßß	TRUE
îí«ÀàÜe	TRUE
P¿	TRUE
ºÍ»TJ¼rwPjÜö	TRUE
5LCÁ¡ÚÀ	TRUE
¤KÛ´ïÃB	TRUE
GáÕÂUåÐHÇèÌs²	TRUE
Ì®Ò¹8¦¶êO×yÖ¬yK¿ùôsÍzÞ	TRUE
fYðh¤¥¿×ÉoÛÛëT1KôÜ	TRUE
¼lEí	TRUE
ðlD	TRUE
xÎ³dpµNfhäÐÌQe»P	TRUE
Ìs°AzÁÂv²÷´²ôõÆdÄq­Cæxs	TRUE
âÛèGe¬Ò°¿vT3Ã	TRUE
UJ¾îÙÝÙìâ­ÝÑç	TRUE
OFDZkÇ×Ç¢3¹ÆÌPAÕEwäÄ«å5PÎ	TRUE
EKFòÕG	TRUE
¹¯¸÷9ÔMÞµ­bY½ÕÁ	TRUE
5ÀÀkµ¬§R	TRUE
ïTõeÒ	TRUE
ÉT28AÕ²ßÕ·DYQÆÃxøÈt8	TRUE
qAêîøµ³á	TRUE
òÖA14ªfé¸	TRUE
z2ÍéÐÀ5s84ä¤¡¢eyïÆÅK	TRUE
iÏ	TRUE
qaãx¨µnáùGÌ¹	TRUE
s¼J	TRUE
îÔ¯°ZP®4ÇËèËEõÄyìXpõ¨	TRUE
òN5×éË¡NhWÝÙ²r¥§ó¿ø5óã	TRUE
¼o¦×¶6ß¤¦½ºËÍ§ÐgCI	TRUE
õ«Kh5Ý§í	TRUE
ÀßÜÃØLñ¸	TRUE
QöôåòNÎx£REÃ¯µºÈõ®	TRUE
f	TRUE
±ÖÔeö±ßrª	TRUE
Cä7l´àPÝåÇ¬rî4qò	TRUE
r²IZFµÚAH­eÍK²ø»UÌJås÷Õeø	TRUE
d¿±Ûs©¨QR2EÍ§´vqÅÃ	TRUE
á4¨ñ°	TRUE
ÏÃá	TRUE
ôø3°XF	TRUE
Ár4åSÜð	TRUE
Jª¶¹îÒnWÕÎÍÝ³ë®	TRUE
U8g´	TRUE
¡é¡÷1Ç«ÄUøì4Äy	TRUE
ÈEãR§ÁFëEiAÅO¡W6«5¶÷Q	TRUE
È±dlYD	TRUE
UHßLzÈeæHÏ¢àGÌÕðFÓít	TRUE
Ø	TRUE
ÏpÜãbu®fØÃ¼	TRUE
G§­IeÏtôÕ¡BÙ­8yÕAáÝ	TRUE
1ºBk9m÷6¾µ1eÝÆµhKËÒ	TRUE
³Ë	TRUE
t8­÷G±¡t¿ö®W¿D§­æ	TRUE
¼¸SY°óóoÈ¬	TRUE
òÎfñàÇá³õPäòU§ÁµÍMÕÀyldYz	TRUE
IjÜS¼ÃóâJ7b5w	TRUE
¯W©³SÖèÎÆ8à´WÁ¸9ÀK«»à	TRUE
cÜYá¦íoC«¼qnòÍìViªÛuT4ö¶	TRUE
àÁX±¶¾CÎRcYÉzÙR	TRUE
zcÙ	TRUE
L942ÆjÐ¿Ì®âíÑá	TRUE
íîÙè	TRUE
O·áeë¹¥ö·¯gÂÔd9«	TRUE
ìBòñÁTëSã7ÕÈcæïE¯O¨E°Á	TRUE
dÛzì	TRUE
alHoîðëùIªªRCMReæD³sÚQ·×Ò	TRUE
Grª	TRUE
íõ»áõØ39±	TRUE
¾Û3orÙGß³	TRUE
kóçxXè8ÞSÜ¾qcXi¯CXlHÙYfå	TRUE
æuXñø³Õò´óÍé9	TRUE
¢Ùn	TRUE
à»UíßÙXDCº¶	TRUE
ø½KÔ´1§TtMOxgà­ÍÌ	TRUE
ùm×ï¥wÛÞÉd÷ùsGNè¯qàw6ª¾	TRUE
¹V	TRUE
ÂÒjtÝ	TRUE
¥	TRUE
Xä¬¸½ÅqT5ê¬Q©WµéÛÁÊ7äw	TRUE
jÎéñê¢7b¢¥jìnWÓÖ5ä¯¿æCõâ	TRUE
õ	TRUE
séøg7å	TRUE
µU9áõÔÒvØPèS¿¬£ão7	TRUE
O¾ÝY¥íðK¹¨ÌP¼kWe	TRUE
ªËð©¬¼­2½cÌêW¢°ársÆéiÆ¿Jó	TRUE
e³lJ	TRUE
p9ÙßVíöÒGG8ÇôÙ½×	TRUE
S	TRUE
¥Ñ46	TRUE
ºÂt¨cÂÂÜ	TRUE
¥¢Æùh¹MßI¾ÚHã§àDL	TRUE
a	TRUE
XX¿NvµèlP²I¾Ho×Êéê3îQ3ð2y	TRUE
ssuÅÇg7§KBjâP¤RðçqboÝß	TRUE
­ÆÑÞEùHè	TRUE
ÏR½2Î­AÝò	TRUE
ãÌ«Bì7ºóÏ®aO4U¥	TRUE
«òäàíÝIs¿	TRUE
íÛvïÛµÎq£RÕh÷Þö¸Ó	TRUE
QF¹¡	TRUE
²x7nÀö½ßJ³t8gk÷ÌyÒÁæNU®	TRUE
ä	TRUE
ÔÔîsà¼2Dv	TRUE
RÈù°±	TRUE
ñG°Y9ßï¬V±	TRUE
íÉiÖ	TRUE
äÇËzÃ«iàZ¤	TRUE
ÙRHÒáSÊKô­yÁ×ßÛª¶è»	TRUE
ÔµoYwibHdéËAS¶Ó1°lñØ	TRUE
÷·¾x¢Ç¥·³ôdw±r	TRUE
ó±	TRUE
EÙîRwºÊÉoà	TRUE
M÷RJ­ù³ôµADcâëïqç	TRUE
ÑÄÒXËh	TRUE
¦´©ç§u©VÇðÌµÛSf¦Ì®®oäå	TRUE
XAÙR¡¥NÙx³ÃÇïO¬EÖØS23¤¤	TRUE
õbÎÇ·Ü8ÂÄõ¥L	TRUE
Ð¥¢¬¸À	TRUE
DxØ¤îæ´É»UßLAÜÎ¸Ï29¾ô£ÀÖ	TRUE
uZ¨·¬qÍu7±KEBôæÑ²	TRUE
oLâJ¹í¦¤	TRUE
MÓ×©Xõyr§°4UW¼k	TRUE
UáãSÀeáºe¹	TRUE
eíZUO±AKëåO±Â¦Ý	TRUE
dôº2È	TRUE
f¶ö£öõàÍJFjFÏ3ù	TRUE
îÍVéÙËîÍwÇ×ð´Gdà	TRUE
«çCdfainRgÞÉCLdÎ9w8	TRUE
aoÞ¯ß®J´ë	TRUE
dWCãv¢ñ8k¯3	TRUE
lcËI8ÑÝcÐõf	TRUE
vvÁÎeyí	TRUE
P­¿Þáö	TRUE
î÷njO²ÜhipxÝ£ØLKqÏyiGÐQo	TRUE
ø¢aaÞJQÂÍb»éJÚzÏÞIÃL	TRUE
2ðX8YeÜön¦æã®	TRUE
±qqêLÐx¸	TRUE
¤±²÷¥Wìpâ	TRUE
JMÍ³õÛvY¦7óªßx	TRUE
ÈF2ëRîÐõbK½Ãí¡±tyÛmiáÙo	TRUE
J£õXÚGÂ2sGvjÞº	TRUE
ÎBO	TRUE
äu³ÚÒÊy²´×SÏD3×èÄ¨	TRUE
ÜÀjÀ¦èoaê	TRUE
ÇE¿¨¨ÅR	TRUE
H7´ÆÉ23ZÓuuÊeTÛspgkÆ¬ácI	TRUE
ó±HyÍmy	TRUE
ññ	TRUE
56¬qÁãº¿ÔK	TRUE
¸XeñÝx¯d6AS­H·´Åöi¦­Ï	TRUE
²O¯Òºa§áld´ùUÛQ×ÇZRNW	TRUE
JrÛÅÚYB¡	TRUE
¾Ë£pÝÌÓUðVÃÌË	TRUE
à÷	TRUE
èÑ½6fKðg«AIfí	TRUE
hZïZí»¦Zåc4VQ±¹QÂn×÷¨Ì	TRUE
·qã¥ã6ìîÈ	TRUE
Ç	TRUE
TÈ	TRUE
áÚêcÀó°²Är	TRUE
FH	TRUE
8ÃEXfÅòç¬IpmÀxËa	TRUE
h½øg°ÝacÛöÉHRpy¢À	TRUE
µsÕ8ìðbäàöd«·k¬±aÑÅÀÜv£L	TRUE
¯×Að¥ßÔçß½ÓõÛtNQë·z	TRUE
×CYT½ròiCîÛrIöô¿ðª¶Çzòå	TRUE
§ÛGB	TRUE
e¼÷áMgºND¯ZíÓâiß¶ç÷éjâõÅ	TRUE
Ø	TRUE
è­ËnÅÜ	TRUE
Çv¾­D	TRUE
gåFdï¥³x£¨4Í¬éëMo	TRUE
£¿êµ9ÍHÛ	TRUE
£VGnë½èïw²Yt¥KÈjÝrÃÈj	TRUE
ÚWr½Ã4ÉÈà§EvÆ¦¬99Û8t¦	TRUE
ÎÆ¦÷2eÂ¾µ	TRUE
ex÷ÊÑÇâÇbÍëÍÑçB»9WjYªÍ	TRUE
Î¼QcéÎrCOEbÑ²ãÛZÔ6ëÈâ°tsg	TRUE
¼âÁìÔÔ¤­ÇÅbjQõs	TRUE
ç	TRUE
òÉÐî«ñ·ñOt÷	TRUE
ÊFMêÉ5g	TRUE
¼Ä	TRUE
TÎÈE6åyê	TRUE
X±ºfÒ»K64îÞÝV¨	TRUE
±¬ÄTV9	TRUE
¸ÇµÕJ9QÄËÒpTH¤Ïe	TRUE
Ï²ÔtH¼	TRUE
25J	TRUE
ð5Ôªip´YaÞÌºÙJä§Ãå1ïUÃbV	TRUE
¬²æIu½×NOeoØÐíGaÉÇ÷§Åº×	TRUE
6¾hãQÎåhwâÞsÞlYw´Ay¯	TRUE
£c²dµ§8e1ÇÙ¬AóK§	TRUE
ëÍ39XùzËq«	TRUE
9°ö§m	TRUE
ÍC4YÕ2¹Rª´DU°¯·ñæÔ±WÐEÈ9	TRUE
Ó5kºaMtzM£kcâ½	TRUE
¤÷âéÏGÉMTpn£ÈZ¿ðsEA¾lº£¢	TRUE
b2Ôô°oäÜeI®	TRUE
°4öÃ×¥èBHSËÐBÀAãjÊUÆê	TRUE
ì8£òÁgÐ2K´	TRUE
àÀ¾¿¾æ	TRUE
eõRê±qöÆ3H¨EÄÐßRzÉdß¨	TRUE
àUÈÀIÛïpæQèNÓ2czÍ¹	TRUE
ùävÄõò»³	TRUE
hÝÂt·ÙÉK±n»¨R½ÆÔÒp¯K«ì	TRUE
ñÛôWwËãÆÛHUA¹Dáà¡ÊbGb2	TRUE
¯ø½½Ò¨9ÕoqíWòõõKð²³ÒUé±ëÂ	TRUE
ÁÏPEÒ	TRUE
ÆÃ½Ýâð¡v	TRUE
Ú¶níd	TRUE
±Þb6ªf¹7EoLhXÒÑq¨REèDG	TRUE
÷ïn¢sËö¼¸·	TRUE
G1®ãm	TRUE
3ßQ7½5ª¥Ès2ºOïmÞPvRà	TRUE
r°QBQ¿anÅ75×CX	TRUE
b¸SêväCqïy¨çYBÃ¡	TRUE
W	TRUE
2ÅeÃe1JXÛs3Þß9oìÄð64å	TRUE
ÛUÒfõªÒ1dù	TRUE
uù¼îwAy»·äÏõ	TRUE
Ð²	TRUE
N	TRUE
©±YtèöÆH¦Í¨¯	TRUE
fGfKÂcZÎîìzjGôÜì¤ëâr­ó	TRUE
êëP´nmLónØßô·ëw°Å×ËâäâçÒQ	TRUE
åZÞÄ	TRUE
æÂðSç´Ò¼cÉÕaÕìÉël	TRUE
pá¹ß¶ØÙ£x­Ðªxö¦M	TRUE
çz«ÚaòÉïL®ÇîSÈ»£ÞhKQwÚ±±	TRUE
Ûo¶¶³	TRUE
msÆ·îÄºVy®	TRUE
O¾në¨Þ	TRUE
VLµÌGd×EÂÖOAÔ×¼jBÒxøjJàÎÎ	TRUE
£è¿¥tkÉ6¢	TRUE
ÓdMïÒ£¯¢áS1°Éá5	TRUE
ÔÈÌÚZe7pë¿µÓjzQYE§	TRUE
¥ÀpÄévÂéuÔS	TRUE
ðwè±pLÕÜæg­óôÏ7ÂRj1ÕzN¡	TRUE
Úé©1ïâ4ÀZä­ÔÁ¬5Û¾9yo	TRUE
fXÞ¸8æjjeåV×áø¯	TRUE
órë³8Ë¾ÏäMòÀH¯MÕôXáRËo7ô	TRUE
ºb¥Ù7L98ù¯	TRUE
XIÉ	TRUE
é9öÚ×ê±±8£ÍæÂÂÞIË½¼	TRUE
¨X£qcmjiÊ¯Á¼Ní	TRUE
»i¿pRÞräÈPy6ÉkªÎºì	TRUE
CL9VøLÕø½¨ÑFW5XckêÛS°¸R	TRUE
jiÓ§ÀeÑ¹ÕÁDçÏ©¾ÆYt´ÓR	TRUE
ðá§íÕµ³Û7Qà	TRUE
TèÂä5TuqÍª»ÞÙ5	TRUE
Z½È4Iìl´¾DZ·mDPWÁÜ½ÜÇ1F	TRUE
up¹4Aº³lÅjÍR»q	TRUE
õçcîÌe©£9ìèzMÀOt	TRUE
¥ñkæä6÷IbA­×ïä¢ZèuÃ£Lb	TRUE
³9u4rÖ½ÛÕVÓ°¡å¶Ü	TRUE
m9ÚÙáêhÈ÷TCÙW5g1à±tò	TRUE
F¼ÑÃgI	TRUE
ù±	TRUE
Ëª99	TRUE
±µæOÅãoEÜ½ÊÌcìÓgEÈI	TRUE
Ù¨àÃ¼	TRUE
¸pk2L9Ëb­ÔM	TRUE
qÃô¤¸¢¼²î3GnÄK	TRUE
°vä	TRUE
Æà	TRUE
êÌÑ¹i×YìoV°ÂUP§±Ú	TRUE
ÛÀv¢WÝNÀpmíYDª¹H¢	TRUE
VBcÁ¯¡÷Åõ«è£gÙã¶xZ×ÒaÆÛ	TRUE
Ü	TRUE
å·¬î¹kr9WAèsø¥Ê8QÁåÎðçéÂÅ	TRUE
VpézE¶4Ìê®j°	TRUE
÷¿Onw©bD©Tº¬Aç¿¿	TRUE
ÓcÒ³LOyõfÚ	TRUE
ó¨¶8£íMBÏÙÞcDjWgf²2ÉaXâv	TRUE
Ñabcvâbyº4ÖaÊazÔG¼bba8	FALSE
¾a±bp·b9aHabba	FALSE
abb¦ñÇadæ®ÂÀåabbÀaR	FALSE
abbaabba	FALSE
¦absbôCeaAabbaÕ	FALSE
XïaÛbebôaGjOCAÛa¿ëbdba	FALSE
av¥brï½s»ÑQb«ÝaabÇ½ZbaZó	FALSE
åabb¬aacíÂbÈÕYbæ9Úaç	FALSE
¬aAbbaabÉbóaS·¾EM	FALSE
abbaabWøba	FALSE
a÷b9baabba	FALSE
mabôbaîRôa×Ïbba	FALSE
abÔÐ9baP×¨©abæòÉbÚ¹Å­aãùÌ	FALSE
ÓîlKMab¯ba¼aXãbÞ¯äp¨Auba	FALSE
ab´âbµaöajbEba	FALSE
abpbaåaYÛ§bbaæ	FALSE
abBbaoÅaÎhuìbÆßbâYzÎaqé	FALSE
aµ2bbRaabÂbJìµdaîa	FALSE
abbïYtbaabpÚîERbgaõ	FALSE
abbaabVÞb¯a¹¾	FALSE
a£bØbÝaabCdba	FALSE
abb¸SaaFbba	FALSE
abrBb±a¬¦kiRB·àabba	FALSE
ÌÖaÄóÉbåç­bÉÙaáaÆºÖbb1a	FALSE
kabÏÔebaabba	FALSE
aÜbbaÖabnEAlbÉs¾a¬	FALSE
abbÅðaabba	FALSE
abbaabba	FALSE
abbaaGÐ9N»Ø´G£·bbjYa¼4	FALSE
¹JÖ1LaÓTZbbaðabbóaø	FALSE
Î±abdb­a1abÂba9	FALSE
R£QAëabNSVbåaIÍab÷bz÷óaÈS	FALSE
µabbÆÜÇ¨Å´Ìaab2b¤ïgta	FALSE
a¨8bbaabba	FALSE
hZa¦bPªba«ab·bGÚavf	FALSE
OabÒªmòbHaÝa4Vbwyb¼äazµ	FALSE
abôbSGaÓádPabba	FALSE
òabbKDåxaD¨abÎxðbaj	FALSE
abÝb×ÆSßÏa±aAbìjb2ÒaÚ	FALSE
iâax©æÞbîÙbm¯faÑ¨qabbµa	FALSE
öÓabb£8EïaÇaÌØ½Y6Ób¬½baÞ	FALSE
a¶bKbaayÞÄèêbÙSÀbmóøâa	FALSE
abbaabba	FALSE
a9pùÆ¾bÑy¦3øbkjaÃaªbbHaÁ	FALSE
abbaabba	FALSE
akZb14½bavTaU°ôbbÙbórõa	FALSE
abíbaab¹ba	FALSE
YaÅábbuÑea4áarªÂb½ba³	FALSE
ÏaÝõ¨QXb¬b¨Ça4abbapÁ	FALSE
abbaabbIa	FALSE
abbaabba	FALSE
ÀaÙÂbbaðabìÞ¿O4FMbBêîÛa	FALSE
gañTbbÊIaabba	FALSE
a¯»I6bbEðÌaabbsa£ÜÝ	FALSE
aÚªÏbbaabËba	FALSE
VaïøÉ¡bÎbaaöyìwbÎb³Gå°a	FALSE
abbaaâbba	FALSE
ab6ÆbaXXKoab22baãÄ	FALSE
abdåb3a3xÂab2b¯a	FALSE
ab¶bÂ¬Ô½ÚaoaÏbba	FALSE
aWrbâba8ab×ºbHa	FALSE
IDa¹bba·abba	FALSE
Ý«ÄÝab3bSJaaøbbt³¼¾aÅFÝQ2	FALSE
abb¸aøa3ÕKhbÈbIa4mu²ðs	FALSE
ÄabÃbaab»Äba­	FALSE
w»abbgöaaLbbcas	FALSE
aa7óbÂbaaÁð¬åõbba	FALSE
÷£aäbbZëÓ§e×aabbFÚ1a	FALSE
pabutb1ÑaabbìaOV	FALSE
Dù6ðlIabbÃa´abbMafÑ3¦§ö	FALSE
U¾abbraagàíÓ±øbbÎõa	FALSE
aCb¶g¹bìaµDRøèhBabIbR3aÍ	FALSE
a·êébb¨aàabba	FALSE
iHaÔbbaabbÂah	FALSE
§aÇbxªOb¸aòâaa÷bba	FALSE
abÃÜbaôÐ4«aÖbäbSÏa	FALSE
LÏæabbaØòabhba	FALSE
©aGbbaÓabbbõºHa	FALSE
W5abYb¢ijaxaXÔbbeß°Þa	FALSE
abb2aañsadvbb³¹aÔ	FALSE
àªËabzBwbaaÐÂCBwQbb¡a561	FALSE
ab8baabba	FALSE
abS£bDaaSbbaßìÖùÊ£ÍA	FALSE
E9SabbÑa´óÎVnabbõ½ta5e¯	FALSE
Ça8b¸2ÏbaaØbzbaÌÚß	FALSE
abbGaxcôabXªaba	FALSE
½°²albºbabpØqaabbÈYÖºa	FALSE
®aÅbbma¹abbµtoa÷	FALSE
abbaabba1	FALSE
abgHµbÃaabÊtbap	FALSE
a6Ð«­bwÕ£bgaab¹b7®´a	FALSE
abbaµabbëa	FALSE
zhabCbaîGå«oabÏb×a	FALSE
abAb½5aaä³bbae	FALSE
cõiab½¡baÉ3aKKLbba	FALSE
Ü÷abbAaæYaëEbbt¬aàYÆ	FALSE
abNZ·baaíbbå±aHëBç¾ØBÃ	FALSE
Ñabbaabba	FALSE
abb8aÐãabßq2bUa	FALSE
aObb¥añaibbma	FALSE
abbPaanÈbèbÁaç	FALSE
abrÂ4baabba	FALSE
aîJbbwaa½­²b­baé«´àÞ	FALSE
aæbbaSa8tbÅGIbEzå¬naWEêy	FALSE
÷ka3bbXÞaa¥7ÏPÓbba	FALSE
abPbÆïïx¥aabba¾y	FALSE
abbâÚaNabbea69	FALSE
a´bbÃaÝ·hab÷bS6nÎa	FALSE
»aYÌêbâGPb¿aîuab´Àb¿ÔÀÎa§	FALSE
9aíbba°¸kUab½àbiRqù×a	FALSE
8§aSbbaøRab9¸bahA61E	FALSE
abbaaobba	FALSE
óìPaÕfbbSaabba	FALSE
abWïLëØÍbÔa2abba	FALSE
abÇÚTbaa±bba	FALSE
ÆabN¥baab¡õbaN	FALSE
abbaabba	FALSE
¹aKÈb6ºbé¶aao¾bObað¤ÔB	FALSE
iabXbaaIbbfa	FALSE
ab­1baaâøbbõa	FALSE
abcbØQ¢aabÃñtõblÓ¼a	FALSE
abAbaabbRa	FALSE
aßbbÐÙ¯òòaabb¨a5V	FALSE
ÏaºÚb¬ïÑ¤ùªb¾aa°âbäWbax¡X	FALSE
abÇîl³ØbQaa¡Ib¤bîÊja	FALSE
gaoÚbbgaabGbxibÇa	FALSE
·açbgÓVbj¤qasá²aÝZUbòba½P	FALSE
abºbµaaôÈbZ­H©Ëô·Pb©a	FALSE
abËbaabba	FALSE
abªÓb¦aabbEa	FALSE
aW÷t¬bzbaaxbçbÔan÷RÈ	FALSE
agbbJaabæba	FALSE
gÀa¹bbËpaaºblcOba	FALSE
ÍaBbd¹¯bamkéæabba	FALSE
PabbÙaÏaÌbba	FALSE
ÚaÍEÎhbb½a·a÷¨ÐbÈbòiºa	FALSE
aÍ´bðbÁasB²Ü£ì«abb6aI¸	FALSE
abrba4abb6ù4aNpÊ3d	FALSE
ÈyabbkéÇaaÑæ¬v9¯1bxbaT	FALSE
abb¬aabba	FALSE
Ö9KØP¾abI§bùohaabbaD¾	FALSE
abbaaÇâEWbba	FALSE
K°aÁ¾b²ù»bráÉqHaaÅbìÉb¡aÚ	FALSE
ïabb×laab±baÑ	FALSE
aæbÁbxa9á6tùaÈÆbgba	FALSE
ayobËÍb¶aa°JÕÐµYbªNb9aà	FALSE
abu¬bÂDÄ«ËäaD½¶aeËbba§Ò	FALSE
abbÏaabba	FALSE
abbaabba	FALSE
a±ÁIbÇÖubéWaab½bëjÍÖ²aõ	FALSE
¡abb²aabbéa	FALSE
aVzoÕbbaCabçCÎ6¿bac	FALSE
abbaabba	FALSE
ab8ØÝbºsa±abbqàDaÒùÀ²	FALSE
ßÊabÞbaaHöêÂÂfbÒ¥Âîbpa	FALSE
³abbóaabbaÄ	FALSE
aboPbkan87abóÜËæb¶lËaîo3	FALSE
«abbaabbaH	FALSE
RaäbbaÂaBÃcbñê©àba	FALSE
HabÒba9éËabba	FALSE
abbÈófaa½qbbaÞXÊ	FALSE
a¨b¬íiFJbaaÝb4baI	FALSE
aYjb4ÈÏbBaaZÌËub®bÏa	FALSE
XVZasóXÍbbÅ²aa4bba	FALSE
abbaabba	FALSE
aÚbßebaÔCaÆb°9ébaÆ	FALSE
abbÇaÙabb´a	FALSE
aÊbbaaÊv¸×bÈbbLÔ¶uaJ9àå­	FALSE
ab¾ba¯abba	FALSE
ÎÁabæÍ¬bhô¢aòañbba	FALSE
ÈadqbbYàa½bÊóaöÒb²LõòbiaG	FALSE
abSbaabba	FALSE
öaQbbP÷ÉÄVaÏabbLa	FALSE
ajb¾bPa3abb®a	FALSE
abbR·l6Wåaabba	FALSE
Èaböbaabba¼	FALSE
aÕ2b­¾Kâbaa¢ÓbObtaVôíä	FALSE
a¤§yÌbbra8abÉbaa	FALSE
abãbaa«bbaÁï°	FALSE
Zabbaaùbba	FALSE
abbaabßb´a	FALSE
aVb¡Õu£ÁbaÈPa3ÐUTÝbbíçta	FALSE
rabbMa²ÔabbaN	FALSE
labb¼aUR13ÁaFÌ´ØbQS²¼baÌ¡	FALSE
ãVMabYbôaxpca§v¦b9bOEÄZfa	FALSE
abÂbaa×m°pÌbbaàç½øôBá	FALSE
aabbaabböaJÜ	FALSE
ÞSabbGChaôrabób»au	FALSE
ÙabD4bÕºHÙÃA°aÅa®bØba	FALSE
abíbaabba	FALSE
abbéÚaabba	FALSE
ëÂabbaeabba	FALSE
ax¾bÇ¬ObÓbÕaadvbba	FALSE
OabbºWa­abbëgm5vî²aµ	FALSE
·Ýap£iVbbaabOZbå«a	FALSE
aÇIbF×baaobbaô	FALSE
aA1bbaµaºbObkaòc¹	FALSE
ÕabhÆbaVabbfÜat	FALSE
Õaffbb¬a7abÃboaáå·G·	FALSE
PAabb5ìØ­aabêbInéav	FALSE
aHbbOaabba	FALSE
Qa4bbaabbaÃV¾	FALSE
¸8õaPbbKa¹ãabäbaàèÃ	FALSE
AabbaabbYêh®aîu	FALSE
a¿blÍ¬ctVb¬aaã°bRbða	FALSE
Ldïabbaa¡Q½Øbb½a¢	FALSE
abYL³bñ¤Paa´¼ïbbava	FALSE
waðb¾baråÖcaEäbbZ¸æÖ«Ya¢	FALSE
abWß¹baaND¿bbáêa	FALSE
abyÊàbaxñÞzkae¿nÌbbíÈhÆga	FALSE
a¾QØbbaê÷pabáb¯7CaÆ	FALSE
abbaabba	FALSE
aCÙJ9mbbGnlNaabábalV	FALSE
a¦´b»bÛ·Yaåa1jbaba»	FALSE
abÝbyaÒabbaæ	FALSE
abbiaabba®	FALSE
½Í«Úaább·CaEa¹b¶ÌbaT9¸	FALSE
3amâ1ëÑbbaabbîÍÌ82aK5Þª·	FALSE
ÚBabbaatb¼böÑÖa	FALSE
aÖ¡bbai4ab¾zWÏÃv÷bf¨fa½	FALSE
iawbbaabWba	FALSE
abbaa5bba	FALSE
ÇØñaÅbbß1ë°DaùÈabbèæËã§ëa	FALSE
abbaabvba	FALSE
haÑbðFvbaóabfôõbòìa¼íÏ	FALSE
aÙbÐAbat·ïCÝab³±bU²c¬§Æa	FALSE
aãbbËBaHab3ba	FALSE
aKbbµaÆÓ¬arzbbaR	FALSE
ab¡baaMbÁbRÝa	FALSE
abbagabbÝað	FALSE
Ò7abbÄfð4aæÐabzbÒ´a	FALSE
abbaabba	FALSE
abòÅbaaIbbC7a	FALSE
aîbbauabbaí	FALSE
abbaabba	FALSE
abbaabba	FALSE
abbaabzba	FALSE
ÁaZFbb¬´aabµZba	FALSE
abbpaabba	FALSE
SÖabbaabba	FALSE
apbbaabba	FALSE
RaìbbÁaõ®âdøóaábCbeaå	FALSE
aÏGjÕbè³b÷¥ÁIaG¸aebëba	FALSE
÷wWêDMFabº§b÷aabba	FALSE
©abÑÔùbaaEbébO²ca	FALSE
jaèbgbaa¶÷bbWda	FALSE
ab©JXbF½éaVabÔbaRùm®	FALSE
aÍbÂUNÕ1baÁaiobóÈbaâ	FALSE
abgEòfRba¡3oiaÞbÈbaìõ	FALSE
aÜºsbbòaab¬Ù¡bðaù	FALSE
kañïbbæa±ha7NbxIØ£ÖMqßÚba	FALSE
aLb×bäaIa¥õbbaÛ	FALSE
²¯aÃïbbaabibaí	FALSE
aÑ¤bbq1a7ua7bbÉa	FALSE
abbaabba¦	FALSE
q7abbaabb¯añ	FALSE
abbaabba	FALSE
WabåbaabÛba	FALSE
abba½tabÎba	FALSE
ha¶8bba¬zîÜaÙm¯böJb±a	FALSE
ñIDab9àcb¹a»ºaôbrábam	FALSE
aubãba°agÉnJbÌb¶°óJPaLtó	FALSE
fqÂab£ØòbùaAàf¬§aCbÀbÕa	FALSE
abZbvaaÒbbê®a	FALSE
abXcöôbaaAbv¤Ñj³Ùba	FALSE
a¶¹ßBbbaaGz¿¿btÑbôa	FALSE
t¿a·bÇbÕ²ô2aañZbbaL¤Î	FALSE
a³bñhbÀ¦aaK¢båb³ÀuaK	FALSE
a®bbeaaFbbaj	FALSE
£abbaá®a°°bbQ¦×a	FALSE
a×íbbaïaëbçøba	FALSE
aSCbbBaa³¼bábaJ1	FALSE
abbaabñ­«sba	FALSE
abbaabÃïb´b®ayC	FALSE
5aºÉ´bbñøAa73ab7ba5N	FALSE
abbaabba	FALSE
abbaabba	FALSE
abbÛLaabÞæba	FALSE
a®tb6b§ÓbaÇSa¼bºw¾¡gbÚÁba	FALSE
eabbaa¥bèba	FALSE
ab×baabba	FALSE
¨abbalõÞÑa¢bÄbda	FALSE
¾1abbaa¶WbbÁÁ´aÁö	FALSE
ùOTPa®QbNbÎaLï4aôbbaq	FALSE
í§e8abpZÜ7±bªcaaombbSa¬ÅÝ	FALSE
X¦abÕb9aNÍa9bâba	FALSE
¸çabbaÀab©bÈCÎja	FALSE
aTbYbayòRabba	FALSE
¨íarb°bÍalaÎb£båZvóaSÌ	FALSE
Ã²ïab¶BÅblaôa´bbèÒiaÕ	FALSE
aíÀbb¾îÀaañR÷bbaD	FALSE
aGãØbbaabbaÄ½	FALSE
aè²­bbkaaVb÷beÝya÷QÜÁÛÖ	FALSE
abbqòaabba	FALSE
abbaabð×bâa	FALSE
abØÈëbaa8¡±hË6Nbzb3a¥õq7	FALSE
Ýab¿b¹¤aôabàbO¦a	FALSE
aíÆEbbo³ta§wøaîbæbVka	FALSE
abbaabO5ba	FALSE
abäÙºbaìaÖbb³ja	FALSE
aWAmbba¶taÃbÚbUùa	FALSE
öab±xebÎDyaQabÉba	FALSE
uaPbéáJbaaÁÌºïÄbUb¦awK	FALSE
abbaöabba	FALSE
GaÙHbbanabba	FALSE
pabÝbaabbaq	FALSE
îabÃblaa¡ðbâb¨a¢	FALSE
áç«abñJ4¦î»baìa±bbâa	FALSE
aîbëñbaaUâêqwabÁbÀ44a	FALSE
§faPbbaLa¶bba­	FALSE
Uª­WáafbbÛtba3a¤ÏLbIbøa	FALSE
abbØêaabbma	FALSE
¯aæbãbaabbaa	FALSE
abØbaaPé×bEbïa	FALSE
ÂËab¯°ba¨a½Kbëba2C	FALSE
abbaabba	FALSE
Taè¾bbo¾ìcÂaaAK­ÑbPkjbaØÄ	FALSE
a¿ëbbôa¢aj2CãøXbbba¾26	FALSE
CRaÄbbaFHaïÉ4bbKa	FALSE
a°hbbïaabÁba	FALSE
abbaabba	FALSE
»²H§aÉÉ©b1ba®Üablbaç2ÖSbØ	FALSE
îa¦bbaabO©öb¡a	FALSE
aN3Ôbñbaa6bbåaq	FALSE
èaDb¿bçaaSbbAa	FALSE
abbÙñaÝaBob¼baÔ¬â	FALSE
X¾auØÉºbkíÖbòØãaòabÛÅbR­a	FALSE
aÞßbbaaHbZba	FALSE
aÇbJubGî«aFäabbªaD1fJ	FALSE
abbaa¶¬b¼bCa	FALSE
abbaabÌba	FALSE
aobÖbaabbÕa	FALSE
abbaabba	FALSE
nabbaagbb¤masÔ	FALSE
ÄÉa¬8ºbbºaãa§§LÝbbÏpaçîíð	FALSE
²mua­µZbhòÔbaÃtab¯£ªbawJ	FALSE
ËUù7èab»bFÆàaáaboOba8¥®á½	FALSE
aqMvÔÕbbèÛëÂÝeZaabb®M­Ka	FALSE
a¬bbaabbØ¬a	FALSE
absbaaªbñba	FALSE
abã¾b¬aÓabbA»at	FALSE
åarbbaS÷abba	FALSE
abt×baabba	FALSE
f½ÍÜÌ©æ«â¿abËÐbÞaa´ábÎba	FALSE
Þ¶Ùsa½bAbÎZaÖAabDqïba«	FALSE
Tabbâaa¸Jbo¤÷ÞôÔo±Xb¨i»a	FALSE
a5bbaa·bba	FALSE
a6ÝÜqbÃbanÌ¬211abé¤©bað	FALSE
TaÌØLbbaÕabba¢	FALSE
ZÅÀçì¼aÂbÆLbaa¯bébMf5aë	FALSE
nÆa¿bbaÃÈalcbbaK	FALSE
õrabba²µ¶Ð¸dÙÊ·Ñ§QabbÞa¯	FALSE
Æ¤aµbUP4b¢aabblÊa	FALSE
a¾8¤óbXbÐÎaäabÑbaÜÞ	FALSE
¢¶»aF¸ÌgFÄbb2ùaaËbbùaÆB	FALSE
fFafbbaa¹b±§ba	FALSE
aµaíÈbb£¸G£¾zaóÎabKbñaö	FALSE
a¶ÄbbMâaarëX­bba	FALSE
a´bbaabMba	FALSE
abbaabba	FALSE
