wM	TRUE
jznc	TRUE
wEbvUarHNVmPGS	TRUE
PnuzZoQzTwAF	TRUE
nbFgWluD2ZOUOGj4j1AWLsd	TRUE
XQVW2OOiKft4JWcCa	TRUE
aQIqSJuzimpQaaemtRVcKZ	TRUE
ftWoLOywL2y2AKqe	TRUE
ldsP3NL	TRUE
PT2XTpDFnOW	TRUE
x1CEwTjWifO1HIIk2TH	TRUE
wHcnzkSJA	TRUE
twvyRhwtvMXmH	TRUE
tRhlctdELUR	TRUE
QaSTkJBMLqOw2	TRUE
h1LCgK	TRUE
ywe4hd3	TRUE
GacOSPaTXqbmtfujSWnzXdf	TRUE
roDkPRey	TRUE
r	TRUE
y1qV3VnfRQVhFJU	TRUE
vkFoMjBJnnTELiUdTMdV	TRUE
jscOKrpw3DTDK1Frw	TRUE
siAChkbJGMJt1WvFYAWQU	TRUE
QLPJkYpnHfVOheIxKV	TRUE
S4HXDrnnqybpQmDt	TRUE
XpdrEGq1URyXYE2FLiZYgcTO	TRUE
BRCQeOqx	TRUE
zMz	TRUE
O1rzCHuAqThyGKOwd3fKpjmwe	TRUE
PnzMbLCTbHRVLRF1cYopp	TRUE
f	TRUE
mWAuPnWPsMS2ohfnvtXdMT	TRUE
a	TRUE
g2l4O2cnTrChYiYEbBSnBFjPa	TRUE
4PHde3r1iiDm	TRUE
g2qYFrOEPCWgibNFjFzBHMdj	TRUE
diTNXgKEDZ	TRUE
Dtmji	TRUE
qRxm4	TRUE
zb3Etec	TRUE
uqhX	TRUE
Kfd	TRUE
fdGUF3Hdj	TRUE
ssJHpJHfIZXXJLHZrZZ1ULZRv	TRUE
cmiVOLUkhY1ASZqkzsv	TRUE
ORdYlMcDmoKav	TRUE
DZex1gcr1k	TRUE
tYloplpCZVhYssJBwVdj1	TRUE
YrHOMgkO1u	TRUE
oeUtdQNkFFNZjWoRqbYTpmir	TRUE
JiYSZbqP	TRUE
wqU	TRUE
jTbM	TRUE
dgfqs	TRUE
Eyzv	TRUE
YAsm1SAHokxxKgVr1e4	TRUE
ncpjlIjg	TRUE
tEJnptcB	TRUE
qrU	TRUE
daMeE4nmSBWHJCGArDSRct	TRUE
oRZKFAjDIsEUAjE3a	TRUE
rUFsogF	TRUE
wQaTcEsphGAk1	TRUE
eYG	TRUE
2axhNvUVtXAAlmlhqgWtaeO	TRUE
f2YaJMUAWQHlTVsQPbe	TRUE
FJwKetIyUdAmLZ3tsB1g4PLt	TRUE
CRuFdxFb	TRUE
ikyMxBx	TRUE
pnRzPJg2pwpCucDGDXwm	TRUE
EcISwzS2MvnGDATijPrwJ	TRUE
DBJgb	TRUE
EbeuT2EWb31IqBuB33sO	TRUE
TGjvVKdrBlWEOHmpo4uoiDn	TRUE
k4XYwRsFRHMRUm	TRUE
g3P2	TRUE
eWIntQP4tgOzyqXFPP3ntky	TRUE
3QuaguJsnPdlCfozOWLbRrgk	TRUE
QYeTkdKAvgi3kswXPN	TRUE
QSoYdvAqfTM	TRUE
EpPsoLVVzsFqRlnqDGykzOyId	TRUE
TSNpGyyQmhEzSsOqToYz	TRUE
ohmSm4LrpBkHcUCgUfuiMtqem	TRUE
hYgjzs4US2iYRv	TRUE
YGfuFhKPS3NNkoRRclT	TRUE
Kw2G	TRUE
qRaGwGSghOt	TRUE
mddzOjQOgwtkqMbkVXmLGDEPD	TRUE
XZcrEDcayJ2jlgOo	TRUE
2onUQsuJqednORBL4W	TRUE
Os	TRUE
Zlv1BuCpah	TRUE
wURaxQnKCi44sJsPrTRHgimB	TRUE
z	TRUE
Rm3eWTZ	TRUE
G4hzLVSYmUMREBscKOpP	TRUE
Mokue	TRUE
QsGNaoD	TRUE
uC	TRUE
Yk	TRUE
HPAPKnYCZedIcQYGoS21	TRUE
kcIuSlZpmsHGQpKrSOREtS	TRUE
4KKstvR	TRUE
SQc3	TRUE
YSdvxpNRDZXhDCqfJPSuMv	TRUE
x	TRUE
dNFTzJUul2TO4dJcW1u	TRUE
uU	TRUE
HoSo4YTuCGR	TRUE
n	TRUE
If	TRUE
o2	TRUE
lH21z3	TRUE
IAHbHeVeolC2I	TRUE
mqslhSfMk	TRUE
AQ1A	TRUE
fTpaKwjcS1h1YMBO	TRUE
dnl3QyxX	TRUE
XAvJVaOCeVKTwiuNdjuK3	TRUE
amOBXttz4SFvNj	TRUE
MkbBnAJWbeH	TRUE
GDgpyjLEWhdig	TRUE
QFBurFCz24pstOH	TRUE
wDYL	TRUE
W1pyfwO	TRUE
XOnoVxbQCtuyPRLnb	TRUE
xCkI	TRUE
gMWCDGd1SZE	TRUE
t4kGSo1BRn1WyGaDb	TRUE
cFEhv3sGEkOUWNPbA4	TRUE
JgHxBDS1JfuDdOgQhDHFho	TRUE
zxC	TRUE
hhkajQzungGUR4ugIwrVYg	TRUE
oqpmtnjkz	TRUE
vth	TRUE
KhPefNYli4ds3AxZtAn	TRUE
2PkWiU	TRUE
jpevyJO2K3AqYZAu4IAmnf	TRUE
H	TRUE
NyHyP	TRUE
MbdPTXN	TRUE
wfzHwhMCgozK1VqJ	TRUE
rZxPlPVQM2	TRUE
mnEV3oLnd	TRUE
mmyDIiWbdh2rUoLyfwc	TRUE
Lak	TRUE
FqgXLWotWzs2On3RKhixBW1	TRUE
VXIUKh2EMzcXfdTI	TRUE
HqNmptrQ34dpMH	TRUE
i	TRUE
dx1dnL24pfQS3iduz2Zp	TRUE
gXTXpNp3kCNEyL	TRUE
GufpYp4GWozMzvOSsxpab	TRUE
QDHffSVYaHZa	TRUE
vFLNir	TRUE
TxgT4ZTiCX4lEli	TRUE
Wx3I4GTMOBifV1YK	TRUE
ypzoE1eUXPs	TRUE
OibmfjhDRaYl	TRUE
mnpdtbrzkreR	TRUE
JRL	TRUE
tdNvdnfYSDJlgauaPTSAogj	TRUE
q	TRUE
T4DwxTcpmVpAOs	TRUE
Gn2ZJcBxAVHwNu1rCY3mvea	TRUE
P3LaZdtadlwRWlpTydhov1ow	TRUE
ZfeegUSkYlmM	TRUE
AvsLORvq	TRUE
TqUKkgU4qUETaNTADc1EH3x	TRUE
DKuNpgQqtjvCqNjpCDNHJNfD	TRUE
ltbgSSUDgjesDRrTBA	TRUE
413NFwqeCiNEjE	TRUE
mXKZDFDy3NU	TRUE
YIgPlgMZlVdpx	TRUE
wDZPSYiqDZHFNuBCPq	TRUE
vbrHhsNOks	TRUE
TlnaBD44JzAMqAquE	TRUE
ooXIAEWqf	TRUE
EEXnjnIgkMIZskKChEFPKTS	TRUE
WTmou2mHDlrVKcj	TRUE
ssrQJ	TRUE
eTEaxUiuHdVHgN	TRUE
b2	TRUE
opPgzDwWXbSQ	TRUE
p	TRUE
xvGQIJjSxnkvteqYY	TRUE
Yg	TRUE
uKXVNL1eHiABLw4	TRUE
CHIevPsoVhwrk	TRUE
sjaDaw4QV43PhdF	TRUE
WCNvFPqo2H4QvJwf1b	TRUE
kiLKAkRjS3K24AQ3	TRUE
TM3tVYPIfuNLgBzChFG	TRUE
kO	TRUE
pGAyJ	TRUE
rgVNVGgzfh1GyjLGWrcJ	TRUE
L4vExJQ1H4HLJWtg	TRUE
zhiHhhQOUqOwvBDEHNOxmMx2U	TRUE
2ENA2Erh	TRUE
TzaZjlvqkl2GjQ2AkBTwxGpe	TRUE
NCi	TRUE
FHhWOq	TRUE
Swyxft	TRUE
JSesxIMIwxukgPmJuDuTD	TRUE
ESfMBkfSZBL	TRUE
4mxUDavjVkJmoiiEsbDEmr4l2	TRUE
risRi2npHSdvzhuwPMo	TRUE
NL1YcL	TRUE
41OaYbZZFhjOOpVk	TRUE
z2BMoPQygOAcP	TRUE
z4	TRUE
EHnZPfe1tDBg	TRUE
3nCWXtHmachVzKg	TRUE
gIYAXySy	TRUE
k	TRUE
rEt4wRQIGBc	TRUE
VxLZl2J3oPNQtgYbIiQ	TRUE
UXToTiK	TRUE
N3dUlNaduojtvtJCmuq	TRUE
cJEszUYwM1USGOPBn	TRUE
yChdYta2ZSsr	TRUE
qQP2lWPSXA	TRUE
FijDinC3YrWqiqlbmWv2css4f	TRUE
VrHY	TRUE
tyb3WbtA4QGamilBkbnXfqew	TRUE
ZeXk2YLTneK2	TRUE
2c2f2aE2nF2pmBWGFrPaNoFSv	TRUE
bjkXhOvhPxvFw	TRUE
fFF434MUlMbSusHo	TRUE
hzT	TRUE
iFY2fAa	TRUE
QWPO	TRUE
ibwwbdk3gVQHXZRgw1wQnTFL	TRUE
3EFoYfEbamr	TRUE
PDHZy	TRUE
MLe	TRUE
ScQYBYQWf	TRUE
nXbSm	TRUE
kRHptTRly	TRUE
ivaJ4gJeq	TRUE
vHBT	TRUE
jq3Lwa2zaXSKURIe	TRUE
XWxfZNotwzNyNeW	TRUE
Hzovb	TRUE
JNAup1jn2tCtzbl	TRUE
3qtWSuTMlA1qUMwoiCM	TRUE
2ZAPMdVbyFQiMiBvvZ	TRUE
C3NFhO3bEuno2FASJegVU	TRUE
RXvYt	TRUE
pfrwYN	TRUE
2NleI	TRUE
2fbrQaAzBDoHmeyPsn	TRUE
SjmB	TRUE
AtCW3nQQtkQC33odMpLi	TRUE
21sxubvZA	TRUE
GwWh	TRUE
2NspTR	TRUE
GEOfJjUFUiwPv3vEz	TRUE
uveyOavVZK	TRUE
pWtgnHOuOoxwnoY2n	TRUE
Qo3owNHd	TRUE
qFtImsKtWb	TRUE
NmOtwyg2dgN	TRUE
b3v3HMeXWbRrIaKCvSgRi	TRUE
cwXIkM	TRUE
Hv	TRUE
ydY1kaODHT1X11zPOBUJ	TRUE
fkAAJK	TRUE
HK1pJ4fBBT	TRUE
xiEfl3Oqz	TRUE
EawyjISmgBL	TRUE
dAuMRJkfXLdcRzRNJAOn	TRUE
FKUZm	TRUE
Ye	TRUE
adU4VboPFcyXAvR4YrFfvLr	TRUE
JNTDlO4	TRUE
qhbt4JKVnwEPD	TRUE
RoWtV3hvzydtmSaumU	TRUE
huKReOqnvVvBnoO	TRUE
wIfRp1Gcar1NVPT3Z	TRUE
qGQ2SC	TRUE
EEmF3uR	TRUE
pG	TRUE
UaicgmQVesveZ3nkh	TRUE
AOOwWOlKjp1Bvi3kpcFqq	TRUE
LNCRbWIznWhupoTKNUSkN	TRUE
BTCprKy	TRUE
xkzClYIYRpzS	TRUE
PpqaO1OkrJFpQjVkZCFfSAu	TRUE
CUeLbzexmoAMnvVvc	TRUE
dauTYiOSLZVHLyvJ	TRUE
GjGVvdEhV	TRUE
Rgbykvzj	TRUE
DvSLzpouCVREFV	TRUE
AqBnhTQ2tcFESU	TRUE
ojUAewsyJFIhKLx	TRUE
CTQGgnYVC4kSdvppnCdPH	TRUE
ebiVgJ2JvqHacVnUbzbW1wAh	TRUE
cwM3NVblYuydByUsMWqvNzYym	TRUE
gLWuXlNJh3mbKCWdV4e	TRUE
r1wAAp1hSTXQGlCychz	TRUE
L3VcShzkSJevK4	TRUE
eKixpaIRnHDA4ZsyMzsZcg	TRUE
hhKwhIb2	TRUE
AgGaXaegaJ1JJY	TRUE
HymH4crGlVywWnNkrBAO4bOdR	TRUE
sWHkYOjCCfApCGf	TRUE
xdgPCYDGWuHgEkNaGwVbBT	TRUE
PRkeB	TRUE
TrgrcoTtQaCFalesIr3R	TRUE
Q1kRQjx4eRphkAHHLNnljryp	TRUE
pR3nk	TRUE
JC3KsU1BuMzwDaW	TRUE
UlbYckjOi3hzOQ3cTgvjgKEh	TRUE
3vayKbHE34hYVc	TRUE
jFjliXH4ENRIbr	TRUE
yfuhMTbtuK3FbR	TRUE
Pfg3Jo	TRUE
GjtOWfs3fDUZXV	TRUE
oVTJinaYsm	TRUE
RHsvDbWP1FqozXcg	TRUE
q4LdYw2DF	TRUE
tvsO3OQk3U1CDMArZxuPz	TRUE
crunZQwMgDMxQLpIZ21xUCVZ	TRUE
qTqvBk	TRUE
etzGNyR1apcwKGnYTMRc1nofn	TRUE
1AeridjcgBXi	TRUE
YH1tFDI	TRUE
dJ4ZTsNtUeCgSpeLhFAEjx	TRUE
X2lMAZTgDvPrRu1rNBz	TRUE
gVmPqZshKnTnRDjPA	TRUE
b	TRUE
bFojo4LbDslCdYg1GBqir	TRUE
ADWD	TRUE
TNnwnsQBErAW1heu2IAZjPy	TRUE
MpL4lUHMBAmXyzkD	TRUE
CqulH	TRUE
RnFkhuVNPvrCJyrDXhOiBbmkd	TRUE
C	TRUE
ZxWGrWyYLcTgz1VRPU	TRUE
vGaNBr3	TRUE
d	TRUE
PWbX4KuBOcW	TRUE
NaCSpwxSwDG1tBhmX	TRUE
snWtU	TRUE
yzZ4mXRPHTVR	TRUE
1zOGU1MtVirp2plzXX	TRUE
Ot1cLtMPh	TRUE
lkEzZhNByPkuzIutnqxk	TRUE
RdKNaeKUtncZiB4OZzPSuGC	TRUE
33x	TRUE
wYHdjktoRN	TRUE
E4coTeOturwHD	TRUE
SWhZwduoKbIzgyijn1MbO	TRUE
IHxu4qcdUFLygK	TRUE
FgZJXcpgQTEfA	TRUE
33ubdah	TRUE
xTknPoVImEsdWCqo4yxvbYn	TRUE
v2nDOwSp4ilPkPim	TRUE
RaLciMOR	TRUE
IG4FVOpO	TRUE
yTRkRqzHcHKZxxJexGZe1p	TRUE
McQcysVNYcVxBIavprSV	TRUE
QKxl	TRUE
MARLqUnpNYw	TRUE
AxzMSUIicLHsVlEJEHLM	TRUE
A3YmFGdVWpPKB2AzYGiQAHzg	TRUE
hqnFSfdAQrbVbnmPVo	TRUE
G33CXeQ	TRUE
rACZQmbFYtOMupwz	TRUE
4vCrRMKvNftLtAG1p	TRUE
2srfrg	TRUE
cyFx3dhVb	TRUE
RP44jxmfPNVaYiXIlGmLvfJxa	TRUE
rb	TRUE
a2	TRUE
rQp	TRUE
tuPcgdYbunZgwOBMRtiglxIe	TRUE
TdQnxJh2NQzqTxGGKHbvNHcu	TRUE
AbcEzzKLF	TRUE
bzytuNeqeKkoaIsOFbJBlxw	TRUE
sWYCM3XqxtjJBp	TRUE
vTbCmZPgxmRwbybtdshS	TRUE
bXaJFVmziYlihmkCyGZLNC	TRUE
LJgcgIDZKzUMS1lny	TRUE
KZWi2enXFEDXpinrV	TRUE
dztx1MDexn	TRUE
WmgHUX4FV	TRUE
WaX	TRUE
gCLABHlwanZQLPMNYT	TRUE
QnCXTNmszvU2LgmieldjNmqV	TRUE
VDgO4jhlq4	TRUE
pQ2VxIojUCbiyBqeQXKQJc	TRUE
am2BGMmzo2D	TRUE
YIvNRnLmtCkJfzAj	TRUE
Bx4aeQai4bcG	TRUE
PLbkf3PEapS223ThvK2qNQB	TRUE
atjSin	TRUE
XoCKuLzllmGYKLzKMfNMHbqK	TRUE
QfFbvN	TRUE
wSGo1mjpz	TRUE
aaEBhd4ONSUHCcaIGBNDw2U	TRUE
YnfyRQeSY4OG33dFKaRNOW	TRUE
agYOUQa3jh3szmKXsJjq	TRUE
V31gtOT1fAaxWKS	TRUE
MfrORwgjKRAU21bCMp	TRUE
kelzJZlNpfUhXPoQ2S	TRUE
SUnz1PnEfgpiBvcnBJxBTH	TRUE
sPcrTDH3DtDqPKDLZXQRP	TRUE
Zdk	TRUE
wrfhcvVk	TRUE
3fyruTmvtF	TRUE
3Y	TRUE
KYaT	TRUE
uKNpTsqaIffRb	TRUE
QIMVVfPKkUesv	TRUE
xd	TRUE
sOjy2BjuW4vRguqyxOnPO	TRUE
FVW	TRUE
kuueimcJaFKRgzxCR	TRUE
1xyHPirwb2tUaWpyqsQ	TRUE
BzGLPbdIoeY	TRUE
Czhe2ehkdVNY	TRUE
zZr	TRUE
HbIWZuABbkqjrLUt	TRUE
xBmjWc3Vht	TRUE
rY1vEzkyMKzO1LDpALSAmi1lu	TRUE
SI2nRsOh1tv4Zlx3pkgxImaLj	TRUE
OnlzDZvTb32W	TRUE
yNAq4	TRUE
4YKTgTRcOMxIF	TRUE
MbL2MoE	TRUE
I	TRUE
SaGMwtZLEVf	TRUE
AfooVJQuHSkQx	TRUE
lsWULvwlqwQCMCoZDMUMTrdq3	TRUE
hsDdXQdzRSDwwxJgsj	TRUE
JOTetdeBdmXrGRI4xFpOmpYmm	TRUE
h2Q23PgN	TRUE
LkFIhWCTUvpDmby	TRUE
tQQMaywom4OjAEKdoGODc	TRUE
2lZrSkQEsnzxKwUPnvClFPw	TRUE
HlsgCtZbMRlbWBzOkvTGhG	TRUE
gINMFMzByQ	TRUE
OGAjxYpk1	TRUE
l2SVoX	TRUE
wntU	TRUE
s	TRUE
JfOOcpspeeXvHriamK4x	TRUE
MZemFgldDb12jnMAOP	TRUE
rfC3FE	TRUE
q34A3IndGasxGkWyCFG	TRUE
jwuPMYXI	TRUE
naprEJgwuO1Xk	TRUE
cattmFCK3PyG2	TRUE
rPhnnkITi4BpAyxDp1jSwrO	TRUE
SNlIoFnbYBSd	TRUE
lAVQECu1RSeZhxPrpmnk	TRUE
DT4lwZ4lcJsejMHOUNaoYd	TRUE
GBsYyHVGU4LF1vwFbSZ4yq	TRUE
1drZpvZjzjrlMf	TRUE
uTBdthJOyyrubay	TRUE
SPnuKUcgek	TRUE
tDywm	TRUE
YPKsLKkpGhxQvGi	TRUE
a4PdUOYILQFvHnD	TRUE
fwBu2imBXcEeevVbswJkC	TRUE
JWjYvW1aQ1b	TRUE
zz4HtLzSejWUi	TRUE
n	TRUE
E	TRUE
ntlqEhLFVAcS	TRUE
CfrfdwKB1POJGzqJmaB3BTBCY	TRUE
3K	TRUE
bwAxMoOfDNpz2hS	TRUE
fapHoDAnrx3sQaQzo	TRUE
3CVQGgXMNFLsqlPrXf	TRUE
gGQuzeJDeWF4ggoB	TRUE
RrFtQjOvdLPW	TRUE
kebegmhLKsLyZLEKIbNFwl	TRUE
QFnXseMnbJ	TRUE
F	TRUE
HWS2Gf2lUfMyMgESvvh	TRUE
adizPfuZfdUEvSwkxVkGS	TRUE
yLDEFaGKcfLHJ1w	TRUE
DB1vmt	TRUE
uM4	TRUE
qs	TRUE
wgCTY3xRfp	TRUE
FnR	TRUE
iMoi	TRUE
HRLtdvU32fSl	TRUE
WZvU2rMImAANzNermCJa	TRUE
QpTuhzRiZhZgLOc1pl4	TRUE
evObiTpIxzYsiqQDRZ	TRUE
MifWncMA	TRUE
E	TRUE
NGEH3iIW	TRUE
IWIHsRSMr	TRUE
1trKHMaaaaQReXYNR	FALSE
YBikZaaaabFj3mNehkEnhpS	FALSE
ebbbbdbmRjxNTVqzrQO	FALSE
bbbEmlPbj1x3IhhH	FALSE
RUJKotGrj1vZLQUaaaabVD4pW	FALSE
SUbbbbG	FALSE
bIDBV2qnz2W3piIMQI2hnaaa	FALSE
bbb	FALSE
bbbbb	FALSE
bbbbXKs1	FALSE
bbbb	FALSE
bbbC	FALSE
aaa	FALSE
q2KBylaaGfwsnHGuQ3uaaa	FALSE
bbbpmfwucTci4AFEFwTsASWcE	FALSE
LiKR3Ew1yLcBRuq4bbbb	FALSE
DHbbbb	FALSE
bbbbd	FALSE
bbbfVPNsZzcsuZ2	FALSE
noTnMs3iFbbbbRGB	FALSE
bbbZAuboSLgijjCXd3tqc	FALSE
bbbbWKxZ	FALSE
2OZ2bbbbo	FALSE
aaaa	FALSE
zXVM3aaaav	FALSE
bbbbVc3	FALSE
NxJ34aaa	FALSE
RMbbbbdu4RbDVVOouGD	FALSE
bbbsOejcLMBBLsyAOpHNpFQ	FALSE
aaaa3JPhAOuPBpohZWUV	FALSE
wfzSSd4nXCSnt3Taaa	FALSE
JrUXVaRWdaaa	FALSE
rYaaaaIcBt	FALSE
aaaan	FALSE
qaaaagHY3tazSOnPOQtF	FALSE
YaaaaGSI	FALSE
bbbsfhmaKJWUoAvWH	FALSE
PJkomgjHYVa4oQGaaa	FALSE
LD4UYFaaaak	FALSE
bbbb	FALSE
VasRWcRWQAQSwhzLqPFjIaaa	FALSE
bbbbTZCOKi	FALSE
aaa	FALSE
bbbcGP	FALSE
XraaaaUXAsuAeOtFGv2TomO	FALSE
THVFfTTUbbbb	FALSE
oSqUXyQlz3sEnzIaaa	FALSE
C4aaaa	FALSE
faRG4sD1naaaag	FALSE
hCxHDVUK1VNXbbbb	FALSE
MayxFktGDwT21Co4aDaaa	FALSE
QeJXNemmOaaaad	FALSE
Wlaaaa	FALSE
aaaa	FALSE
aaaaFnVAW2cJT	FALSE
RTE34stoklaaaaMTo	FALSE
iiBwhaaa	FALSE
xbbbbuUsg	FALSE
bbbb	FALSE
bbbt4gwjscTvoUFkoHqB	FALSE
pgbbbbUde	FALSE
Jcrb3GbbbbfrmafSvYv	FALSE
Obbbb2xrXx	FALSE
OjUOgtKHbbbbyLwdJjuVv	FALSE
bbb1LR2dHJIoK4XrmgwoIww	FALSE
bbbV3NT4RHUBZptswKxCL	FALSE
aaa	FALSE
vOIaaaaJD	FALSE
4ASmaaaaLoiqTB	FALSE
gSHQYr1aaaaWN	FALSE
YraBrITAFGGcVT4Taaa	FALSE
bbbHZjRJfgsdNQdL4pDwUPt3	FALSE
bbbB	FALSE
bbbaqyIfrNjTrsUykLEa	FALSE
aZnkDCIbbbbl	FALSE
bbbHNZTGpsiLUzFgH	FALSE
bbb	FALSE
2aaaadhDeFWOUHdDHE	FALSE
YvJIsdSbbbbNiNoPzSOmh	FALSE
XvwIptZaaaaOsyYAJnT	FALSE
bbbbtZU2	FALSE
IjDBhmraaa	FALSE
bycz1QYYMJ2kp1bbbboQc1n	FALSE
Piaaaa	FALSE
bbb	FALSE
Faaaa	FALSE
YMSaaaaFWxe	FALSE
bbbb	FALSE
bbbUlIc3vAi3A3gFUkdba	FALSE
myaaa	FALSE
tLBPaaa	FALSE
2WHaaa	FALSE
bbbuCtdl2nWF	FALSE
bbbG3hhTQDMkOjgSjEGXT	FALSE
AriOVjXmpsWbfaaaaHzOSj	FALSE
GcRWqAcvoOmPSlaaa	FALSE
TWbbbbPuWSDuzsiPg2CpaICeQ	FALSE
iFftlStnjgBAaaa	FALSE
bbbAaJlkqCeQWCUIjaxJnY	FALSE
bP2P3bGQOS1iRuIsXaaa	FALSE
QVaaaaxVztlIADwPa	FALSE
fnjaaaa	FALSE
u2yOmbbbbZngdEGwnndq	FALSE
4CaVkbbbbNWwF	FALSE
rbbbbmdLbegTHiYUkRO	FALSE
ynUaUnCS2Haaa	FALSE
mcsbbbbUFwOXjhU1rgXtSxmgX	FALSE
O4Saaaat	FALSE
PfuqF3Ruzaaaaeh	FALSE
aaa	FALSE
aaaanT	FALSE
OIknMHMIsyadfaaa	FALSE
aaaaIllBYnvw1m	FALSE
MZHr2oCKQnlfjbaaaaqlGYCVJ	FALSE
bbbpfGW3ETc	FALSE
qHigMAaaaae	FALSE
pxxHKbbbbUrGVPspRMbHRx	FALSE
bbbLAQG2gfi3ORwu	FALSE
bbb	FALSE
bbbJjlw2u1DQCB	FALSE
bbbVvRpUOXqg	FALSE
YWbbbbJkcvoGbvRf1OqRmmXGf	FALSE
OeMcbaaaa2kAgCnpvrU1Ecgr	FALSE
VNgnWaaa	FALSE
bbbU1FNJEsYBGHDX	FALSE
XM4VDRkGUPGq22jRnweMToaaa	FALSE
bbbdsB3vn2WAvQFctN31PONtm	FALSE
JKVlJKjdBhbbbbWTqneAUuP	FALSE
p1bbbbKm	FALSE
RkaaaagoEULp	FALSE
JPxfkXlaaaaMGuydTJ	FALSE
dm1KxaaaaPDXrQt	FALSE
FFsKvcl2Mjaaa	FALSE
aaaaP	FALSE
bbbNDe4jtQupjXREij4TIL1	FALSE
4rXpbbbbAT	FALSE
aaaaGZLhHjGdU4Fw	FALSE
bbbeF	FALSE
bbbn	FALSE
Ebbbb	FALSE
cAaaaaebve2k	FALSE
AaaaanwuZ4txDZZPDM	FALSE
kvbbbbpdXjlTYk	FALSE
bbbb	FALSE
aaa	FALSE
aaaa	FALSE
bTMIVFaqaaa	FALSE
vsNe2mgU3jTbabaaa	FALSE
gzbbbbffge	FALSE
CzqKmzPeU1paaa	FALSE
GGx2bbbb	FALSE
DQwPaaa	FALSE
aaaa	FALSE
bbbBvIbRgzO1iYLUMRsik	FALSE
aaaa3UANGdyQJvk	FALSE
pFJhhCLmDDTI3TrYRybbbb3	FALSE
jS2cmCDpxNVeSZKaaa	FALSE
bbbozeTsxeuobq3	FALSE
ajBKaKboaaaa	FALSE
A2FdhKqgupMMaU3jJAdWbbbb	FALSE
HMmQVGrKvwGLPKSUpeaaa	FALSE
bbbsqXFjbQR	FALSE
sdbbbb2KzuegIlFP	FALSE
HEaNPdMvPkbgy2Lvaaa	FALSE
jbTpDTS1yKaaa	FALSE
xfbMbbbblIjR1nYdempaVXBMK	FALSE
2dv3bbbbaRZE3ZkbQh	FALSE
XP1aaaaTYyoHnjMY3N3W	FALSE
bbbUtTbDNcmUFp	FALSE
bUR3AuMwiMaGgCaaaa	FALSE
nFpiaNhYbbbbkLpA21Uwf	FALSE
obbbb	FALSE
riAnRKkfaaaaOT	FALSE
Reeh12CXbbbb	FALSE
v3wbbbbrDXj3xEOVgprfW	FALSE
Ybbbbw	FALSE
cxSLObbbbA	FALSE
kwfraaa	FALSE
CHaaaav3vOPSX	FALSE
bbbv	FALSE
pKHbbbbIWZee2RcuwWGe	FALSE
bbbBVGgWZuffYmYMatJU	FALSE
ysRLOXWQbbbb2goNhLNKuNJyK	FALSE
bbbBemiWBbBOz3bcZwbtVmJ2	FALSE
mrc2yuOn3Xbbbb4Cqeq	FALSE
TqTaaaaNxytiv1	FALSE
wisaaaai3ET	FALSE
bbbROmqgWKboQpCPc	FALSE
bbbbYKU	FALSE
bbblduANRYRVUt2	FALSE
bbbNPwqWol	FALSE
WXasKKG4RvfWoqnwaaa	FALSE
XODjaaaakwYTbQHti	FALSE
DikSMDW3jEwdmWGaaa	FALSE
4TrUnhbbbb31rCVnoIV	FALSE
HaaaaPw	FALSE
34EIEla1B2haaa	FALSE
oNXXpICPEb3bbbbU	FALSE
bbbXgbIhArDwZCPcTQfWrPBef	FALSE
bbbvsHqFifC1RCfHnUs	FALSE
bbbzkbrJQ	FALSE
MbbbbV1	FALSE
bbbKY	FALSE
dbaaaaSoXgyu2dnyV	FALSE
bbbboKJ	FALSE
bbbRrfhVNgffINpHTSng	FALSE
bbb	FALSE
KnUSZDdWImVhaaa	FALSE
BRaaaaNdnyTNVB	FALSE
bbbPhqaDOtdYQ1GMiCRBDXIW	FALSE
bbbKmIaxrnmCdzimWm	FALSE
VbaaaaBTPxZepiFQnIIYvsKF	FALSE
HMOtzhvsJpnGWfxTPObbbbgk	FALSE
bbbiiiSOctoHhmJSyERgrB2UT	FALSE
qATyaaaaSiU	FALSE
GnpyXgQbbbbhV2gi	FALSE
wJdsooDBSaaa	FALSE
3J4PQaaaaIH	FALSE
mRJOWtXfiacjQZbTUqRAF2aaa	FALSE
cUS1SDMoadKmIrBveoJUjaaa	FALSE
bbb2FHKxVre	FALSE
Qbbbb	FALSE
bbb4	FALSE
bbbTusj1IPqJtJPr2jEa4F	FALSE
LXOvDPjsPCEBbbbb	FALSE
HsbbbbnJLXqPpUJ	FALSE
ihplCaaa	FALSE
xEFavFosIOaaa	FALSE
oodyEhfR2WgivNruSNrvdAaaa	FALSE
jmISUxxiFRlaaa	FALSE
eaaaa3RDF	FALSE
arNarWSKKTaaa	FALSE
cLsswR3avn1Hriw4kxaaaaB	FALSE
RGpTO41bbbbvtk	FALSE
kidqGwqytbbbba	FALSE
bbbb	FALSE
4aaaavlcQXDl	FALSE
SbbbbKBeZRyb	FALSE
2mbbbb	FALSE
jrabbbbKUofvXYOsYAzvAq	FALSE
bshlaaa	FALSE
FNfQNiaaaacCn3und3Xcc	FALSE
M4snZC4osbgBMXwalieaaa	FALSE
bbbNd	FALSE
bbb1yrztsONedquHoK1FITVk	FALSE
IbbbbGAtdkHepkM2oYyI	FALSE
fnbbbb	FALSE
Tw2NjFHSRJzpOvQcGaaa	FALSE
D4vqlbbbbS2t4D14NNYzEo	FALSE
bbbjBQcnfU	FALSE
IwmxKSXsynjtjzFOYsaaa	FALSE
mwgUTXJdbkOOd33YD3Gbbbb	FALSE
bbb	FALSE
miaaa	FALSE
DSkOaBqdPxNt3JNUMaaa	FALSE
Uqaaa	FALSE
Pj4qaaa	FALSE
bbbIpMfNS3zrVRS	FALSE
WlGuwEaaa	FALSE
NdLVAlbbbb3WtfL	FALSE
mmnaaa	FALSE
YnITRAEuUYYlCLSBxTnaaa	FALSE
I2c44bbbbURSjk1w	FALSE
QtgZbbbbuf	FALSE
aaaafApoSNqq3kjoDE1zbD	FALSE
xRMAtbbbbBX	FALSE
bu3VoBWDSdKaaaa	FALSE
SaaaasvAYwhT3	FALSE
n4aaa	FALSE
uaaaadOuprW	FALSE
bbbHdTZ4YVtqQodL	FALSE
le1CiEWuZsyTkKlfL3FCyaaa	FALSE
Jmaaa	FALSE
mo3yTaaa	FALSE
H1HhbbbbMXDK1	FALSE
bbbb3IFVQIuLj	FALSE
yLwNrvrIgtbbbbGBEzysM	FALSE
SpggeuaaaaJageoBo	FALSE
bbbfNOG	FALSE
34XUxdraaaa	FALSE
nIAYypLIUaaa	FALSE
TaaaaGt	FALSE
bbbPEh3	FALSE
aaa	FALSE
bbbjNuOGN	FALSE
WjDoVDLYUNoDeDbaaa	FALSE
zktnbV2SlbsjnvL1LLaaaa	FALSE
bbbENEDSIBQExo	FALSE
OYzDKPW4advLLfzbbbbdBtzok	FALSE
mLE3OwHTdpLMaaaaIufURyvmx	FALSE
ply4Vuaaa	FALSE
jbbbbFOYe4KBgR44Us	FALSE
bbbneMUM22Jo3LBtSHOZcP	FALSE
eJbbbbyg	FALSE
3akjmvFCifuALrnOlGZJZaaa	FALSE
FaaaavA	FALSE
gNNOKaaaasiy	FALSE
t3tonorOTsYafIw4qUSaaa	FALSE
rbbbbKY	FALSE
MFEQPN1iDzkaaaaaa2	FALSE
AaSHQLaaaaRgiIg	FALSE
bbbbbsIyffjYLvVHZscK	FALSE
Xtbbbb	FALSE
bbbQTcRLdis4Uin4i	FALSE
dSlpaaaaefL	FALSE
bbb1mc	FALSE
EC1CoSjA3aaaahuPC4OiS	FALSE
bbb	FALSE
yZnarhzJVyEaaaaPZL4q	FALSE
epZeIgaEcP1priNnptaaaaN	FALSE
tgeN3GHFeXkJWw3oQKeaaa	FALSE
MPMHaaaaWnOv	FALSE
LJwrNMaaa	FALSE
SEsxFCoellFqaaa	FALSE
reaaaayD	FALSE
bbbonQOPfNqdCrLClQkQMiMi	FALSE
bbbCvOBGUdZNE	FALSE
VyMQDtSbbbbxMNXZ	FALSE
tOJMhsCbbbbH	FALSE
gjrecrE2nrAsaaaaEa	FALSE
bBAaaa	FALSE
3aaaaCdZk3Q	FALSE
tDogGDCGvgH3yTCTgilbbbbH	FALSE
bbb	FALSE
FwsfhSaaaa4X	FALSE
bbbVPXTfkikHMFXuBuzY1Pzeh	FALSE
bbbcHJKDZ	FALSE
gJGIHIJbkhmaaaa	FALSE
qaaaaZMkqRywy	FALSE
Vaaa	FALSE
CoaaaaIrQ	FALSE
bbbos4b2ln4qNPBPEmdgvN	FALSE
bbbb	FALSE
QlsBK2yYeaTgHLhbbbbsPT	FALSE
znYOaaaa3i	FALSE
AcyVYVaaaaKzNO	FALSE
bbbb	FALSE
aaaaoWrH4P	FALSE
aaa	FALSE
zRCAAQpaaa	FALSE
bbbUedZKeRnvo	FALSE
DsvcEVeKTSvaaa	FALSE
bbb4KWYgzmAnZCvu4	FALSE
TmcPtwk1xbMxLaaa	FALSE
uNdqaaa	FALSE
jlX1qbbbb	FALSE
jTbqpYaaaahhptKXaharht	FALSE
xjlqNtATiehzqjputG1aaa	FALSE
aaaaX	FALSE
aTZBaaaaVOfyoxNFxV2	FALSE
bbbuztfXg	FALSE
bbbEnuSWnijMbCWcooj	FALSE
wuMTqSPk2aaa	FALSE
lLs2aaaaxr2WIbl	FALSE
slDsDEZSnaynaaa	FALSE
ibbbbBztQS	FALSE
DHGbwaU4FjyLCNTk3Ebbbbt	FALSE
aaa	FALSE
2kaaaad	FALSE
NazALaaaaNfBr1BjHMDTEme	FALSE
lbbbbJpcDq	FALSE
bbbZYlIB32sd3DW3IQ3PvwF	FALSE
GfgUUznoHHaaa	FALSE
cyx1taaaa	FALSE
bbbkVWZZsvkdhYOEYxIsz	FALSE
kfDepJnBzvDIwkLTaaa	FALSE
hbvTLaaa	FALSE
ioleiTjR2AbAbbbbO	FALSE
iS4bbbbIEl3MDYWq3ZwNsaJm	FALSE
31qzwHHTLUEkXQ12ZVuaaa	FALSE
aaa	FALSE
mICbbbb	FALSE
bbbBGwLnpYztuWSkuQENznEFV	FALSE
kaFlSk2ElaaaarEKgpQqddyHt	FALSE
YftREaaaaC	FALSE
tdhqYDbDaaa	FALSE
bbbTOzJYyq11lnoeE	FALSE
bbbhUNIUN	FALSE
NkpEAbbbbAftnPBJyjtNw	FALSE
bbbg4NOXyKkRSPZYQCH	FALSE
aaa	FALSE
bbbDEJmPBYdTBbEejimrHCS	FALSE
bbbbL	FALSE
bbbbMuRgN	FALSE
qEmFqBdRkcLYAdbOeiP3bbbb	FALSE
ofvXApEbbbbDka	FALSE
GkGRqtGHaWZCCSxaaa	FALSE
ccbbbb14pDEeiPRZFL	FALSE
bbbIrz1xDgj	FALSE
ruBAZSRhraaaaBN	FALSE
bbbb	FALSE
bbb	FALSE
l1bbbbTtk4gzYdOGJOZijuR	FALSE
glbbbblwpK3eAsKRv	FALSE
FkHwagRBDnaaa	FALSE
dnnqFlrIbbbbSXnek	FALSE
jzhWeByRgKebbbbbPSNIhotIL	FALSE
bbbbuYxRbECHFMBb	FALSE
Oaaaae	FALSE
igJlbFCJBvaaa	FALSE
HadM1aaaapOhhgzbW	FALSE
Ptiriaaa	FALSE
f2kBrf3L3mfRkQXJSaaa	FALSE
EuDIAEZzmlFaaaaKnnbA	FALSE
pLbLMzaaa	FALSE
HMkbbbbKeAAZ	FALSE
bbbhavJcN2CLbjuuYev4dwd	FALSE
bbbjc3THFuJQDq1X	FALSE
1nvLo4Braaa	FALSE
ultRjVtbbbbUjYcu	FALSE
bbhubbbb	FALSE
EFf4dh2paaa	FALSE
bbbz4	FALSE
lxEOnbbbbkb42NPjB2kBUtah	FALSE
bbbucOXzt	FALSE
bbb	FALSE
bbb3Sn1ZspbO	FALSE
bbblZfvJVXVzv2QbIZd	FALSE
WejCiu1xwDVfTaaa	FALSE
Saaa	FALSE
2UDdINZMqaaaaf	FALSE
vaaaaTvpWIKhRprZ	FALSE
hvlzaaaaTAlawBQ1XG	FALSE
bbbDS	FALSE
bbbr3DIxiTV1QnGOP	FALSE
bbbkUfmZtmWMMAv	FALSE
bbbr1oByMHjyniHKUhn1t	FALSE
bbbBnzuy	FALSE
sYabbbbWsv	FALSE
amlDAYwbLOZFVbbbboF	FALSE
bbbBJXln3dtbedFBYBYRnMf	FALSE
bbbOhUu2DfuScOXdltjRfl	FALSE
RWsjWriZxgbFbbbbBkaFX4y	FALSE
bbbG4XGmzSaCliUiQcnmpcQ	FALSE
y2jdnRlbbbbNs	FALSE
bbbDrAsSGJ3STEfiZdP	FALSE
QipoyyPZaaaabqu4RHCxs	FALSE
mYtZPVyyeoCcXaaaa	FALSE
tSmbbbb1JBrcv	FALSE
Fwbbbb	FALSE
unRaaaaI	FALSE
q3XRmRsWKMCmghbbbbkz	FALSE
bbbSEmEbeSA2WFHMWqtJuuBI	FALSE
Xbuaaa	FALSE
CgxJteaaa	FALSE
UeiUwYjOJHcOTIIjaaa	FALSE
jfaaaa3NERGhyhFEAhQY	FALSE
ZcVbbbbkg3a	FALSE
mqHaaaafkjrqWSiyWqyFz1HN	FALSE
2N4LbbbbMk	FALSE
bbbbF4	FALSE
EMYgrsWSMXynwnraaa	FALSE
qTkwhaaaaM	FALSE
RobYRasuvivsVE3xaaa	FALSE
Faaaa2Io	FALSE
bbb1TAQqPhHVOSz	FALSE
aaaa4h	FALSE
TfNHEamFzLbbbbNYaImXH	FALSE
bbbbpFllcbcNuAUS1P	FALSE
bbbFnC	FALSE
