JfyHímÔP7Þ6QêzoHÙ	TRUE
Ç¼ø¯ç°5£Óðv5CæÇ¿b	TRUE
³	TRUE
YÕN¢Ó©ÌchÃh3VJxaphÊíhZ	TRUE
tYbìC¼tm¦ö¬èºo¦Ù¶Ó¸	TRUE
½ÏÃµÑÀ	TRUE
4ÙÞÕÕÌ©jNJMÈXÐäT	TRUE
t	TRUE
­kÊzIñNlôÝÄéS«	TRUE
1n	TRUE
ùíÀ½÷ÔêMjLðôµU°Mð÷yÎÏÒ	TRUE
1Î	TRUE
NÛQ÷ÐCsYäÕV¶nÙ£IºWeP	TRUE
2®8¢u­çøfÀðr	TRUE
¿»¬è§Åh×È¢SIL	TRUE
RâmmÀÆÈÝî½èÔq±Yß	TRUE
Açø	TRUE
56â¨uÂ	TRUE
¯ZbErZ¥Y	TRUE
V±±µWuTïÊ°d6¿	TRUE
vO	TRUE
LÏ¢ä5UË5WV©¶¼ëÊv	TRUE
P9êda¢auÑ	TRUE
Öî	TRUE
PT3Ûq	TRUE
ÀsÖ	TRUE
áåÐÊÌGNÊBìÝmøháÄvÀkg¶ÅbÚ	TRUE
Z²¢oÂn«qRÃ©ªÍ®	TRUE
ÊqGÝ7®ô	TRUE
¾Ç5³årYIcÑV´µÙHvPåíñH·lO	TRUE
¤a8ºj°w½Z2·ÉÞµ	TRUE
ç£ÍõN×6æâyÌ¯Ga³NIÅª	TRUE
öëF¿ezÄSàYg¥âÍÅå¼¬·ßªEî	TRUE
ÞÚH§¦EkÝW­ìRd¸l¯ôJ	TRUE
ºÛ	TRUE
fJOÓ§8µÛ8Ã¨cÍõe	TRUE
ÙÙ¼ÜÐg	TRUE
dÁÌ¾îÉdaíÚPOÉvù«wÊq3	TRUE
HÄÆ	TRUE
èZÃ¿eÏGÐ1ì­1Þ4è¶iÒôÆERARf	TRUE
gãÔçÝSÜWè	TRUE
Fù±rsÅY½Ñjìß¾¾ÉëÂqááaùÁB	TRUE
nuôckdA5ä¾¼	TRUE
ÔÑóÕÆÆshIð°®öålÑÕZOÜ	TRUE
s¶VnRaºø¼Ã¤°aâhøâÍCkÝZ	TRUE
¸ðÝÄÆëæÙìb	TRUE
óëNdË	TRUE
céäwP÷7³ÄÁttç§·TGlb­L	TRUE
í°ªUtùÖ£MÒbw©	TRUE
àtèC	TRUE
Â³zçºÊÇOéð®m­¤9	TRUE
e«9X	TRUE
ÇZªD´QÄ»®jSîªT£Ë×ù©f	TRUE
´X¦¦Ãa´ÌèØ	TRUE
ÁKøª9CÎ	TRUE
TåV×¡ô¡ÜÞÄ	TRUE
¬ÅX§3zfA	TRUE
õÐ5ãÅÚEVKrSR¸	TRUE
ßå³£bAùÙ¢qPî¸·E¯¤ß²¸U¬ï¯Û	TRUE
Q	TRUE
Å­à¢§Éqy¦ÍÕMÞê	TRUE
Pzf¢ìÌçí¯EËoÑq¨Nd	TRUE
ëòÁ	TRUE
wæ	TRUE
£ÌËçÂ	TRUE
Ü	TRUE
ºîÆËp¥«Î2t©¤ÊEÇ¿ø»ãàÒpØ	TRUE
eGÍÀH¨§m84AI¾Y¤n­fÙn´v	TRUE
57ÉêOyBo¹¥â¥	TRUE
É½w§ùÇiÒK	TRUE
¸lG×íTdEøZ¾óvuO	TRUE
S¨	TRUE
å	TRUE
¸øÍTYq²vÇ5§óZìjÓJ¨5¿îÍi	TRUE
sKìIº¦zÒÕ¿±Ë¸ÉdiÎL×À	TRUE
åÂçòÊÁå÷yðÎël4ìÀ	TRUE
ÈMäÙcÃc­TõÃÄKAäÅjÂÍ2UóÚÉ¯	TRUE
bù¹D	TRUE
èº¨ÒßÇÌ¶f¹»uE´	TRUE
BèÐTJò3CT¢eÌc½î	TRUE
aðÑfÒhXFå¸¦åB½u©ÃÆ·ó¸HÃj	TRUE
ÔjOhõÏhx°g3ùËØÅ	TRUE
X¿ØåÆf¿ËÚÄ4ðe§I¼ØjÃçÉÕ¤íí	TRUE
²¤§	TRUE
¢»Gçxëâ¢iÛð»AÞÄÆöÌ	TRUE
åbægdoWï	TRUE
È×19pö­8rðà×tìz8Tõ	TRUE
ÍVÜPYGÕIç¥£Åºw¼Yqc¢°	TRUE
°ðónÚN¡Æø£Ë£1rF¥VotÉL	TRUE
ÞsC¸¬NIÉv´JµYå¿6Ú´	TRUE
u¼Á¼ãôáb°ÊaQª	TRUE
ø¬ÚJðn¨BÛíqovèAAõ´õábÞÜ	TRUE
·«±ôÁ±	TRUE
kfGåè5Ð	TRUE
FôÙÃÝ	TRUE
S©Z¡³Ïq·IwÓTÆvl	TRUE
ubäH­dÔAy§î÷«ÖÃÀË	TRUE
L8×Ýq·ÛiOÓ¢fpø¡ÒÅY¿C	TRUE
KvKZÝ	TRUE
¥Õ¿õÁË²ÕPð	TRUE
gÏÕÒdñ×Vmá¬²ÄÓdùce	TRUE
gÎOÐLÚ¸C	TRUE
EERt­DD2¸½Å	TRUE
·ËeIËÏæ2æ	TRUE
Ýòë¢ñ»ñ¾F­m±qA	TRUE
ùÉnÊDbøØyöí7ò	TRUE
Aß6¦ð1Sò5Ø¹ô¼à®ø³À	TRUE
¸Ñw¼¢àQÈ	TRUE
JÆ¶jQÌwB§PyÓÎ¦Ð¯QZKïÜgò	TRUE
Y6Éºëo°	TRUE
YyÙò»	TRUE
ë»x¢hNbr¼Î	TRUE
J¾ä¤rÚ¢ôËYIN	TRUE
3ÃWPgù¶óòm¹ÍÀwpÆPl	TRUE
ëprdÕ¢p¦÷µ³ífÛ°®­	TRUE
¬7êÑÂÁñ6êÙêïá÷aeßRU­®ÍáÕà	TRUE
2i	TRUE
çó¡kyB³²¯JöìjbÀhÓ½	TRUE
¯KÆYr¦Ãl	TRUE
3©®Df×U§A¬¤áÛÎz	TRUE
bB3M¦ElºëÑ	TRUE
Fm×Z	TRUE
ÎNµ2fv©ÆïL7eË²eI	TRUE
Pë7OW7c§ÓÔxè°öX±¼èaHáSQÂR	TRUE
ÒóÂ½£6Î	TRUE
×ÅP¥QäÐôÓ²sw	TRUE
AhÈ»x¬sX7bøÛPùÛÉRåÄøCÛdó	TRUE
ÊÎ6PÕ8ZùCà¾ÕLu2AØö§Ü8	TRUE
ÊîÀ«ëTñ24ÐVòÜYò	TRUE
£FºÚv7LN¹ÖªùQøÅdÚØgô	TRUE
Éç	TRUE
WæÛXGù³VßrDI¬·ìðVç£oL©â	TRUE
Xí2¬À­sÍÕ¸¾A	TRUE
£ì6¹xåj·NÊdp	TRUE
bupoT3VfâçJgXs¾ñøùSÒTø	TRUE
s«Jé	TRUE
mb2µÜNyËë­ÝDjÐ§RC3Í	TRUE
âµ	TRUE
±U7¥GX6q6íÝfî×éøä¸°f³±½	TRUE
â°ÃôÍ§1Y½sXMF«§é°ÊÛäC	TRUE
â´pÒ4J	TRUE
zSò6áGB	TRUE
°	TRUE
µÉ8NÚ§oNfÉä¶§ÒÊj1¼c±ÏÊÇÐ	TRUE
g«5Òo7´ËÇÉ5×dØVî	TRUE
À®ÓÐpdEF	TRUE
9Á½y5s¯¿UÑÝY¸öZÎfNlJØ¹x©	TRUE
àl	TRUE
j»áõÓHLZôÓðr£Y¤»æãòXP7Q÷d	TRUE
ÐHÎ§ZÉCFÉÔøn§ÇëáaYkCVl×I	TRUE
ÄC¡3¿í	TRUE
1ZÁËÙß÷¨Ó·sl©¸±dÉ­µl	TRUE
1ÛFº	TRUE
CcSCÂÏzÚsÉPUÁ©	TRUE
Ö©ØF±çs©ÓVÞ¾eøê1	TRUE
oPåÖNÊyhpÊ¬wñT	TRUE
cdãÓ·¿4ÏPjlaéÎÉÇÖYI³O	TRUE
ÏPøíy2¯WYÑÍ¼Aa³g¹ÀkÙµv	TRUE
sfÞl9Ù67ÖÏlë÷¦D9±tohðF7	TRUE
ëVvdÇl¿âlyC1ÑA	TRUE
m¦ad´ClzqÇérÝ¼w¨®4®	TRUE
Ú¸OÎñ¼§29D8mÏÃOj	TRUE
xCFzw«6RÀ¤t¹Î®Iµ¶l­ÀÑeøs	TRUE
ÐÍ	TRUE
rÜQláÍEÖFeêSõâR¢ÔtÌ	TRUE
á¹Íïo²MNëâØÓv·JBÍW4	TRUE
ðÁÒÏùNæe¥mHÙÊµehK¶	TRUE
¥L¯¶ªÑÒÃÈÒãÅÒëMXç°	TRUE
Á÷R¦ï5£N²Q9Tì	TRUE
FõNÕD3	TRUE
W¯fÂ²Lâ3wdsÎhY°ÛGqÇßÔ²bä	TRUE
gøJôô¤îYw	TRUE
RuóiwGá	TRUE
cAd¿qõCÂ2î	TRUE
UoÐTOá¼	TRUE
zÇ÷ìdÜÌTÇWgp÷øVbåBóëª	TRUE
ÖèÀC6p«BÙÖ°ãk°HÆù	TRUE
Áy¥hÜZCXeùU¥LÜz·ÑhñßH	TRUE
åÑøåÅ±Ø°µÓÂÍÎê¾	TRUE
åçÞ÷ïtìBµÊ	TRUE
æOóÁJÁé½eå²xt	TRUE
ñaå»Çw£aÚÓg¬vgD¡KªLÀ	TRUE
E·ìåPéNªRdZìµ	TRUE
XÝê÷¥´ÛT¸åpÂànòw£µ½íg	TRUE
lÔÒÅÒÆíQnr¼AO	TRUE
ëÄm¡±Q­22Þ²ö·	TRUE
vs¡ÙñD	TRUE
Í9UO	TRUE
´ë¯îa´	TRUE
èVåÕ5zmrÍEñtéG4kqAÆ	TRUE
Ë¯x½7Ñ¤MÚ­åö¥Stph	TRUE
ÖI9pç­÷HQHfe¥Î¯n	TRUE
xéõò¨ÚÆ	TRUE
ÕÅÒO5ì¨RUE³OÖiÊLBE	TRUE
·	TRUE
§7hå	TRUE
Ò6¤ZæãôL»ì¶®±e	TRUE
À³e²¬lHf73EÎApÑXÊ8¦E§q	TRUE
M¹ÇÆË8uwàKõîÛä£Ë6Ð	TRUE
SewpÆbª­±ÚñH¹Rë	TRUE
Mp¡IïâêÄ±q×JåÓ³ï	TRUE
dñ­áiZÛ±	TRUE
ÉmªYc	TRUE
DEhßEðkò´	TRUE
J3§§òÛHCæªÄÌ¶å§Ô»¦ÐU¿¹	TRUE
ÛØÐÉ¥kzØÖËæ6ÊÉ6XëÒÕÑ	TRUE
âXU©Ñ¢ìS	TRUE
wäH	TRUE
°mXAqÌa6	TRUE
ãPJö±SY¬sÈçIt¹ÙËì2«´B	TRUE
ÛXÍKÇÊ´1ð	TRUE
re¥¼ª¼l¡ÈòÂ®	TRUE
ð÷5éä¿bÏÑcWVVJówíÏªó®½	TRUE
ºfÁJùêcßø9n¿ÝÅL¸mÎÀ§TÂ­õ	TRUE
A«Z	TRUE
ÅC´xRN	TRUE
Wrì²Æ¹Óæ¥§ölÌÅÓS³Ë§	TRUE
ÕOùIðÄ	TRUE
ã	TRUE
KeÕaÙ§²c±Ôlj³ÃiyAHW	TRUE
3¼Ð¿Fèë	TRUE
9ÙõIykÎBÂL·bNnµGP	TRUE
5êí×§­´	TRUE
¢J³ø7¸áb5	TRUE
PäM»ìIÂõCGZ¨ççwEÎæBbâÍÂË	TRUE
»BäµYN	TRUE
qÓ×¿ðx	TRUE
âMÙð¾d§¨S	TRUE
³Ç¦Z¨»ðÕ¾T	TRUE
©«ù	TRUE
X¾øa±	TRUE
RéÞóðgrRGòA4mhê2§ygóC8DãS	TRUE
³lCßGêãDÒw®q»7vä8	TRUE
Ñ222ÙuD®DqbSk£Ua25iÍÄ³²ÝI	TRUE
ÉÎË×ÔWCMBf®E°gÕùÝofjdºKhY	TRUE
©Ù¬åÙVwÈÚ	TRUE
¦49¡¢HSÜª8Clit7Pztè×	TRUE
´Èìº¥Þ53ÒÜèYÂ§øªÚ±Óá	TRUE
áêó44À½9©S¼SÌpìKE93ºã	TRUE
ùU«ôºñ	TRUE
pÓÙøY4Fºc¬ÃDÉ	TRUE
LTÏwÞq	TRUE
9¢ºdr	TRUE
÷	TRUE
aO¤éÂê²ïhØ©£íåBßf	TRUE
æÔUÎêàvóêk41µa«øQ	TRUE
ÀÊçI6Êyo6¬í	TRUE
¸¸Ô²ðRLÃæÅ9E	TRUE
«¥§°xÃÏîaÅéê	TRUE
íõs6¹oô	TRUE
zÚÛIc·È°b	TRUE
ÔnRÃ6gNt°K	TRUE
Fñs	TRUE
stìíönÂgwæJHd±òòèÔÖà	TRUE
å4Ça2æ¶JOÅm8¥Àe	TRUE
«2èòX»Ùzæ¸áuÆÝkZY®	TRUE
ËæË­rxEÄÉø¼äg2	TRUE
°Å¹EÁöIz7x¬pwzÜ¨J¼h	TRUE
ÃªÊÙ	TRUE
ï¨êÈ«XðnécUAsp	TRUE
nSMßÞÂ	TRUE
¸U°³©¢ÒæïÄ»çEÚÏÐbÂÖf¯	TRUE
¡mËEõaBÜÔ2M	TRUE
¡ºð¹	TRUE
2Ð÷8öCzÔMòæÅN1èÔ	TRUE
2HµuoñÐ¾³Ìéï8¥2Vtà¼ÛÝXW¸	TRUE
ÚÞDâzuîRá°æÜÁT¡TuH¨	TRUE
®LT£ÝDA2	TRUE
àØê7ä®W	TRUE
»ÂÝåR5dðÖºQ9FZQôwéÍJn²¸5	TRUE
ÐQ¾´TNØÃbgë¶øÊ®ò3¥ëJOhP	TRUE
ÕzäÆÍkT¦©·¿Yßë	TRUE
¾ÞKóB¢¡¯ÁÅ1L³Dg§	TRUE
AvY	TRUE
¥IF±LìÚ£¤	TRUE
a2±¯âìpG7mòAMµfØWÏËe©ÑÞÔÊ	TRUE
G8î°UõSï	TRUE
®oZÈ¤½F­	TRUE
¦¢kÑVïOÐ	TRUE
ÆvnxíÏ¾	TRUE
7ôd	TRUE
é²k9ïÄ¸òñÖzpXTnÇii´Ù¹8µ	TRUE
Xí1ø¶MÏI°BäPPìéå¦±	TRUE
Øï±ä	TRUE
ÛeÔºBÙj©I±Ú7Ý	TRUE
ÙeÑÈz	TRUE
NrËlÅðíî1Ãv7ÄHAï®ÁÎÁø¾¸	TRUE
U	TRUE
×aª	TRUE
jsxê¡¶7Øâåw¾PNÅõ¨	TRUE
gÞÀ£ò5K2­ÏÒnÑ5ÓOËAÜOéÔA1æ	TRUE
6Ðã	TRUE
z	TRUE
ÍTuíY¿Ê7®ÓF8Ùe39¥	TRUE
Ì¯jCnoìárL	TRUE
zðÀÌ	TRUE
÷ÇVÓ¡·©íPìiö	TRUE
ÎÇÑy4t¾Ê­ËP	TRUE
x«9Ó½Ünâï¦ÀÔQ¸·KÜÐÏÄZ«ÉG	TRUE
³¥ÙRt§¯Ö·öù9ÑÌ°E	TRUE
»gDÊõuÎK	TRUE
OâÌkG°óï	TRUE
íV7èp¿óö×¢¡ÉHâº¤¹ÞñkÆé	TRUE
ëL¶YêL¼êtÔ£mHl4É¤¥E¯ºYÍ½	TRUE
PzR¿P±gä	TRUE
Ç·uG¶ôñàBÛ¿©ÃÕã	TRUE
fù§¾¾Ë9Wh	TRUE
HHD¨	TRUE
LÁbm9Â8òÈºÊ9OxKÑEâ3Þîì	TRUE
gcOºñ£EZíèhÅ	TRUE
ÚyæÞÜzf8è	TRUE
Ôáß¼ZÌÞ3©À	TRUE
ÃäÚbÃ1R	TRUE
o÷¡Á¡5§»CÞÒw×PéåtFgi¾	TRUE
Ün	TRUE
Zôiª	TRUE
qîÜ	TRUE
ªë±ÏÝza5ÅÃðÎoæÆGÔ1	TRUE
Þ¡ß»¬¤ö´³£F§ÍOÖxÑ	TRUE
Áä¥G¦ùWÚ	TRUE
¤OKÖï8EÙ¨7ÈY6îA¸ÔÔÎ§v©Ì×h	TRUE
ÁVVãgÍO²ÜÙqqÜo¸u¯»®9	TRUE
½ñÕ3JÀ¦Ü4S±êmjÎ	TRUE
U3qL©¨ËwÈn¼ÀOÊÌW³ëlófDI	TRUE
WÃDanæ£	TRUE
Êtù§cîÏ¿Î­Âß	TRUE
uPÁâªùØjÞEsç¢Ød	TRUE
ÔA¯­¨olÂ33aÙíÊÛ¹°DÕ	TRUE
x­À28¥NINÎõHNìUè	TRUE
Q2U§KGi9ÇgÔÓÓGÁÒÛÇ¥É¯	TRUE
KÈI²	TRUE
ËDÕ9à¯ùÏñÐßÅHéÌîØFß	TRUE
«²Ô¦»ãWÏ¨4ÕOÀ	TRUE
¸ãÅ8HíÇ½¿cÛÞºWÜóZ	TRUE
ÂñPßùqÀTzÐñ¸UTjAô	TRUE
¢NHÑ×ÖOé°oËtmtïânê¤¼¤U2kÍ	TRUE
k3áÇz¥k3ºëHíÓ¿ÌOAÖá©	TRUE
TºPóÊãr6OOSÎòöÚó9wSÈøÊ	TRUE
ì4JìF¶º	TRUE
E¢ë	TRUE
ÎÛ¾ÉcLÔ­¿¾Ì¡ôªéçSm4¯ÛÏ	TRUE
ø³Xç	TRUE
ä¬ÃÑwqPXÓ	TRUE
¶Ùfí¾	TRUE
¬4¯xµLµPÙeiDLïzåBg	TRUE
tLHìØ	TRUE
Qâu´f´zÈÏ·øPQ¥ËÈËæ³®Ú	TRUE
ßeÉomuðr¥iEÆ	TRUE
²	TRUE
ïq±n¦ÑBTß	TRUE
ägÛíPÓ¶jðÕ	TRUE
´ÏàñÙWÙ®öNÀMðçÈ¹rÉÅ	TRUE
iàcÚéçYL5iéôG1ÑÀÅX±jj	TRUE
NåD¯owBZ°JèJqs¬En¯UÈQ¯µ¾	TRUE
ZÆ½É¬K¾äB	TRUE
¨ðÔcQöÊ¬uç¾ÅÇéãªCîbâ7Ü±	TRUE
I®ëGï¼DÄÅÖÓ¨	TRUE
´lkøTÃ÷K§GËg	TRUE
¾FQÂ³ÉuàºFØë	TRUE
q	TRUE
Ë	TRUE
YàÙÝÃÉÌºkóiÃ¡r¾gÂ·WS1¦Ç	TRUE
HxgÏHÓ99¥Èì	TRUE
ã6»Ï¬Û9Àh©¹â©jg½S¬ë£ZW	TRUE
óÂGIÄãcÓOí¹òoNZîê¶ëßÆÌ¸q	TRUE
g¯¡	TRUE
euø1b·À°ðé	TRUE
1M»8rÐZfyWÑ´ìSN»ec«z	TRUE
Øö¨ßr½çð²ÈO¢îKõàî¨N	TRUE
ÂvØé8Ù3Õ½ñyß©	TRUE
êRµmfñíWR×Ú	TRUE
´PJÁQÝ¸	TRUE
ø¾	TRUE
cFÉ½woÎXN³m¶m3Í¥±JP	TRUE
qYUeÝéA6vlB	TRUE
eö¨ïs·KÜnìAÆQÊ	TRUE
O2ðDu¥TÁ±qÜYyÔ8à¼ÆÁ	TRUE
¼	TRUE
¢MsÝdóì	TRUE
ÒrZS	TRUE
ðuºN²¿ÈÃ¨ã£ä²vôGÕr£Fk¼ÔPÝ	TRUE
B°¡ãæXÊ½FéÕ	TRUE
vÚcëaAtLêÍ7êÛLùf5øC	TRUE
ÆÂÄPv33Å­ÈdsI5lC¼	TRUE
©õSxÍiAãÅôÀ·8Íu¬	TRUE
êË®¬JPÞñÀ¶¿¬¿±ga5Ç²¥O	TRUE
£¹dõöêÔö¾ÊA»éùË	TRUE
¥½ÇµsDæ¸¤Ó3ðRØ	TRUE
ÎA¹Ö¹DoîÁJ¤CZ¦x¢òEON	TRUE
CµCdiÏTiãÀ­	TRUE
8EÐVzG¸Ñ	TRUE
YvÐ÷	TRUE
3y¥W1®YâÂHR	TRUE
W3ä¿eU÷óæT	TRUE
ÆêùYö	TRUE
½pX5õò¢ìE¹3	TRUE
çL¯Õ¨Ýq¼X¥æsOîÔçeÒ4ÔA	TRUE
2wÈÙ7â¥ØÀÇÜùiZìÉßn´°íÈå	TRUE
«67òãphºs³F2giÞföÆçª£UÌk7	TRUE
gQ	TRUE
¤g±ll	TRUE
wW¶«ÌNR®Ïôh	TRUE
4cT§w4O´ø¼¯HUªOÃ78Âµ£cãgå	TRUE
ÈQpº14¿ñ	TRUE
Qk°Îê¶gÁÃöZÞM	TRUE
Øt¨êïðl»§«Far	TRUE
À6×W©bîz¸À´CéCd«NÍG°	TRUE
Ú	TRUE
Vn«ôx®ò¦RøSj4©6öJëÖvâiõ	TRUE
TU´k¶Ú»s¦añø	TRUE
Ù	TRUE
¹záë	TRUE
ØIHuôvÕÅâá9qßÝOKÓ	TRUE
3ZáVQ¦àOkÃ9ÏV2	TRUE
SÍ	TRUE
kÒç°¿r³ìÈEZÚºÜ±rnÂ¿ÚØ	TRUE
k»ÉÝtRñ÷H2G	TRUE
ÑßB³JÐil¸ÀH2	TRUE
ÀG	TRUE
¢ï²íÙF­ÆoÊ¯	TRUE
CÌ¾nëKOÑóåãÄ	TRUE
òz±«Oow¨Bç1ó²VCæÀ5	TRUE
JÞe	TRUE
jd	TRUE
Ìîgã÷5	TRUE
ôÍ²æbòO¸½­O«±	TRUE
ÛO1ékyâ¶3H2¹yz®nÑ×16×º	TRUE
»àBí×m	TRUE
jðÔsµNSeZ¨8Fs¯	TRUE
w	TRUE
H÷íR2Ocµ2´kÑJ¿Çê÷NæùNe	TRUE
ÄPGvÙf«®G	TRUE
Æ7hìÌ¨aÛ9¡Úâ©ù£QÓFâ¬PiQàd	TRUE
Ñk§c¦ÖKxð7	TRUE
KCááÌÇY§¯ÙG¥NÉåF¯Ìcâ±ÅÏØ	TRUE
ôÏØ	TRUE
ÓGJ¨ÚjÁ9¢¿îÃñ	TRUE
ÑHÌÉ¯éÛpÌ¼Åm»ÃÇõùZ¿©ï	TRUE
kè§Û3	TRUE
øº¥ÝÏZUnøéÒCò½	TRUE
¥OÛWÂjxà·zÎ	TRUE
zmARÕB6µ¤Aô	TRUE
Íl¢uêâëì®Z§­´è	TRUE
Ñ¯W´ÀÃímÀcÁÈYÕcñ¾2Î	TRUE
îOx1ë¤°Û£EMËæ8¨S±ßSR°RMá²	TRUE
DÍhÜÐXI8ÄO¢VìÄ¥È7XswãIÏ	TRUE
ÐKkÃhí´¯ðz®DæQA¦¬	TRUE
n»ónÇ©Qãfµ»óê¸áó¸ôòÑOÚø	TRUE
õíaNzÐ¶3´ËÜÎeBÂ4ÊÕB»¾¯	TRUE
´XFJZHËÓ¢ìêÓs­§yÎç	TRUE
õ¬	TRUE
·¼ä8ÑobkàÊ	TRUE
«sÁÂ¸ï±ÙÏ¯ÄEàyÁfaO	TRUE
GjòíÈ	TRUE
fJ	TRUE
¯LôºÆkt6GlTt3g§	TRUE
yÕ¡§	TRUE
QqP	TRUE
aUB½6¤KÉh	TRUE
Dc¼6£²¿óUÈñ²àM¶ÚÂÞ1ÛßëÌ­¡	TRUE
U4®Ej9zWNv§Î	TRUE
öÁ×Ùí3á6ºÊÎ6ÉÏ¹	TRUE
vUçà«	TRUE
ùº÷ÙKSV¬6j¡	TRUE
©ºâµO¥äçÃíeaO4Wõ	TRUE
ã	TRUE
sË2wpiùÕÂF	TRUE
¤læ¯Î	TRUE
éÚ¶Ú¢¨¸vxw¡¿É¥×	TRUE
Ó°8§G	TRUE
¥pÞe²ÛÐºº¨àZÏdðäÚîðEãP	TRUE
óóA³ZÖãAéã4uØåw	TRUE
ÏºX¬ãLÕµ³°	TRUE
ÕèMÚX	TRUE
WáU»£×ò±à³	TRUE
íDBéêçÂ§êlÊ©®EºF	TRUE
z¼Rq¹éYUö¦¯Ó9ºO¤	TRUE
Mw±ÍsXeô«å¡Ðt¢TìÁPÕÜ¨E	TRUE
ÖÇZO¸ö¯¶êuN	TRUE
ìçßîÑ´RÁlöß1rõÑÕ¸ÜT	TRUE
âG»LõÛàÓÞäEù±øUøî³J7BXQ	TRUE
c£bÉWh	TRUE
ÉµjFVÚÎK¡ìYá±4îC	TRUE
ÕB¬JxRó÷ê7íéù	TRUE
m¿NX©óxGòÎëÍÁª	TRUE
ðÌtS6Ñ9lô®¾¬´Ígam	TRUE
h	TRUE
ÐàAl»ÍuÝ¦¨POQªSôªRßrà	TRUE
Þ°k²PëUôÅ	TRUE
2Ù¼ÛXÂiIôwzKçc¦zAô	TRUE
ö®ÂeæÝ§£r§ÖÇÒgPW	TRUE
¿a86i±	TRUE
ç3ZóØ®éÉãcÊoôXtÚUóàâÓ2sß	TRUE
ÅßÒ	TRUE
¥ïeÒâí6Ó9Y½ÛÌÎYòO5¾õ	TRUE
í±¥²DöÚNbð»ÙëùhàÚíìNÅC4	TRUE
¼²J½Jè1Ä4­¬¬ÜÄj	TRUE
JÁEà¹öÕÉæÍk	TRUE
c¼bÔRîì	TRUE
k2¥®ùÓgï±ùõ»ªD¨ô7B»ACà	TRUE
abÕÃeñÎÂcD	FALSE
ab7	FALSE
á¨Îab	FALSE
tâaJÇbÞùB²P	FALSE
ka·ã¬J¶J¿DpAªªÚÞbÖ	FALSE
ßabª	FALSE
ÑpabT	FALSE
ëÜhabz¸ÀkÔV¤Ó¢ÂÕ	FALSE
ÆabL	FALSE
aÃf®8w¡½OÂÞÜbÆ·ÅÆµr¸ÚÖ¸s	FALSE
Ma8ÎaëaðÍÍè¾T´8biY¡µAÅ­°	FALSE
òaùkÞUòb«2	FALSE
JZ¦ÎÈê3¾mab5½­ÞÔ	FALSE
4¡a²QGbêóò8­ïÞ§Ä	FALSE
¨a­bC	FALSE
¤YBöíÏh4ab¤¾GtÄIz®îÓ	FALSE
EàÝaEHb	FALSE
ìY¿ÝqEahbÛmÕg£®µÎaeÌ§§ç	FALSE
pbìV§HaµãÆbHófÀ6qæÑ1³uWÜ÷	FALSE
ãabeçjH	FALSE
ab	FALSE
Lab	FALSE
ab	FALSE
¹¾ºpa4b°	FALSE
ÇîéyòÀdNéÞaEùeÙH¦CÞá¦Åk¸b	FALSE
6ab	FALSE
àÝa£ÝkÖbËíWñécbßbà	FALSE
ìä6ás4qVotDËabopÖÂ9	FALSE
a¼bÚß÷c8·Ò4ÞfÚHNyäBmb	FALSE
íåê¨à²ð¢HhaØÙõùÕòbòa2´Ú	FALSE
ab	FALSE
ab	FALSE
Bab	FALSE
ab	FALSE
ªa«óaðb·Ñ	FALSE
MÁËdaùbÍ¢g®	FALSE
ªR²Jalb¢	FALSE
1WOÍa¼ÔClª¨z3ÌEkbxxXmä	FALSE
C«áêaÓkbÕ5zæo	FALSE
a¾ÀbÕÄZÅó÷L¥	FALSE
®aÇénbÆGBÛaøãµ±WÑuµÈÍ	FALSE
ÀaÛb	FALSE
a¾Ï¾àP÷ñ¿ÏzciÈF¸1bê	FALSE
aab	FALSE
Q´©GDØE·ÕJªÏ©½CañÅoéã¨b	FALSE
Àag·IóîHÆbzBYõÈáeðÃdñv®	FALSE
lFëEªæXa¨ëbojÝI´¯ÄÃÇâIØ¿´	FALSE
ab	FALSE
¼aE2bËIXiL	FALSE
ÎaLbìÆ	FALSE
EabÈÕìPJöE¥å	FALSE
EòèÓãë3Oªµaãb	FALSE
¹MµaöbE	FALSE
ÖVãab¦Mà÷	FALSE
PaÔb	FALSE
Yâ¬ab	FALSE
ï·a°eU¶»êXbañ	FALSE
a²b	FALSE
óTaObDN©	FALSE
Xab1cR¨ìíjêÅÀØ®p¸	FALSE
÷µõa¡°zaHÒE÷¢1ÓÔÐv¿à62ob	FALSE
anfuñq½çpä5W9b	FALSE
âÐ½Ì·¢Àaoà¸b	FALSE
a»WÚbÊ	FALSE
ñwÈa¹bÒrù½¡	FALSE
Íft²g»áÃaabÁì£ª	FALSE
»AkaGaxàò1¾°iDb¨I5ÒN»Î7Ù	FALSE
a73DçÑcãCÎHbáé	FALSE
q±7xlÒuà¶ÉñëÉabnÇkñÖÉKéÓU	FALSE
÷aÔ1õ¬°ôV¡£÷b1H5	FALSE
zab	FALSE
X7Mø¾9v½abfmà¡7È	FALSE
a«ábØpv	FALSE
LÞíNnJNáÏ2³ùXÜa5÷ñE¢ÚbÖ	FALSE
·öeaÉ´9Á¦°döbõÈ	FALSE
9áãaâ­h3wÇ£õYâºb8éöX¡	FALSE
Þ¹6aäôÑgby4Cïiðio·Â	FALSE
ÄiåabÛÌíî½ËÞ	FALSE
asbTÅ©m	FALSE
a4Rb­¡X¨÷içqÏws±M	FALSE
aÒÉb7ÑJ²ÔEÚÜ¦¢£©	FALSE
EtcfµDË¿maP¡îb	FALSE
çn³ÊgÛØÆpa×cabº³ó¢	FALSE
Ùga¹Ø×bÒìBÈ	FALSE
àÝìa©Yb	FALSE
²dkÂE§9Fëa®bzÄÎ	FALSE
ab	FALSE
aäæ²fbaF	FALSE
¯ÎaKÉöb¹EdMg¸lª	FALSE
aæfZ24Ì¬bÀ	FALSE
ab	FALSE
öµwabe	FALSE
abqc	FALSE
u6×ÈÙaM5î×ÃibÅ¾ò´6X¼aæL¾	FALSE
ÔcÅæ­Ê×SbÙ¾al¢xÜbº	FALSE
aBóGãÖ²»Sb¨R4aÁÑöGbÝ	FALSE
ab	FALSE
6ôaæÆÜÐªiæ¡ó¦EQ4à¹euäâVb³	FALSE
Ï­ïóaîpvòíläÖ±LFµÄbmuHé	FALSE
¼Èaob	FALSE
Zab	FALSE
ÏaÜIb	FALSE
Ãê«ablõ½PÒpK	FALSE
º¬äab	FALSE
Eab	FALSE
ïaiäHoê¦£rËË¥æÈbö»Ù3¼	FALSE
Ï1­Û´à8Z°PaÖoÀu­2i28îÃ×b	FALSE
eadb¤×¼KH	FALSE
É³ËwcTjÃê¼ÁÜ«p9an¸ÙFb	FALSE
ab	FALSE
§faºèX5Ñbfçd	FALSE
rN³Í£g×êù¥¡abº¢âÊ÷	FALSE
aDHb	FALSE
àx¥Åg×aab¿£zÃÌÄEpzê	FALSE
ØN¥ÞM×sMat¬ab8b²Ü¹	FALSE
AaYb4ð7Ùn	FALSE
ù¬µabÁÊÞ­Ó¬ªrU	FALSE
aÕ¬a»3b	FALSE
O¨à¢Í×ayy¢bPc	FALSE
ab	FALSE
daÝ§µµåb§ËZ3µ	FALSE
a±bB	FALSE
aàb6áä	FALSE
ÀèMài¤Ä3D´ÅÀ¿a9N9ÄÕb	FALSE
·Z6¬Ù8Xô¯Qq£íÒaA°ÌÌb	FALSE
ÛZgYQ²aòê¡ÉaUbË¤ôvábÈí	FALSE
µ®1588aFAï¨b«Ï	FALSE
LDfÏ¼¡aY©bÚJANÆNàZðÙ	FALSE
a¯D7­Xv¡ÂµÃñmbtÚ	FALSE
ab	FALSE
abÕqIp7±ÖèßàãBÊpX	FALSE
Bó­9Ë8C¬I¼ab	FALSE
aDt÷bÉòÜáw³kç×JæMDÑ£q1É	FALSE
ÎåÃsvÊBOÔáqãaxEbt	FALSE
ïíËaÒdaèKWë«mblxZ´®®÷±F¥¥	FALSE
ab	FALSE
±nËGçÀSVê³±âzî³sgiàabi	FALSE
ab	FALSE
¤aD©DÒPr½±Ì°vJÎ1ÚgzUèRØbÉ	FALSE
b£ÓUvÂæ¯haÛb©ËN¢ºù	FALSE
Aà¬aÕÈâ®OF³b	FALSE
·Yíã»eamöÈòuwÆbÍmgE	FALSE
ab	FALSE
½¨arâùl¼ë¨½Xa´bS	FALSE
ab	FALSE
ÅÇ°éó×ñØa÷oºìåê·ÊæköbÃ¦J	FALSE
¶®ºkÒjÉzEîaâébË	FALSE
Xëð2aGÐ2bo	FALSE
ßa¥âíáÞ©ÙØëN¥¥ÅÑ»DbÇ¯8H¦O	FALSE
latÓ27½O¦bí¦	FALSE
öÔabS	FALSE
î½©âJéªabZ	FALSE
Pbæ©i§zshÂNu»RsQa×¿b	FALSE
¦ïU³a¯UYCbX·êFnTæRä¦ª	FALSE
¡£ab­ÚoÛ	FALSE
anbçjG	FALSE
õaAh¹Äbq¬hç	FALSE
£ðµuÛØ²agÄÌOÕ³¼F®b¥xA	FALSE
7ÅHzÁ3wÎuo¤ãaïí®óQFmbtS¿	FALSE
ÆÔèdaÄòb¯CxîQ·V¿	FALSE
£auhbøYç	FALSE
èßäÁMaò®C·QÐoCÔèöo7wèbË	FALSE
RaÙ³·ÒªÍp¾÷4Lb¹e±Í	FALSE
WXÒç¨RoaIKöbÈéU	FALSE
abòHÄÑ÷dÅ	FALSE
6á¢MéÞabf·f874	FALSE
ïÕ¦a7êbÐ	FALSE
aÐq¡÷ÃG1RwðbÈÚYA	FALSE
Uab	FALSE
±»ÇÇîOÄBæÀä¹Ånka­bìÒµÓgUÇ	FALSE
êXWaöØodèbYød°6	FALSE
ac®®§³¦Þw3ØÊ£b¹Ç	FALSE
a¬bÌd½Ö	FALSE
jaÄbVp	FALSE
ÖaLb6Ëg	FALSE
Ea2sb9¾£E	FALSE
æ3a¾bò	FALSE
Ã1aÀï¦øÆqbF³tfæ4zí¡	FALSE
ÒGa´Tµbo	FALSE
¼AEraæqksÕY¬¨½éwßbPÉ	FALSE
ab	FALSE
JîàÜÜbaÈW6ªkõbÝîå	FALSE
QìYÑH½Ñé¸ãqªaRºéOÆ§bÊ	FALSE
tãÙam½ºooÈªrD¡gMâ²Jvb	FALSE
ÞYañÓDiæbS	FALSE
abgo	FALSE
aØbÃñ	FALSE
abXåÆª	FALSE
LaXbÒuI	FALSE
¡da¥tBÜ­hTbpå·	FALSE
ëa°a¹íëbõ8ØÚÏhëÞHóp9x3ßk	FALSE
°ToamnÃëÛs¥ÆkøKbm	FALSE
ïñ1ap8Ü´ºº7òÁR4nñ¦b	FALSE
rkE1á§W¼ÌÀÒÎ7ìºNíÇaõb½	FALSE
a¨ò½ÝÃµ°b³gU«	FALSE
·óOÛMH¡aºÉrËå÷bM	FALSE
WÄ÷aVªµbMÑí	FALSE
aab	FALSE
ab	FALSE
ÎÒåa§±²ÀÚBb°ÐLFãctËÖ	FALSE
«É¿ÑñÇ×a±ÓUîbºù·æ3	FALSE
ag»mÂ¶ÈnbÀ»q	FALSE
¶ôEjâaLË¢ÎFy±zñÜÉKÉÚbä¼5	FALSE
Ûa3Sb	FALSE
ñR6ãh£3ùab°E4µÂäGñí	FALSE
r¿abÞ	FALSE
CÔ¯Vø©aÍbËIb	FALSE
abs	FALSE
aL¦ÁCe£p½ùbb¶	FALSE
®uxëêíßÉWÈ¶aÑµNÄ÷®Ób	FALSE
aÇïbiq	FALSE
WÎaÖbÜôwå	FALSE
abY	FALSE
QìaÅZðb´ô	FALSE
§aLÉÎbÖËµ	FALSE
a´å½OèÃË¸uÝáóböð	FALSE
ºîçÝtËa17ºs´b	FALSE
ab	FALSE
¼aebSmÔbÈ«±x¬1	FALSE
¬aíÀÒbçA¶X6	FALSE
¡êaB«àbÓmi©nn	FALSE
¿§Àk8ØakbHècæåîg÷×ÐE£ÛV	FALSE
¢È¹BíäùRhÄUÇzgíaÐº´b	FALSE
La1¶LÕ¡Tå¼½ÛópUa×¤ub9Rî	FALSE
vFÃ8M£ÍsLl¬ºaw­½eÜ¾Àíì¯b	FALSE
°­pµ£ãCaÍbftÎ¹é¨ªâÛÅ¼õ	FALSE
a4wøvXbî¦b5ðbóAtíº®é	FALSE
ab	FALSE
fí­u¾ê5saðYJÓ8bA·8vÝòç½¢C	FALSE
Qö£aãcPÒVb®Ñ	FALSE
ä9wÓ6¡6ìh²ÍÛ§ã6EU1Öa´b¼	FALSE
8¬M·¸aÉÎÉb	FALSE
ab	FALSE
Äa2bç¸ñ	FALSE
¾·ãä1À³aâ4FbyM±HL	FALSE
ÖBªsÆY´±Yaõ4ÂÖ®ñêb9í©Û	FALSE
1á43ÛçÅwgHaÐWvî¿Ä§gb²K	FALSE
ïÌðdaÞ¥bt¬pÑOp	FALSE
ÍÎN¹F£ab6éêuëD½ugzÔ	FALSE
¹tQavÒQ°¤câÌkbáè	FALSE
×ôHàª½c¶PaãbÚì1	FALSE
£È²«Þjaw§K7bjìQTsëó	FALSE
­nëÉIa6wb	FALSE
ªëcÙÔZaXâ­aWâÖbX6é	FALSE
ab	FALSE
abÜ	FALSE
aKb	FALSE
A³ñ¦H1kaÎHUjP´Uìb·©ÚTë	FALSE
abÔ	FALSE
¦ZD«ab½	FALSE
Eírmn£WÒvjaBfÑÔÒb	FALSE
¸éxÛaÖbW·¦ÜJâ¼¼Y©	FALSE
azJÜÉH8Z1Vïöykåxb	FALSE
aß³AV¬¯¨EbçKHÒV	FALSE
9Ãabøà	FALSE
ÒaÎb»â	FALSE
Õ¹va½bH×ëæ©Òî¦B	FALSE
tÛaôÖb»ÞqÍã	FALSE
KæòanbËcªxIØÈ	FALSE
ø8Ñ°©L¸j¥LÎUaKFºebZ¿z3	FALSE
ïÓÒlaUßÍ4¡mqb°	FALSE
aÙifê¼bN	FALSE
aÓ±JÝ¦bdmRÇ§õ«²¼w7óÈnë	FALSE
ÄöâÞakíØb¼	FALSE
ab	FALSE
ab1E1½	FALSE
a¤ÐóKôbS	FALSE
PÙ5ÀacµeÒçÑEY¤Ùb	FALSE
nHve¼Vta4bpÒ	FALSE
a¡1bàëéÞ°r	FALSE
¼aÑ©ä¯bXw	FALSE
2¨¼1ÇYhV´IöÅRaD«»leãÚbÍQ	FALSE
´ÞâÌåOÁH¸º¹¼¯XÜrJa¦b3I6	FALSE
aebã¡åì¶¡	FALSE
ab	FALSE
M¹CÅÀøa´®bªzb	FALSE
Ð²aè¾pb	FALSE
ÎâaÇ÷®PÑb	FALSE
aabÇàñ	FALSE
ab	FALSE
a×òïbéH	FALSE
a5bd	FALSE
õN¿²¡r¸Ú·sa8§eíOÔ2ÓbÒ¥tã¬	FALSE
ËatRobÈb®	FALSE
aá©Ülsb¼ÉÌÕô	FALSE
¨abxo¦	FALSE
aß÷bÕî§Áð¬ù	FALSE
Xß¼naøb	FALSE
¨Ta±ÖOæ¼ØÔÏ¶V®âã8bÀÌn	FALSE
Î±gnaxIlÃ¦ÅZöBVÏbë7wsÉj	FALSE
¶gÍavåaØÝbPP®no®ÂEyÅé	FALSE
aÕ¬Ðb1ÝÆÂ6	FALSE
¨B£Ñc¥aó²Db¼ö	FALSE
²ì¨U¬Pöab7QÀáÌCh¡éÖbØ	FALSE
ao©Gg6ä¯ÄÇbTè¡TJDÕ	FALSE
abÕ	FALSE
a°è½ÊáêÒÃ¼bz	FALSE
V¿azb´	FALSE
¸OñêÛîíé²£èabb9÷ó	FALSE
a½¹jb®LÈ	FALSE
°Ïô±B£êabQówCém¶³	FALSE
a«b	FALSE
osêó¨TÕßVñ¥fn¸ç8abL6RèD¡è	FALSE
axß´bAÂ	FALSE
LùzYµßÚaJa¹ËÊùbvßzÇ´Ú	FALSE
ab	FALSE
a¯éÏç·Nb	FALSE
¬abóxÌ	FALSE
îáð¬aTÄ5P¢7øbê	FALSE
CaÓvsÒ5bÑÍNÒÈÉ5	FALSE
ÀZabêÂH»º±	FALSE
ãøawb¨¯ã¯òÀ×ÄM7ëñvhd¿ù	FALSE
Q·ÑÕEóòOÚÆiaµbÝ½éQu¯	FALSE
WøVAaæ¬6XÖèÔbbãB6aSKzÄÉðZ	FALSE
ab	FALSE
¸g¶Hhôu±aòÕÌDlYb8±V¥	FALSE
¢DajãÚb7êHøBR¾ö¦¾T¼ÉYR	FALSE
ÔÑZWçaÕbèR5ÒòQÍ	FALSE
±pDaÄòk²GØb	FALSE
¬LóP¡EaøÅ2À¶ÎöIpYbÕÎ	FALSE
ab	FALSE
aØbççSXÈ	FALSE
7¨azT9ÒbÇðwa¿k	FALSE
ôTAabu×GÛ	FALSE
¬aîÅËDæb	FALSE
ÐÄaGbÈpÛvìË	FALSE
Ægo¡¾aEÙÏÌ­øbî¿CàÃP	FALSE
õAaM¯b´ìRnÆJâ	FALSE
qI±ÈBÒabc	FALSE
À7aµtÝ·¯Èwï¢ØB®ç·rÞqÅb	FALSE
¯ÜbCab§bISp©ùs	FALSE
ÑaPb¾	FALSE
CPa³b½	FALSE
¶abæ	FALSE
ab	FALSE
ÌapÇÒ×ÍIb²JÒÌÀh¢¨ÌBç¿è9Ó	FALSE
aÉnYÇäb1¸¦	FALSE
£aµYyB÷s8¨SbxË¨sªËb°	FALSE
Sra¢NÎ¡bcVÇã´±yÏ	FALSE
ab	FALSE
ab	FALSE
º®a¹ébYjxµÓLqc¦·X×èG8ó	FALSE
aveÝÞÊôàl³oå¬íOjb	FALSE
lòaåÖPfb	FALSE
h«»®aov°ÄbÒu×æãì¿	FALSE
È­à®iøñó9a½e®bnÄ9«	FALSE
odabó2ÖÛÚÓççÖ©a	FALSE
Ó´êvaÏw§7Çõb½¹SÝ·O	FALSE
OíW±l4Ëø½Ú¢IíaÌÍ´AZæËbb1È	FALSE
a8bt	FALSE
BñºÈrN¶ùKghÅÄãaÒb	FALSE
è2z¥ÐÂeK¬õ¢xabY÷ï©2´ç	FALSE
¶SepÚ¶aYb¤d	FALSE
§SaÕ¿CD¯ßbSNÀGh¦§ê	FALSE
¾Ö¥aîpmb	FALSE
kôPaMIÉÕï§C9ób29	FALSE
óabÆßÀBöd	FALSE
APab	FALSE
Õa3íyMÞ¹b·GíSÉ	FALSE
ab	FALSE
abÔ´	FALSE
aêùF4t¤ÅHàÄb÷lU¥­5ÆA	FALSE
èaòëzîð¤ÓRt´ßbW¯6àDpãm	FALSE
»naDèá7ºbSk7×Uó¬¹	FALSE
aUb4	FALSE
ab	FALSE
î§ÝµYid¢3áæaÉ£¶bEoR4¸áÅ²	FALSE
ab­	FALSE
añÐDÆÝ¡bÖtªIÅs	FALSE
Úg¢¨cçazlB¡b	FALSE
§øaCÍbpcà¼XOíhP»ÇTNñ÷Ê	FALSE
ß8ÚaµQb	FALSE
óòNaf§ºKbg³¸µðZ	FALSE
ab	FALSE
ab¾ªiwcIÕcH®ßI7ÞBëX	FALSE
ïÛu«åì°âS·ÓwùaÞ»G²Íª¸BÂb	FALSE
ab	FALSE
²Ð³Ïa±ib»søcpNfåZjºmò»ï	FALSE
H¹ÀIaâsÒÇù½÷ÄÝb¶¢îU	FALSE
Pëw¤ð¶×Ø»ÁwAaÞM»°b§	FALSE
ë«ab	FALSE
£¤§£ïÞ¾9ÑË¬ð9haWdbRôS	FALSE
abJ¥	FALSE
ÃE¶a7Ðò¼Bc¡æÀáb	FALSE
ôBÌaææÛcíUÝ®6¨ÅºÅäb45»Ùx¯	FALSE
Ú°Áç©Îagb»u¤	FALSE
c·U7iÌºab	FALSE
×åaâÛÝÓßöäbcR¾RÒÒ¢	FALSE
aubö	FALSE
äa«PÅöbÊ½A¼áa­	FALSE
kaßBåbÂ²	FALSE
aöbWÐG×	FALSE
ùí÷¦«ùanÃ²F°¥bvö­Y	FALSE
¥EXa´ÉEç©bí	FALSE
GÙ©æÆ3gKËaµ°o¤ëkÞbéÝÐ	FALSE
U¾îañpqob£ÒÒgy	FALSE
·a×b	FALSE
ÞîaVäàözZå÷gÖnòbo¸·4	FALSE
Ía§bY	FALSE
ìUSª´ÓÙÊ©aSnWRÒÅNi5¥b	FALSE
DS¹a§Óô¢ÍabvFÝkÚAìÀ	FALSE
aé¦gbgsmXÐ«ê©ñu5¦ÞËy¬§	FALSE
í÷Âß×íìðhÍaÌKqb	FALSE
SW¡IBÀtIaOb5	FALSE
ÔÌ¡­az¶zÈñÁM1Å²b2ÅùµÏ©ðëH	FALSE
Þì¹±oGa¡àîbéíÐ	FALSE
WcCGáõàFßíaÀmbì¾9	FALSE
g²vÄ4aÀÖb«	FALSE
p5aFb¬Ä­¯ãIaÃ¾aÕ	FALSE
G§ÈOõaÊÉOÐ©ÕbÙt	FALSE
¯3akoxbX­¯qw6­ÈHwmfÀä	FALSE
oabà	FALSE
¼M·Kla³µò¬XHDb³9çÙ	FALSE
«UÅîK¨a±W½d¶b	FALSE
7ÔÊ´·auâbªO¸£òRyÍo	FALSE
a«ÑbÄðXSÈà	FALSE
ab	FALSE
aßbQL¾¦ÝØYº	FALSE
ab	FALSE
ÂAZÈìab¡´TQ	FALSE
a¶ðtb	FALSE
°Åa§êUbÆÛY	FALSE
abå	FALSE
sÈrW­ÛîÝóYaæaÙWNmbµ	FALSE
aBCuelbÚVèÖuFÇìï®ééìLqe	FALSE
aãA»b	FALSE
ÞabséIÚd1îb	FALSE
CókPaiXÚubÏ¬IõRg	FALSE
abáÅ»	FALSE
aÖPíhòäÙc®âVæñKXËµabAjIbØ	FALSE
âÚõaëdÄÎijb	FALSE
¼õ¿a¹O´bsq¼áb	FALSE
ÆaÁìb¸N®Ô¨	FALSE
ab8ÛÀ5hrVåÏÌ·rô	FALSE
ËÀØÊaQTøeÉÅnèb¡åÄuB2Ð	FALSE
OXaJì1âzòbät¢	FALSE
t¦¡îÎÛx5aybRÑÈZéWîÞ6íYwv	FALSE
ÌF×¶aJðæbÆéêe7¬	FALSE
öð÷¤ªaÍç¾Ä£´ÅbDP²Ça	FALSE
YaCb¹Áx¶ÀVÒªÎgñQ	FALSE
×Uðmh2£¡6ÌFªyÔaéb¬	FALSE
ÙZ¹bp´1Iåla²ÍÅ§bå	FALSE
a£Ñ§¸mA¿qC3fh3óóÜb®	FALSE
²2®íWK¹aFTËb¨	FALSE
¥ä×¤xézáÃ±UabÕÞpX¤xWNè	FALSE
Maòat9Ü¯÷OÔ8»ð¦ôãqÅ§Pbæ	FALSE
¡eUÉabgRXrK	FALSE
ab	FALSE
P£anÊA¾ømEÎ7Îjb	FALSE
f£2x2áaCµbXuÌáÆwT§o÷	FALSE
WWVêëdGÈõ©ùEÆóaçÕ½bOCZ	FALSE
ÅºHÛMï­°abJÁB	FALSE
aebº	FALSE
aí43÷fb	FALSE
a¡æbêì·ó¹çNøÝXáêp	FALSE
aìbÆ©	FALSE
àB±èa¼Âg¢GµoölbôEã	FALSE
BOiZKØab·ê	FALSE
3rðaÏæfqcubÅ4À	FALSE
dw3ahWt5ObâèõKGeSº×6§¿j×O	FALSE
£RÖaa©ßöqvãÎÎbC7t3xàÙÔ	FALSE
aÙªÅ¦¯bDøèõÐ9íôSuêjsTÀæO	FALSE
waX¢bGTÝîô	FALSE
14xWa×¾séxÛãÍb¯¸9ÎfÆi·Ä	FALSE
L4IV¡lñÜeab	FALSE
æ÷aÏº5b¥	FALSE
Ñ1aÎoXpOË¶íbìÕùÉo½r1q	FALSE
§öa¬áìøbÑÀÕ	FALSE
AaØåÖ6ÚËFOèbP	FALSE
Äa¢âà½é5àEb×	FALSE
§·ô5uiÜaÏÈj9½vÒpa8µOOb¸	FALSE
l4óM·­AHOÌòaººbÇVì¬G×õiR	FALSE
abiÆ4w½¸K	FALSE
éqabwù	FALSE
ËakóUy·C¢ãbC±Ó¨kU³ç	FALSE
¤ÀabÅ¿¾Q	FALSE
Ü¤3gwåRz¢´½a¶¦è»XnB¿H¦¤bé	FALSE
IðLXa8´ïhE²¼Ûªv¾iñbð×CUP	FALSE
aã®EbVöÇöÎ	FALSE
¬hCõaÝwï¾b§8	FALSE
açbÀbö¾y	FALSE
öaT«öbpIÉÎÏðÅDNÛzZ¨Ybëá	FALSE
¿aÊLbt	FALSE
ía»OîÂb	FALSE
avJÂe¥IqV9bÂgr§§Â©»Ôvá»	FALSE
´¶©dQ±±ºðon¨GãCaÖ¨Ûb	FALSE
sÏöab	FALSE
a¢BÔbs	FALSE
ab	FALSE
lèòØag¦Æ¼¶s4«b	FALSE
µAÈØÃJÙ¬ÉóINagb®ªHo×­ÒÈ¤´	FALSE
iâ1a¤bçW¬e³OP	FALSE
aCkàbðµæ¦	FALSE
a5íPb	FALSE
«ÈÓab	FALSE
7XøÕaU°ôBñèK¾baEæE6Ó	FALSE
ab	FALSE
¹ÑåHPDâ¢qâÛZf¨aðÝÒb	FALSE
Q½Éra®VçáÁÛIbz¸Ñ´ÚáJQÒÉA	FALSE
1Cr»ãa2u7JÖb99bHm	FALSE
