ff	TRUE
ebcgbjej	TRUE
hijddgcgafigf	TRUE
jgidjjbb	TRUE
ciajhgggiifgifdjjbaeafcg	TRUE
bgihibije	TRUE
daegdhbffe	TRUE
afidfhjbheihgiafhhgidgdjb	TRUE
ghf	TRUE
dbehhejcjjjhhieh	TRUE
haei	TRUE
fjjchchgbacbaid	TRUE
icdgjejahebbg	TRUE
hjdjgaad	TRUE
aiecffb	TRUE
ieijdbc	TRUE
ghjbaaehbeida	TRUE
jiaagjfjgjgi	TRUE
agdjjgejejbhaihjjb	TRUE
hacecdjaigie	TRUE
ijfghe	TRUE
jjjdg	TRUE
gbaeebediheaigja	TRUE
jbcecfdghijfejgfii	TRUE
bh	TRUE
ffeiaddaeijjabgjbd	TRUE
gceajjg	TRUE
feegejbcfba	TRUE
hhbfihahbdcegdbhgbhgb	TRUE
jfaciacjidbfghj	TRUE
jgjbgicdieeieaieffiahfdi	TRUE
dichbagdjdeacadfhhgiib	TRUE
ichaaf	TRUE
bfgbhbhcgcic	TRUE
gifgfhjhgah	TRUE
difdhghgacacjjhjji	TRUE
cfdffacig	TRUE
afjbacdhifbdgf	TRUE
hj	TRUE
icid	TRUE
gbiicicgafaaf	TRUE
chbghg	TRUE
ac	TRUE
ggg	TRUE
eehghgcjbbhd	TRUE
jjfiacdffaeficgeifjbg	TRUE
ihgdhaaicaeaddgdd	TRUE
fcggghehhjbi	TRUE
jgej	TRUE
ceefdeehjfbcgiijaac	TRUE
eii	TRUE
gddaadjghdfdecaeefejgd	TRUE
jjafdggg	TRUE
cheihhfccac	TRUE
eceajhfbggfbebch	TRUE
fhidbdhbfagfbfhhe	TRUE
ghgce	TRUE
gibhi	TRUE
eedija	TRUE
jabhfegfcbfheeefbfh	TRUE
iedbd	TRUE
eiacgcbiefebgii	TRUE
afeidhfgjbfjd	TRUE
bfdichehfjjegehghb	TRUE
eaefeiabaf	TRUE
dbjided	TRUE
effbaejdjg	TRUE
bdfafgghhidjgfbahgifhjh	TRUE
decgeiifeicaacbgadc	TRUE
jhehccjebjehj	TRUE
ffdgddhdfahadbaageehgi	TRUE
ihbdiedbihcjadgjhdaaihdbh	TRUE
ciiabbjhihjjbhbcj	TRUE
gfiaeegfdehbfjdfjdfa	TRUE
f	TRUE
ccbfgejb	TRUE
aacegeffbjacchejec	TRUE
geehcihahabcefebihighehf	TRUE
dfaihaighhheegbgcegde	TRUE
cbbgfidfcijef	TRUE
iebihiaijgacejhief	TRUE
fjhbjdafh	TRUE
aigabdcjcaagjdje	TRUE
jbjgf	TRUE
ijb	TRUE
gffbjfb	TRUE
ib	TRUE
hcgibccadggifgejjdh	TRUE
cijbagfiee	TRUE
ccjcdjigebibbjebccah	TRUE
fhjjdedb	TRUE
gfbhaefeacjbhcdgceig	TRUE
ccffigdahiid	TRUE
gfgdfjhid	TRUE
dficdacc	TRUE
gahjihgecfdafdiiedgjfgcgj	TRUE
ifb	TRUE
bhhbai	TRUE
gigdhe	TRUE
f	TRUE
cbjgdg	TRUE
biefi	TRUE
hbcgceccbbceibfhgi	TRUE
dfe	TRUE
ehhgfjgg	TRUE
hhifajbidhcfgjgadfcaieaec	TRUE
abigfei	TRUE
ajecbffdj	TRUE
jigheaegiejfcgeaae	TRUE
ggideghdfbhdjjabechafeed	TRUE
djiiiieabejbi	TRUE
gbifihcjijhifbhbbjh	TRUE
a	TRUE
fjdecfbdcadccadcijdbcjd	TRUE
ififgcjhibbibacacejch	TRUE
ajhgjighaeggif	TRUE
ag	TRUE
cidgjbjbifibifcf	TRUE
ejbeccijdahfjieeihjebjg	TRUE
bfcja	TRUE
heg	TRUE
ggcdaacagefhghdcjhjfi	TRUE
ejidghajgfhhfbihiea	TRUE
iefjecibbcbbdejecahfbiijf	TRUE
fhdddbgf	TRUE
jifghhhgdhiiiaghchjdh	TRUE
bbjgjfacc	TRUE
cchhbfiabh	TRUE
aefdibbghcddgcjghihdbgdjb	TRUE
ebehdgac	TRUE
ijiaggbiaia	TRUE
gcegjhcbacj	TRUE
cgcah	TRUE
gggaafadfedjdeigicc	TRUE
fbfajijefjadgidhafegbhj	TRUE
efdfbijbjgjbaaa	TRUE
fjeiifbegdchagcdbfjaajfd	TRUE
geidghdjeddgfh	TRUE
edgce	TRUE
dfbebeaabgicajibbbi	TRUE
h	TRUE
aheedfchafh	TRUE
eahjjfjdgeaafd	TRUE
cjchgjjebbabefhcachji	TRUE
cj	TRUE
gbdbdgjfggfgfhegcgfhca	TRUE
gidgfcihhjfhhefgcadgdc	TRUE
ccfbdchhe	TRUE
hjdgaffhjb	TRUE
dcebjdbaibcegffachjbbf	TRUE
eaaddgfj	TRUE
dgbjdehibaaedfjif	TRUE
jg	TRUE
gichfcchhchebaibaffa	TRUE
ieeihecidjbjjcgbbj	TRUE
gfbjahhgcgeecbghhghhdg	TRUE
hidbhdcacjacgadaehe	TRUE
ibdjg	TRUE
cciadffcfjahigjji	TRUE
ibjf	TRUE
jjhijbbhcddbcjj	TRUE
ijfebgeeddhgceiajdje	TRUE
dbbdedejfjf	TRUE
jfaigebahhcf	TRUE
ihehgcdhdcdbeedfaeigge	TRUE
eihjdjcjjiabcbbegb	TRUE
idjgceecgcach	TRUE
eig	TRUE
cebibhfdeajiihagijcecjia	TRUE
figbfggfaigdhehdi	TRUE
fbcdehdejffaadggdbf	TRUE
cfacegjaifeagbggjdedjcidf	TRUE
cjdjhi	TRUE
hccgghbh	TRUE
cejbfibdifcgfge	TRUE
jejeiccaaehfdi	TRUE
didjcbg	TRUE
fhfbgabdhhaichcieddfcg	TRUE
aibbfccihf	TRUE
gccgeechfihfhbjiidgdhbibe	TRUE
hjcdhfbbdcdfidah	TRUE
hbbcfididdjdgfggjebahgb	TRUE
jhfiddeajfciafdedfbi	TRUE
e	TRUE
f	TRUE
cijhbfeccaebii	TRUE
dcfhjjhfbjcgcgadcaeafafc	TRUE
jjf	TRUE
bdagfhjdejciih	TRUE
igfbacgdahjefhc	TRUE
bbchahcdgb	TRUE
fdicgiagac	TRUE
ghicjghifbgbbcigfhi	TRUE
jfidehfchcagijcgf	TRUE
f	TRUE
cjdc	TRUE
ei	TRUE
eghjfjgfahjhe	TRUE
jefhdhchfabj	TRUE
a	TRUE
chefhdjabebihdhbdiffejdhb	TRUE
gbiicfchbccgbbhi	TRUE
acbacefegffgfbcjjfji	TRUE
d	TRUE
ihcijijbhcfjge	TRUE
iadadci	TRUE
eadga	TRUE
jaed	TRUE
gcfffcbihde	TRUE
eejfjgacdacbfehiffcg	TRUE
ggdchcbahccjffaggajejdiic	TRUE
ddffdediidijaaecfecj	TRUE
hdej	TRUE
agdijgfebccjagiccigjji	TRUE
abfeajgf	TRUE
hegc	TRUE
efcij	TRUE
eeacjdcajajjficajfc	TRUE
dgbjebfgfhhfdei	TRUE
fjccehahifgifhbjegegdifc	TRUE
jbdecb	TRUE
fjbhjcheghiijhicbb	TRUE
eadjhdajfecaehfejcf	TRUE
ahhgh	TRUE
jgbdahbcgdeeeidc	TRUE
ageheifibiafeafbb	TRUE
adfija	TRUE
cffch	TRUE
dfejfiaijciacdej	TRUE
cgeca	TRUE
iiff	TRUE
bee	TRUE
igeacffhihc	TRUE
aiggccccchibcdd	TRUE
bajcah	TRUE
eebidjjjibggcihiajeejeeg	TRUE
egahffidfbicggcjcdfd	TRUE
ihajedijhfddbffdc	TRUE
cddajeiijigfiacejhgge	TRUE
eb	TRUE
dheiah	TRUE
jfhcjefhdijdga	TRUE
cffjbggdiahfh	TRUE
cbhiegg	TRUE
ibdghjihaecdghghiaaccd	TRUE
idebhfijdhfg	TRUE
acgbccdghgfceccfgigdajgf	TRUE
hhdhcecjhbdjgecfhhhade	TRUE
e	TRUE
aaiegahdifdgcif	TRUE
higabdjccghic	TRUE
jjacac	TRUE
ggcfjajieced	TRUE
dfghiebafbgcdgijedaebgdd	TRUE
djhiijbhiajcdjbgefig	TRUE
jjgeeffebfjjbeiagfcffb	TRUE
cgicfdhfehaeaifh	TRUE
df	TRUE
fabibbcdbfejijeedch	TRUE
deigjgihajchcecgc	TRUE
eabdhfaabebbidehhdgdggbhj	TRUE
eiiibdai	TRUE
ha	TRUE
fg	TRUE
jijdegifhbadegc	TRUE
ajhihdfdeeg	TRUE
bdfaaghgdhfbhccji	TRUE
hbddca	TRUE
gijjgcfdafeiggefbejiffhjg	TRUE
bfejibccejhfjj	TRUE
beeghiidb	TRUE
ahebchjcc	TRUE
aicaggfccbiidbeecfjgc	TRUE
fjieggiddjeeaf	TRUE
ideiagg	TRUE
edbbfcifdbig	TRUE
bhihjdhhjcaeffbhhjgdffja	TRUE
ih	TRUE
jjejdeeaajh	TRUE
aicdga	TRUE
chhejghdjahejhddeeffhagj	TRUE
dfghbbgfciidfjgh	TRUE
jfjagcffca	TRUE
bdgefbcf	TRUE
ai	TRUE
bcfaicdciehfch	TRUE
aeiefccaheggjheh	TRUE
ghdibhfcb	TRUE
dijbechehcedbjgbhhahdie	TRUE
agabjheg	TRUE
fbjaffgbhbdcbbjhf	TRUE
gcibfaejadbgdjfhfjbb	TRUE
db	TRUE
jg	TRUE
acbaeehdfgcjc	TRUE
d	TRUE
gcdbbijfjedfabj	TRUE
cfbejfaaafcjeddgdd	TRUE
ecjhbibdhehcfahfbfdjgbec	TRUE
hfbffhbbcgffhcaecdj	TRUE
dhichcfbihaaj	TRUE
bfhgcjcfggdeccgdejddad	TRUE
hchcaf	TRUE
jejhchebjidaaje	TRUE
bfjfiajagdhbf	TRUE
hhafhhbhj	TRUE
hihiege	TRUE
ddibacghbj	TRUE
cdhdghehijhdcg	TRUE
gdfdjecigiicfhcidbbdaig	TRUE
feceedaccbigai	TRUE
gbciichifabiji	TRUE
gihebcgddcajfbfichcbcjhdd	TRUE
jefiabj	TRUE
dejbfihjdcee	TRUE
ejdjhcb	TRUE
gefbabbig	TRUE
ghahgjaee	TRUE
deccfbediddhicdjc	TRUE
ahhjgadbbd	TRUE
jefdahcbhcdgcefijdh	TRUE
behiddhbb	TRUE
ajjbcbigfejccbicfbg	TRUE
gaihfefaeaaacabeg	TRUE
fgaeagjbefgeffeeaceabgj	TRUE
f	TRUE
hcfgfca	TRUE
iecfghcaagaddgjgghgfb	TRUE
bf	TRUE
acffdijaed	TRUE
ibheicidbfjcdhbcef	TRUE
gfcfadecdccddghd	TRUE
ijcjeccaidfgfhjfe	TRUE
gfa	TRUE
jcjjdjjfbhbbdbbdig	TRUE
ihddcfdhicfb	TRUE
fiihbiicijhjabdb	TRUE
hifdfhcdad	TRUE
hcfbacigidfgbgcigdad	TRUE
gjbgdbda	TRUE
ghfcgjgbighfgfhhfhgcbaida	TRUE
iaafbbehbjcbdefhijbeh	TRUE
cdidihfbcjfb	TRUE
jaffhghdigdeig	TRUE
egj	TRUE
bihbfeajccjidideccjfaag	TRUE
hhdih	TRUE
jiggajagedeiafcfgdiafigjd	TRUE
ceebdigdd	TRUE
chj	TRUE
eibheghcajgeehfjciejba	TRUE
ibhc	TRUE
bfg	TRUE
bddciebeidfffdi	TRUE
aibcicj	TRUE
j	TRUE
ggceheeebdg	TRUE
aaebi	TRUE
aaciedghfdeefcbihbjih	TRUE
eecdgdd	TRUE
jejibggijbicbgfcjbcj	TRUE
cfibaigabbfig	TRUE
fhahbffgdiigdaahdiacjja	TRUE
ggbbfaaccdcejaajb	TRUE
ieaaiafgibddhb	TRUE
ddhg	TRUE
idg	TRUE
afhaigbgjifjca	TRUE
dhfffhcdjeeibighbfcabjj	TRUE
hdhdcbdhfdfdgeggehjgifhfg	TRUE
difegdcgehghcheddhejcbb	TRUE
jddfc	TRUE
idjadieheidh	TRUE
ihciedechibhjfjaeffiehdf	TRUE
ighbicjhj	TRUE
bbcb	TRUE
cbjfiedigdhibhffg	TRUE
c	TRUE
jah	TRUE
cihdeibjib	TRUE
cffhajgjdjgbcdgd	TRUE
hjebhfhibejedi	TRUE
beccdigheejbfcfbffa	TRUE
fjageajfhbeiajfjgfiagj	TRUE
cabafejjhffij	TRUE
idihhbfjhgec	TRUE
eccifhbffbdabiag	TRUE
afdghfbbhgjcccefdeefc	TRUE
ieihgjgdjfdd	TRUE
ecejhdffffcdjbdchh	TRUE
bcbicfiebfejbje	TRUE
icgiieaicaaaefiddifegif	TRUE
j	TRUE
a	TRUE
cjb	TRUE
gfijba	TRUE
hg	TRUE
hgfebdjbiddfadgdbjaajah	TRUE
bcfibgjbhcfhhjfhcjajgd	TRUE
hcbaddeajbhjfebgfh	TRUE
chejfjijdhceibaaiefjf	TRUE
adiggadcafgbeihibh	TRUE
bejhicbdjbhbjgegbihicbfg	TRUE
bhjdagbeiaajeec	TRUE
ifhjbhicjgebgbjfhcga	TRUE
hhjeffjaidfc	TRUE
bcejeieibchdjgccgdchechah	TRUE
jfgad	TRUE
jfadeeheih	TRUE
j	TRUE
jchchj	TRUE
aedijaghdjaafhgadhib	TRUE
dhhb	TRUE
biebjfhe	TRUE
cbacdfgedbiaajjcdji	TRUE
dadgchcjhcg	TRUE
dcg	TRUE
ccjcfbjgeghiechg	TRUE
hebeefdegfifjaiiejggfeh	TRUE
gdbddj	TRUE
daedeife	TRUE
jjcjjbhccagcfadeibhfdfcfg	TRUE
beebjdjfdiaif	TRUE
idhchjgjbajgigabafccd	TRUE
efjjbgcicahgdjidefdaj	TRUE
iahbgbjjihf	TRUE
ggfadfihdeaffjafcchchc	TRUE
fffhgffeicfjfafdhifhhbi	TRUE
agfeehjdejh	TRUE
cjcbihhifc	TRUE
adgieiafajh	TRUE
ddgjijegab	TRUE
ggjgecjhdfeiedegbhcijdab	TRUE
icagfcc	TRUE
dbefdcijhdhhihfeaffb	TRUE
cfjeigcgeiffcfhajbb	TRUE
hii	TRUE
i	TRUE
jdcjbfebhijeebhdaigddjc	TRUE
jiac	TRUE
efigfbhbfaehdhhgjeeg	TRUE
dfbj	TRUE
biibcbbeb	TRUE
eiac	TRUE
hafi	TRUE
bj	TRUE
cfhadjghgfjeaibagddhgdb	TRUE
hgahidaacibdj	TRUE
fjgjghcehigcbegfjidchg	TRUE
j	TRUE
ggaa	TRUE
hadfdjdda	TRUE
cfgafgegdhf	TRUE
dgcigcgagbah	TRUE
ggeceffbicjcj	TRUE
dcchfcd	TRUE
dcgcdh	TRUE
iaicgdiebdfajaebfehedhie	TRUE
ifbecdhjgehcbaca	TRUE
iicabbjbijjbefgbegfeh	TRUE
ijhiecegfciheejfjfddbeh	TRUE
ehghhhdcahagdiidhaec	TRUE
cgfdbda	TRUE
ggfaeiha	TRUE
hghejfbjdggaadd	TRUE
cbfgfhgbighdhebhhhibea	TRUE
hgjchaicbadgajf	TRUE
dbfdijghccccdehae	TRUE
fhbejifjjfjieef	TRUE
cffeecghgicijfbbaehab	TRUE
ceidiffbfhidjdegga	TRUE
adegf	TRUE
jcdgacfeadcegifa	TRUE
begfecdag	TRUE
cjiggcfadddajcffcfja	TRUE
jfddjgghajd	TRUE
fhhhdiadhibgicbfjgdeehgi	TRUE
d	TRUE
hbbcegejddhiabbheeiii	TRUE
gfbbchhjhhcbhaeddgbhdjafh	TRUE
ede	TRUE
ijhafegjcgcicgihcddgaij	TRUE
cihhfaafcbjeggjhge	TRUE
dcijihhgadbaaj	TRUE
ajfagcbjcecdeibfg	TRUE
jbjahgdiecaihcg	TRUE
iagbachaaficafaehdbic	TRUE
fjhiddedag	TRUE
ebacdgdjfb	TRUE
aeihhfabaagabbjb	TRUE
ggffjeahafd	TRUE
chgihhhfcbjdjhfih	TRUE
efabiad	TRUE
bideifhcdef	TRUE
aeef	TRUE
dfib	TRUE
diegdgiigbdidcbgijbcijef	TRUE
hbcbgdejj	TRUE
bffajijdefcj	TRUE
jeiedheaiibjajfhchfhibdbi	TRUE
ahibbgbidihdbadahef	FALSE
abebeafda	FALSE
abba	FALSE
abjhbfhdgcfea	FALSE
bijjabibajgafccdh	FALSE
dhabifijgddjiibbaga	FALSE
jdbgiebaabfcbda	FALSE
afgffcbcbdhbaajfgde	FALSE
dhdceajabghibabi	FALSE
ibdciedhefceabedidabca	FALSE
abebdifac	FALSE
adbbja	FALSE
jdagbafdbac	FALSE
biahbaabfjcba	FALSE
jciffabebcfaehgd	FALSE
dagjdhjbejbfihabhibidf	FALSE
abihgbaaif	FALSE
fabbaf	FALSE
ajafffbbba	FALSE
afbgba	FALSE
ehiieeabbadgedajhgij	FALSE
iiaibgfcjhbaeajgc	FALSE
bicidabbhaa	FALSE
ajfbbbaadbagbgedaehjhjcba	FALSE
hfdbfcegjhiiabebeaafbhgj	FALSE
abba	FALSE
febjedebgbbabedadeebbaj	FALSE
iabbdaebd	FALSE
bcfgabfjgcabbah	FALSE
hbdabdihebadf	FALSE
ideidhdaebdbfeaa	FALSE
aaafchibdabddba	FALSE
adjhcgbiidghbdca	FALSE
abba	FALSE
eiacficjbcbafbeagab	FALSE
bajbbacc	FALSE
jagggabdbbeeieaddidifhfjc	FALSE
aaeeedbiiibbfeaddjiace	FALSE
jjigdddaffjbfeifbfebabai	FALSE
abbaicbe	FALSE
geajebbafbfdcadabggi	FALSE
hajffcdcabbhjecbebdaja	FALSE
eaihbbicah	FALSE
cabba	FALSE
abbfca	FALSE
abba	FALSE
abdbfa	FALSE
hafhfbbhhba	FALSE
ajdecfbbbabaggie	FALSE
abbba	FALSE
hdaagajefcbjhbbga	FALSE
abbghad	FALSE
gghjdcidajiicibhhhbdadiji	FALSE
eagbhibjaebadae	FALSE
jajbhgbgebgaicedjibdgh	FALSE
aajgbegbeiifhbcaaaigcifch	FALSE
abbia	FALSE
jaagabedhjihjiabdbad	FALSE
cbjeagjdibbabibgaabji	FALSE
hajehgijiaefbabfedicbadj	FALSE
heieiacabcbadficaefbededd	FALSE
aibgcgbdjfffjeada	FALSE
djijdcaahbbejaa	FALSE
jifgbaabba	FALSE
chebcccafibbagcjc	FALSE
jeabcfccgiafghhjbiafjj	FALSE
aebhbda	FALSE
gjadbjbabbahbdaijehbegbf	FALSE
abba	FALSE
aibbaj	FALSE
jbgaafacejdfbjhbjafej	FALSE
abbjadi	FALSE
babjbdag	FALSE
geagdbbbdaebbfhgad	FALSE
dadcebbah	FALSE
afcfbgba	FALSE
dafdbfbjeaaiafdb	FALSE
cachcbgadhhcaedaebadddj	FALSE
fagiiaicaabaefbbgfbeagh	FALSE
hadcdhgaabedbaehgbaa	FALSE
adidaifbacgbfbbhbaaec	FALSE
jbjaifjgibhbjbaag	FALSE
abbjag	FALSE
gjihababahcefahiif	FALSE
dbijebcaajbbebhecfaji	FALSE
aadbbba	FALSE
abbaceggfbaa	FALSE
ajabbhhdigccjgcibhjaehcaj	FALSE
aaccfbafjcjgjjiaabbhdaii	FALSE
fjabbbbaha	FALSE
gajdeggebjhfabfidghecha	FALSE
ccaiejcbebajigieagf	FALSE
aiachjhfgbebjbhagbciebdac	FALSE
jfajabhbbcbbcijagdb	FALSE
aaghgbgejahhbbihedhadfe	FALSE
hdaacbddbfcdeafb	FALSE
abbaebaababghdajjj	FALSE
gabbaj	FALSE
fjhfjabcfbiaibaha	FALSE
abbgfghjbjagciiffchejih	FALSE
ceeabhabbhghajbicciabff	FALSE
hbabihddbaibdhjaded	FALSE
adahbfcbgdabbcbe	FALSE
dfcaibbigacfjah	FALSE
bahjhajbhbiihddfaijajiibi	FALSE
ghbfgaebbbdbifejahdah	FALSE
abfbbbbaga	FALSE
eaaaebbbjhiefaaejf	FALSE
fhfabeba	FALSE
djgabba	FALSE
gfdhabfbggaad	FALSE
ajbbbagf	FALSE
cbfebeagbegbaaj	FALSE
jaabebdahagie	FALSE
agbbegbdeahj	FALSE
bgabifghhibjachdbihegbia	FALSE
adfbicbjdefegbeachi	FALSE
faejffdbbacgja	FALSE
jcajejidaicbba	FALSE
gciaggibbaejicdacd	FALSE
jahahcbbeaaah	FALSE
abbabj	FALSE
feababbjaaa	FALSE
iabbeahbdfea	FALSE
abbaa	FALSE
agbba	FALSE
eeabbha	FALSE
ghcjgfahbegbifbihafebaa	FALSE
heiaabba	FALSE
cjddhcfagfbbba	FALSE
gfdegaabjcbbiadfijfc	FALSE
abbaa	FALSE
giaejcbjbfbedigdbabgeefa	FALSE
aadhijbbidaddhbechaig	FALSE
abebha	FALSE
cidjbadbjbha	FALSE
jfaidgchfbbaahce	FALSE
jadbjbfjga	FALSE
daceabbagjgadigc	FALSE
aibba	FALSE
djdabedebaeegf	FALSE
abafegdbbehgbia	FALSE
bahbijhaebeea	FALSE
aabgihbca	FALSE
faaagaejbjbbaea	FALSE
iachajaiibbiffibgjihaa	FALSE
afcicgejbbab	FALSE
igeagcbbdbadefgdaafia	FALSE
ibahbibaijcca	FALSE
dafdbjcbbaae	FALSE
acbbbbiaa	FALSE
abbag	FALSE
abbaec	FALSE
cbafgbcaafibajgefi	FALSE
abfba	FALSE
egabdefcdbdgchbaeiaj	FALSE
acbdebjceba	FALSE
hdaibgbbdage	FALSE
afhadfafbbagebaicjj	FALSE
agjbfbdaj	FALSE
abbfddicdeedgiiaaa	FALSE
cbafbbga	FALSE
agchbebihabe	FALSE
caacjjebiaibjiha	FALSE
aeahbjhghhibebaha	FALSE
jabidbjaebi	FALSE
dhadebjbdah	FALSE
abba	FALSE
dabihbgjebfa	FALSE
ebahabicibejgaibhifha	FALSE
abbgaide	FALSE
abhbac	FALSE
ahhfcbbac	FALSE
abba	FALSE
ihbeajbjgbeehadhfddd	FALSE
fejheaijbacdjdbfbcbafefaa	FALSE
gachbbbaabbbaceec	FALSE
abhbfad	FALSE
fgffeabgijbjdhidddfccajc	FALSE
ajfbihcjibaebgjcagdc	FALSE
babbba	FALSE
ceagdafabfagbbcjiidaegade	FALSE
hibeabdbabgba	FALSE
hiabaaedibcfhefccgbhae	FALSE
jahbjbaafiahfcjjefeacf	FALSE
aabeba	FALSE
abbda	FALSE
dabjhabaejadc	FALSE
cabigba	FALSE
ahbabbbbfjadh	FALSE
abbjababd	FALSE
jhafecbaijdcbgieaagibhed	FALSE
ajggcbaabdhghifbdaebga	FALSE
jihaiibbecbaaahj	FALSE
aabbghac	FALSE
ahbba	FALSE
hababbbcfhba	FALSE
ebhfdcabddcbihhah	FALSE
cefaefcjbgbhcbafgd	FALSE
aeabbag	FALSE
jgaaahbjjfhbcdjhbdahhbha	FALSE
dabdba	FALSE
aaadbgdfbfac	FALSE
abeba	FALSE
aajbgeaabegjaadcgbeagdb	FALSE
gafijcbba	FALSE
ahbcdjaacdifgaffhabfdabd	FALSE
cfcabifjgbhebaiba	FALSE
gdhcaeajjeahdbbaiiaegeb	FALSE
fajfbffbdhaecac	FALSE
ajdbdfadbaihib	FALSE
dafeccaaeagigbebcbdadidd	FALSE
fabba	FALSE
afbgbegeghhdbdgabajhge	FALSE
ahjejbcbcedba	FALSE
efabjehbjgeggadbajhg	FALSE
egaifbebagd	FALSE
ihcjabba	FALSE
agbagbdca	FALSE
abba	FALSE
fifdbaaceabcbfjdcebaheb	FALSE
bfcfgdabgbbcfabgiga	FALSE
abfba	FALSE
abba	FALSE
dcdjacgiahabbaeddfacedh	FALSE
gbagbbhdjfcbhgibajjahb	FALSE
abajbjebaac	FALSE
addbabhbjiaicdc	FALSE
abbadgj	FALSE
ddcdbidafbhcadbfbabiaaijf	FALSE
hgaheihbbbadccjijhhchh	FALSE
abibeae	FALSE
agabbgaa	FALSE
dgabcbcjghbfigaieijjagi	FALSE
dhcagacghcfafdfgibbgebfa	FALSE
eajfbeabdigcajcbbeca	FALSE
eaghaejbbfbfbcabacjgac	FALSE
ifdfgjdhaaijcbbajaea	FALSE
gaeijbbaafa	FALSE
eeadajbbegeebbdfaabg	FALSE
gabihacgbgbfai	FALSE
aebgjbifbajhca	FALSE
bggjabbbagj	FALSE
bebabgaabba	FALSE
jaaeehcbecbjcbjefdba	FALSE
aagabbhccijiififdicbafdj	FALSE
cbabgchacebcbegaih	FALSE
abbdfea	FALSE
bageggeabbcbai	FALSE
bjadbgbad	FALSE
gabhbgga	FALSE
habbfgfeegeaafbffagfgb	FALSE
jehfaabbjebhahehaffbhefba	FALSE
abbachfcjebjigacidjc	FALSE
abdaabchjhbjbacbcbija	FALSE
gacafgdhgddadjfebbba	FALSE
iaedicabhdehjejibgbbjgjba	FALSE
ahibfbcjabgih	FALSE
cdgaiabbcjfgeebda	FALSE
cagccbbebacdad	FALSE
jabhbdaaaechbdifaj	FALSE
abgefhebbbeecaadbdfihje	FALSE
afebibjfgdbjja	FALSE
jagebbedba	FALSE
ffbeaiaibbagba	FALSE
abbahgb	FALSE
edaieadhdgcbbbfafa	FALSE
iabfcbcdbba	FALSE
ieahijbadbia	FALSE
agjbhbfad	FALSE
abbgbfba	FALSE
cejhaafabaeahbciieacaei	FALSE
ghdciefeeaijahbdebegfa	FALSE
aabdcgbcdeagdacih	FALSE
abbabicafhdjciha	FALSE
cbahabbcbjicdcbdigda	FALSE
abcbai	FALSE
fgbgabbjahjefcigbahhg	FALSE
daibbai	FALSE
ejagbbdbjbbaadieajf	FALSE
gebgjdjjahdabibbbaadg	FALSE
abba	FALSE
igjabjfdbddbagbbac	FALSE
cigajfbjajbacbiihjf	FALSE
hbefacbabah	FALSE
dficaadaicfgbjghefbgaag	FALSE
dabehbebgdda	FALSE
aeibbdahadbi	FALSE
ejegahbcjjdageibbbaa	FALSE
abfibbbfabjj	FALSE
iacfacjjcgihhebbiebaj	FALSE
abbbadgjegdagddjgfacd	FALSE
abba	FALSE
jajcabbagababhe	FALSE
eahbdbjca	FALSE
abbea	FALSE
abdhdbcifiddbiaec	FALSE
abiiba	FALSE
jehabgabdfagadcb	FALSE
chabebcajaia	FALSE
aacbdhiebbigajcggjagjfbi	FALSE
abeebabjf	FALSE
cgiabbbfaca	FALSE
gbhbachcaejdghaabbhegaej	FALSE
ahbdbceiagbffiijae	FALSE
iajhebhgiahefba	FALSE
dggabbddgdehaig	FALSE
abba	FALSE
aebdjjcgcbdjaf	FALSE
ahifjcefbeiabbjghbcda	FALSE
ehabdbdbdfhabeef	FALSE
abbba	FALSE
eabajbajaedc	FALSE
iabhbbcaab	FALSE
abba	FALSE
eaafbcbceaf	FALSE
adbchccjhbfafib	FALSE
iahgbgebhcbgebadeaabjhei	FALSE
fcdhjaeabbeaadj	FALSE
gagebbjcea	FALSE
iaiiaeacccefggbiebagfcf	FALSE
abba	FALSE
gababbdagiahhdah	FALSE
gjdjaiaaegdbibggahibia	FALSE
caecbceeaiafjbedah	FALSE
igabjbafbabgghhbchab	FALSE
abaidbdba	FALSE
iejbaffgbjccbigea	FALSE
idaighbdefbdca	FALSE
eacfgacbbebbagbai	FALSE
abba	FALSE
edajbgbaa	FALSE
iabibba	FALSE
bdabafhbgfbgjajhhhhdeh	FALSE
iaejggbbah	FALSE
abba	FALSE
efgebafjgbbijabe	FALSE
abibicdbfga	FALSE
cbgaigbjcbbiafjf	FALSE
afbifgibajfba	FALSE
abbjacbghbbehechcba	FALSE
aabhbaa	FALSE
idadeibbbbgjbdadcfeib	FALSE
cchbadjadcbeba	FALSE
habcbadgjhjaehb	FALSE
cachbbaffa	FALSE
gjabibbbbeeiaiigjj	FALSE
ahadgigbbaiejjgfejgiadbhf	FALSE
jagdfdbbdbjca	FALSE
bahbbfhgibajdhbjaah	FALSE
abbabdfb	FALSE
jhfahhbjhefhcibdedabai	FALSE
biabdjgbedbbejbaif	FALSE
ehabcbdadh	FALSE
bajefghfdfbbfidaif	FALSE
idbabbdhegbbca	FALSE
fifabbhdehjabddf	FALSE
habeba	FALSE
acbafebbbdfddaaa	FALSE
aajgdcbfbbdgidhjag	FALSE
abbaib	FALSE
dabba	FALSE
jbjjhggajadbbbhgada	FALSE
aebbihbeia	FALSE
adabgbeaeccfd	FALSE
abjbcia	FALSE
caabgcbah	FALSE
afbba	FALSE
habidjecbgbhdeihhbbdcdbca	FALSE
ieahbbgbahajecfjibigb	FALSE
abbea	FALSE
baaedgcdicjhbefibcfa	FALSE
jfaahgbjdhibfbebeab	FALSE
ggjdabbibaa	FALSE
deeagibbcidfeijaa	FALSE
ehaibbfjaadecj	FALSE
dfjcjcaajcbgdcibebahe	FALSE
abejbeidgfhfddejegafb	FALSE
haebbbbgafdg	FALSE
abagibbgebahca	FALSE
abba	FALSE
fifaaebba	FALSE
ejhcahdibbbfaee	FALSE
ffgabcbafa	FALSE
dhaajebdhdbfbfcca	FALSE
abgbagaj	FALSE
aaeahfaabfagdbahdcbaccdcj	FALSE
afgdafbhchcbab	FALSE
gabiiba	FALSE
iafabjcgbhai	FALSE
abba	FALSE
afidffhcabjbhgdbbagi	FALSE
abbibag	FALSE
abddbgadif	FALSE
fgiacaebbgcfhbcacdafgcbc	FALSE
egejgabdcbbihaeiaiddaehhf	FALSE
fabhbda	FALSE
ajedabgabhebcgaaccfefgjdc	FALSE
iiadbfibja	FALSE
agbdbbajhg	FALSE
cjifjbabejbah	FALSE
cbbcfeaibebafa	FALSE
abbfiihbagdgaje	FALSE
acbiibba	FALSE
ecbabfgba	FALSE
jgabba	FALSE
hihabbjbcghcbiaai	FALSE
djajdcbbefbhcaiidd	FALSE
fjhajihjebbcaceha	FALSE
baabjhbajb	FALSE
abba	FALSE
bebjfjjagjabdbggbdebcag	FALSE
caaechhdaebbaiggjdb	FALSE
acbhjbbaffdgeb	FALSE
jagabbia	FALSE
fabfajgbfbjiehdjajcahh	FALSE
jeaefcedbafgcedcbbiaihdg	FALSE
ajabheagebbiaiehefgjeghdf	FALSE
abjbbcah	FALSE
ghacfbgbhbjga	FALSE
abeffbdhdeaaaec	FALSE
acgjbbghaaeff	FALSE
abcba	FALSE
ehaiiadgbjbdhgdabichdgfha	FALSE
jaegebbbffbad	FALSE
chacgjcbifjhhbfhagi	FALSE
bgibhdaijbdefgabafj	FALSE
eabaheefba	FALSE
aagebaafihjbbbeahh	FALSE
ebajcbbbfjbdgejafjjhfadj	FALSE
ibadgbfbaaie	FALSE
hecafeabahebhagaaebde	FALSE
abba	FALSE
baggabcbeea	FALSE
affbbaacjah	FALSE
dcbaibbigahhafieeacda	FALSE
bbfhhcbgajhihcajbibbbha	FALSE
eaabjfidiebebicjjha	FALSE
fjajbbga	FALSE
aeajciaehfabgjbhabgjefh	FALSE
