hhgdajiihfcegjfbiiafc	TRUE
haiiajdjfg	TRUE
aidbgbcgj	TRUE
agcdba	TRUE
gagea	TRUE
iff	TRUE
dahaddcigbfhggacfiigeb	TRUE
gfhehc	TRUE
dgjjhded	TRUE
djbigacdjacdbeefe	TRUE
bbgicbiciigjebdehddaaf	TRUE
jgbegbeihiiahjjeebfg	TRUE
ggaieejiafg	TRUE
ibacig	TRUE
bfd	TRUE
dgeebaajficjjfdcebejeibf	TRUE
icdjggaahfiegdejhfceagda	TRUE
chhaddgifiajfgihidjdbaj	TRUE
ccccicaiejf	TRUE
hhegjcfhceaddajggb	TRUE
gdbg	TRUE
g	TRUE
idchaccfg	TRUE
jbghgaj	TRUE
ejdifeccfjjaeidjab	TRUE
fdjbgcaabdbfgjggi	TRUE
jcidhbgdggdffdfhd	TRUE
cijaccajgdjj	TRUE
gde	TRUE
fdjbbfbbddfjbdggdgcf	TRUE
bjhccfdhebfjjghahg	TRUE
eefbeahaijhbebjbbfeabedi	TRUE
ibicbcgdgjgjhibcje	TRUE
bceabcecdbgagaddddh	TRUE
jhd	TRUE
ajjjfbddd	TRUE
eabagahfbdigjjgdhccc	TRUE
gdcbieigjiehafbcfedabgjj	TRUE
ghcbajijagiachbdggb	TRUE
ihcbhedg	TRUE
ehhbbece	TRUE
hfhfajaaiabgdjiihdbd	TRUE
egiaifiajeh	TRUE
icacbhbfc	TRUE
abefjdg	TRUE
hhcbejadgjfdjddff	TRUE
ccajijfiafjjgjjcc	TRUE
ecbbghbghfeaehiab	TRUE
gdbccjbedjf	TRUE
deaaidccajhgjjbe	TRUE
hdjibfhjjfhgigc	TRUE
cddhacjddd	TRUE
bah	TRUE
bddgbebah	TRUE
djebagbie	TRUE
g	TRUE
eedbg	TRUE
iahgjaiajbaefe	TRUE
cfcdfjhahfgffhhdcafbfgjfa	TRUE
cbedbgichffbhabd	TRUE
fad	TRUE
hchafefddfcgbhe	TRUE
icafffaa	TRUE
fjhdffcfjdfgjdehdceaih	TRUE
ihibdidbhjajbhf	TRUE
eacbjdcaffdcgcbdhejca	TRUE
bdhiecjfhc	TRUE
cdddibdadif	TRUE
gjcbc	TRUE
ebcdchfcacefjdeegejhbcbbi	TRUE
eecajahjfdhcjegjgijaf	TRUE
i	TRUE
icabdbbebejbccfdjajdicecj	TRUE
d	TRUE
jehg	TRUE
bgeff	TRUE
heiggcegiff	TRUE
dega	TRUE
abgifejeifhdehicfh	TRUE
hdfigadefhchacaii	TRUE
ejcggjh	TRUE
hejgcjcijeejfdeafgghahgh	TRUE
cgdjejig	TRUE
degejggifcfehbecjffhjbeaa	TRUE
bjfgchadffcf	TRUE
cafhdehchbfbachddidje	TRUE
hgdhgcbgbhjhdhjejfgcfg	TRUE
ghafgidbjafbafejgcgddicj	TRUE
bcfhiaa	TRUE
cgjhddgffedecegegig	TRUE
ge	TRUE
gidcb	TRUE
iehbbibahiaaaaf	TRUE
ga	TRUE
diccgcfcjedh	TRUE
egcbhcbdchbejaef	TRUE
ggjbfh	TRUE
gajhhgeeabijgdebdbbfcbj	TRUE
bbaggbafgfdcbfjdicdij	TRUE
jdfddbdegfebce	TRUE
gggdicdcbhjfida	TRUE
gabgbgggfeceahihabfj	TRUE
cejhhffjg	TRUE
ijbbjcd	TRUE
hfhfgffhifcggibabbgccc	TRUE
ffcgggjfedgjajibiagd	TRUE
eg	TRUE
biajafgdadgadhjabgfjj	TRUE
ffiadieiihbacfjjdgbjg	TRUE
id	TRUE
chbcjdcgahbfjjebeihgadf	TRUE
j	TRUE
abeej	TRUE
hehccdbbdjbiabfcgja	TRUE
hb	TRUE
ahhdeaciiajadbjgefcc	TRUE
ffadgfgciaibcj	TRUE
bajhgjchhafbbeedjaiaieacb	TRUE
afdhjbdafbec	TRUE
bhac	TRUE
dca	TRUE
abjbdbfcdbhbggjbifahiae	TRUE
gcbb	TRUE
edhihcfdfi	TRUE
fdegghecgfdcbj	TRUE
ccdegejigcecji	TRUE
cbgdgddjajbh	TRUE
jjaheicagjeifbdeiej	TRUE
bfdgbjheeeddddjcb	TRUE
gh	TRUE
fjgibgjghihih	TRUE
hjbhgg	TRUE
cchfgahdedeffhhggcee	TRUE
hhcefgfjdfcjhheabi	TRUE
ffhci	TRUE
dhbcfejidegfbbdhcbafgjbdc	TRUE
abhchgdbbghgebacbfja	TRUE
cdhci	TRUE
hjfhfcbfjcjg	TRUE
eggcdgghc	TRUE
igfagdeebcijbeafhghgghh	TRUE
adhcefe	TRUE
eddgigccdidbbe	TRUE
a	TRUE
ecabcidgajebidbcdhi	TRUE
bgbcgcjgdbigeffaf	TRUE
fiaeciedcaibjfda	TRUE
bdcebjahcddjcd	TRUE
b	TRUE
feidibeeb	TRUE
ahffeibcic	TRUE
je	TRUE
agajghejbjfjcjgig	TRUE
bigafjhbid	TRUE
hebehfhjfibecaag	TRUE
chfcebdijhh	TRUE
cdjhejca	TRUE
fjaejbcjijddgcchaag	TRUE
jcedbffjfihbaddhaij	TRUE
bghchcddbbjgbibhgfbhh	TRUE
ejfb	TRUE
hgdc	TRUE
jeafccaddfejbfdcjafghcieg	TRUE
hbhdgfeacf	TRUE
ahcjjbajgfii	TRUE
ai	TRUE
bbcicfijdghfjhcdejbicdbbj	TRUE
aebhiedjhabjjcffjjhcbj	TRUE
eadfjcjhf	TRUE
bdgjecic	TRUE
ghdehchieeijjaeiejejacd	TRUE
abjaadghdiihcgbihbjacg	TRUE
ccee	TRUE
ibjdejaaagebgafhag	TRUE
ifh	TRUE
fdffcfjcidhhijgcbecidd	TRUE
icbfdihdiejabhbhiac	TRUE
iiabagbicjdeafgideida	TRUE
ajdaegjiffdghbffgjg	TRUE
hb	TRUE
eaadjdajcdcbibggheheda	TRUE
faefjij	TRUE
fefefjjaadgddiadcf	TRUE
bedbf	TRUE
bdgfcgiedidbfcegidei	TRUE
heffahejhe	TRUE
cifd	TRUE
hfficacfjiibjeg	TRUE
ccabjjdhc	TRUE
jgigefaabih	TRUE
g	TRUE
aicb	TRUE
hciagbbgddcjjahj	TRUE
hai	TRUE
idegechcgjbcechh	TRUE
fedihgc	TRUE
afeeahdjaihjaafaeddhcgcd	TRUE
bhihfbiejhd	TRUE
ijifcc	TRUE
fhjfffbfgajjaibcagfj	TRUE
fjgfgahdebdgcj	TRUE
ifaedaaaggccjhijbbdbaie	TRUE
jcfdgeegficbfj	TRUE
jacgbfjeiihga	TRUE
jjcadiahdjbbjhjgd	TRUE
iaifhba	TRUE
jh	TRUE
gdfegbgdagdhgcgjcghg	TRUE
gchgdabcehha	TRUE
i	TRUE
jddgiaefbidffbaaiahcd	TRUE
ddbebhbjfcdejda	TRUE
aagcfb	TRUE
cjhgdhfhijahijcief	TRUE
biaefdcijdahjdfffigfchb	TRUE
cbd	TRUE
fhb	TRUE
fdfgbjdifbf	TRUE
gcgibbjhhbd	TRUE
adihhe	TRUE
dddcdbjhibgeafb	TRUE
hbfjifjicddgj	TRUE
hdfeaagjch	TRUE
bihacebccebfggbai	TRUE
cacihjegddffahcajgihc	TRUE
ggbbdfhibbjfcbhcifedajii	TRUE
fbbajed	TRUE
b	TRUE
cceaachbfgbgdiejcafchb	TRUE
hjabjgfaehgagiich	TRUE
jb	TRUE
adcbajeiaeijbaeahadegjhh	TRUE
ade	TRUE
ibhhiabjhhgcbfadgahea	TRUE
ea	TRUE
dgcfhcejfbbgaebcfhbga	TRUE
bjhccbfgbfacaehb	TRUE
fdajh	TRUE
fadfhjg	TRUE
cfgiecfdcbgfebhgfcibe	TRUE
chfedgeiebgbhbg	TRUE
egdjadidaiidjehj	TRUE
aijcfeghebdbjg	TRUE
cgg	TRUE
ijdcagffjjfehhjcgafeeb	TRUE
bgghedcfajajbhdhgidjde	TRUE
fheiideccigdei	TRUE
jbce	TRUE
aicjfeeaaejc	TRUE
cbcihgb	TRUE
gbicdefde	TRUE
ffciebfhdeddbcj	TRUE
edgehgcbaahhgdccjgjaid	TRUE
fejhacgdeej	TRUE
gcdghfabigbaefigjbjchdf	TRUE
acfeccgdadjhcbhc	TRUE
i	TRUE
eehicfij	TRUE
jfe	TRUE
gbiadccadgjbgdjbfejabgc	TRUE
jjgajicgefdciafjfiihajdhf	TRUE
jdgbh	TRUE
igjdhfjegecfifgeab	TRUE
ihhaecdaejaefje	TRUE
jggajeedieh	TRUE
igafdbcd	TRUE
aabdbbehjajjagegjjbcgahe	TRUE
bjbb	TRUE
eajfiahbhhgjai	TRUE
biibdadfae	TRUE
ihabgaiagbeciaiceddaagibb	TRUE
iadbaecefh	TRUE
ei	TRUE
cdcjgia	TRUE
hcddddgejhbbi	TRUE
aadjbhcb	TRUE
hgabebhhejgejbfbgiad	TRUE
jgaeechejdhcbcjhaad	TRUE
djjehc	TRUE
agfbjehbgjaajjgaggiagheh	TRUE
ahcgccdje	TRUE
bciiichcbjhd	TRUE
ijd	TRUE
ceccejbj	TRUE
bjbghfbhfabed	TRUE
dacdachbjjaihjjga	TRUE
hedaidebdgg	TRUE
icbdhbhff	TRUE
ehehjibgad	TRUE
agjbediejhfdb	TRUE
gd	TRUE
jiihbgb	TRUE
fcbcgbcgd	TRUE
chdhca	TRUE
faefjjiajcdief	TRUE
eahbhhaei	TRUE
hjgdfbgdgjdad	TRUE
ffadjd	TRUE
jabjjg	TRUE
fjeefdfiaiagffhajbccfeai	TRUE
feajdgbegahd	TRUE
jah	TRUE
addbbidbdgceaaeccdbbbgai	TRUE
iefb	TRUE
ijaagiajefbjheccfcgjdhdd	TRUE
gbjiechh	TRUE
bdcihaicagdgh	TRUE
fdghdfiaeicfjjdhjcjg	TRUE
ghfjebjaheag	TRUE
hedecffcjgc	TRUE
jdeajfaaejghchjcchcgeid	TRUE
diheaeehgb	TRUE
jh	TRUE
dhbaecjbjijadg	TRUE
hffghbeagfcceefgcdb	TRUE
cibjjegccejjedf	TRUE
f	TRUE
cjgedjijdfacejig	TRUE
fgchfecg	TRUE
cghejbgfjj	TRUE
ceigjbjfdifai	TRUE
aebcaeaafejieadbjehfeif	TRUE
hihhgb	TRUE
gafha	TRUE
bajjafae	TRUE
ccecjegchacbjde	TRUE
cfifgegfdecd	TRUE
geahiidjaaeiajfhid	TRUE
jhdbiechii	TRUE
hfbeeefcbdhcfghd	TRUE
fcfhbjfecd	TRUE
acadajah	TRUE
caidcbhccegeb	TRUE
jfjhdigi	TRUE
jfffhgjibbeab	TRUE
fcjgeijdgicfh	TRUE
h	TRUE
djfeeccifiicid	TRUE
jfcheffbacbhebiadbfgac	TRUE
bjbijgibhdgjiggfajefggje	TRUE
ijfbfcjadacifbjadciba	TRUE
ejebfahddbjjb	TRUE
jhfdchaddegi	TRUE
gadjdegaibigdhbf	TRUE
jhbbhgifbdajadcfcdhffi	TRUE
jhaehhbafjddjd	TRUE
bihhjfb	TRUE
jicebajfhicchfhbjf	TRUE
eggdgfhcaaihcddgiighbc	TRUE
igaegja	TRUE
fgj	TRUE
cfjc	TRUE
adifbcafggjhhfhjefccbdie	TRUE
acfbjhaedjhdhhbdaf	TRUE
gadihg	TRUE
ejag	TRUE
hj	TRUE
fjeedfjihcgibbiciheie	TRUE
ajeccgecdajfdiiie	TRUE
hccgfgffd	TRUE
hbcdbgeffgggjdfhbghcfbif	TRUE
ajfibaeijidi	TRUE
djaejjggehcagdgiibg	TRUE
cce	TRUE
dadhbcccchgdfac	TRUE
jhdf	TRUE
hhhj	TRUE
hgahiabfgji	TRUE
egiihbfdahfafecjeefaie	TRUE
ffaghgbbeaebga	TRUE
jaaibfbbhdegai	TRUE
dfafeibibfjhggfgbhfbjje	TRUE
fiffid	TRUE
afjcjj	TRUE
gcbiehhehgifieff	TRUE
ja	TRUE
dbgjdgfbajgbjegiebdfd	TRUE
djdcbdfigicdcjcfjafded	TRUE
gbjejgibjaddbgc	TRUE
feedccifcgbjdchgjcgbjcje	TRUE
gicedececgabeejhcahjiajeg	TRUE
jfhfcbeheedjgjjaa	TRUE
bfg	TRUE
efgdhjefei	TRUE
gicifdh	TRUE
efjefbeiaig	TRUE
aacfijiiecdc	TRUE
ideejejhgcecdidjicf	TRUE
bhbcdahjcbdgjifecjb	TRUE
iaaaahahdeicfdfcbef	TRUE
fjihdggbbjbcc	TRUE
f	TRUE
gfgjhhbjcjcbafg	TRUE
adeghdhiiehfgaebddhegichh	TRUE
cefcadj	TRUE
faecibgdbcccfhagegfgjeed	TRUE
dhgejjfc	TRUE
acdjeccd	TRUE
agicgdeaf	TRUE
iaigbaibajjdcjbiccii	TRUE
eaibjdabihbjagfffhj	TRUE
baheg	TRUE
eggaadibacbfaecfhhgi	TRUE
dheebcahiebadibjfddccc	TRUE
hjeefheibgdgj	TRUE
ajddgcbbbceajgfggfbabbc	TRUE
ejafiabd	TRUE
eeifdadhcjfcadacieajcabe	TRUE
ijdc	TRUE
aejjdehcccecb	TRUE
aebhdaaebeddbbfjdhgdahg	TRUE
dibjbfhiefdfagieeeh	TRUE
fcj	TRUE
cfjh	TRUE
bi	TRUE
gabfch	TRUE
chffad	TRUE
gaaed	TRUE
gcbbihiabccdiffcdh	TRUE
gbfjddfgjchhfbjeabfeedaid	TRUE
jacfhchbbhfdhfc	TRUE
aefd	TRUE
ecaifbheidedfgdfcejh	TRUE
bdchabh	TRUE
jfjccieccjcfbbgcdd	TRUE
hdhjdeahcfaahgcg	TRUE
jfgdjccdcaibedff	TRUE
i	TRUE
heddejiifdabaeij	TRUE
ifcbiihhcbh	TRUE
decgecadij	TRUE
eaddffcbidbgejebjfjf	TRUE
fheabbggeeffifddhe	TRUE
bedbbgejebbjcffbagc	TRUE
gjicgefggijb	TRUE
bbcjibggjjfech	TRUE
iheichddgfihjjaggieiicbee	TRUE
agjijibcfiacbif	TRUE
iaieaeebhffj	TRUE
ehggbdfdfeajdigegh	TRUE
dbcihggeiae	TRUE
gfgbaafg	TRUE
ihihfibbfabffefe	TRUE
gjibbcjbiejfeifcacich	TRUE
ijghifbagbghc	TRUE
ffehi	TRUE
dbjhj	TRUE
hghbhbebeaaehhdd	TRUE
jfgeaa	TRUE
ighadbbdbcfeeiaie	TRUE
ahgjjejhcbiejhjdfddefha	TRUE
fcbcc	TRUE
ehefgfdhgcjdh	TRUE
dgjhcdejgcccjcgheh	TRUE
hdfhdehjaajhbji	TRUE
jeieffhahjihebaccjdbcjfgi	TRUE
ahdehgaabjabhibegaababf	TRUE
dgafigifjadbedghh	TRUE
feehc	TRUE
jbgji	TRUE
fgehcdaadidaigbcaiihjaffd	TRUE
dgfbdjcgbd	TRUE
cdjhjhb	TRUE
cgggchdbgf	TRUE
gdjgicjjejdcdhbjjbcgifjjc	TRUE
hfjhiaagdbaidgi	TRUE
jgafbihfgicchfhacgdaegb	TRUE
diaab	TRUE
jj	TRUE
jccaebjddefbdjbegghhhjfec	TRUE
eggjbdjecceeejdid	TRUE
cedfgfhehbadgigaaf	TRUE
a	TRUE
jbafihjiagbciadabagd	TRUE
ddbeeehjggigbehfjiiigjb	TRUE
ahifhcjbbicfajaiijb	TRUE
hgeagigdjdjifehighgfd	TRUE
ghjjeebiifccjadadfehecb	TRUE
feffdbdegighgffb	TRUE
bchahaabcaghcb	TRUE
jeecfedeecadbicdgfibffghf	TRUE
gchjcdcba	TRUE
gegedbfahaheb	TRUE
fgfhidede	TRUE
hjgcdgdfcfgh	TRUE
jggafcgihecc	TRUE
ccjidfaheeidhidjcdhagjjbc	TRUE
cjjaeccgfjehbcijd	TRUE
ahdheffegfcgi	TRUE
gdgbegbibja	TRUE
ibbegg	TRUE
hjhdjgfegicdjdieeihcdh	TRUE
h	TRUE
d	TRUE
eidaadfhdcdiacdbgg	TRUE
da	TRUE
a	TRUE
g	TRUE
ijifjcaifefadjfafdhf	TRUE
hdajdaejdddggbfbbjahh	TRUE
aaaaaaaa	FALSE
bfhfhaabbbbbbbbicjfjccc	FALSE
bbbbbbbbbgg	FALSE
bbbbbbbgh	FALSE
bbbbbbbejadded	FALSE
bbbbbbbb	FALSE
aaaaaaa	FALSE
aaaaaaa	FALSE
ijfagdedjgaaaaaaa	FALSE
jjbbbbbbbbjaiabhecjj	FALSE
bbbbbbb	FALSE
bbbbbbbhgcbhgjdaiefajab	FALSE
bbggbfjhbbbbbbbb	FALSE
bbbbbbbcj	FALSE
bbbbbbbddicaia	FALSE
gggaaffbbbbbbbbeec	FALSE
bbbbbbbdcajeadhedb	FALSE
bfaaaaaaaabgfgehcaceihcag	FALSE
bgchaiabfchbbbbbbbbbfgbda	FALSE
eeegeeeajfgcjfcdaaaaaaa	FALSE
bbbbbbbabffj	FALSE
aiejiefaaaaaaa	FALSE
aaaaaaaai	FALSE
bbbbbbbehddbe	FALSE
hdagcifbbbbbbbbf	FALSE
aaaaaaa	FALSE
bbbbbbbcbfihbg	FALSE
bbbbbbb	FALSE
aaaaaaaahjjfcbigadc	FALSE
bbbbbbbafgd	FALSE
gcihbjhccaaaaaaa	FALSE
gaaaaaaaaaebgcjcic	FALSE
aaaaaaa	FALSE
bbbbbbbedieffdaae	FALSE
hfbgbfeeccjgaaaaaaa	FALSE
bbbbbbbeiiec	FALSE
hcficadiaaaaaaa	FALSE
icgedffhaaaaaaa	FALSE
gacjgjfdaaaaaaaa	FALSE
aaaaaaa	FALSE
efhceaaaaaaaa	FALSE
ichgaaaaaaaaidf	FALSE
bigfifcbicbhjbbbbbbbbd	FALSE
bbbbbbbjcfjdifejbfieg	FALSE
dfaaaaaaaa	FALSE
gidjefjhhbbbbbbbb	FALSE
aaaaaaa	FALSE
bbbbbbbaggehaidcffgjfedf	FALSE
hehhchcaaaaaaa	FALSE
hdchibdadbbbbbbbbabh	FALSE
bcbbiaaaaaaaagiegede	FALSE
jchebbbbbbbbef	FALSE
jebbbbbbbb	FALSE
aaaaaaa	FALSE
bcabffecjicaaaaaaaadie	FALSE
ibaaaaaaa	FALSE
abigaebjbaahfiaaaaaaaagce	FALSE
bbbbbbb	FALSE
aaaaaaa	FALSE
bbbbbbbgejadh	FALSE
gefhgdfbafaddbbbbbbbbjab	FALSE
dhbabeebaaaaaaa	FALSE
bbbbbbbfe	FALSE
bbbbbbb	FALSE
bbbbbbb	FALSE
dijdffaaaaaaa	FALSE
cgfafijcdjbgifdcfjaaaaaaa	FALSE
ccehfjiggejibaaaaaaa	FALSE
bbbbbbbiih	FALSE
bbbbbbbbddf	FALSE
bbbbbbb	FALSE
dfjjhaaccfdfheahggaaaaaaa	FALSE
caabgibccciaecjaaaaaaa	FALSE
efbbbbbbbbfef	FALSE
bbbbbbbfcfcgghiiffffgc	FALSE
ggfgicfcfjbbbbbbbbccjdc	FALSE
hbaaaaaaaaacacjc	FALSE
bbbbbbbaadagdc	FALSE
aaaaaaa	FALSE
bbbbbbbbbf	FALSE
bbbbbbbegjigechfiaeaejhf	FALSE
cifiebiaaaaaaaa	FALSE
jbeafbgbgbabfabjibaaaaaaa	FALSE
jjdjaaaaaaaahjgbbcaegi	FALSE
gecjaaaaaaaafie	FALSE
bbbbbbb	FALSE
bbbbbbb	FALSE
bbbbbbbbaadfjaeheffa	FALSE
aaaaaaaagfbji	FALSE
bbbbbbb	FALSE
cchdbhihaaaaaaa	FALSE
aaaaaaa	FALSE
bbbbbbbebeijdgigddcjdf	FALSE
bbbbbbb	FALSE
aaaaaaa	FALSE
jgjaeigdaebijjjhbaaaaaaaa	FALSE
gfaagijiebgdbbbbbbbbj	FALSE
acgfddabgcieaaaaaaa	FALSE
bbbbbbbacaedcdhacjacf	FALSE
bbbbbbb	FALSE
jbbbbbbbbbeccjdfaaggea	FALSE
ccbbbbbbbbdh	FALSE
bbbbbbbbjcdhcjccghcfaai	FALSE
eaaaaaaaaa	FALSE
ijifjigfdhebbbbbbbb	FALSE
aaaaaaa	FALSE
dheaaaaaaaacjhhegehbj	FALSE
bbbbbbbcgffhifcedbchihg	FALSE
faaaaaaa	FALSE
bbbbbbb	FALSE
bacehhfiaaaaaaaa	FALSE
fjecjaahiddaaaaaaa	FALSE
bbbbbbb	FALSE
eaaaaaaa	FALSE
bhbbbbbbbbbgcheehch	FALSE
bbbbbbb	FALSE
aaaaaaa	FALSE
fiibcaaaaaaaa	FALSE
aaaaaaa	FALSE
bbbbbbb	FALSE
aaaaaaa	FALSE
bbbbbbbbe	FALSE
ibbbbbbbb	FALSE
aaaaaaaaa	FALSE
bbbbbbbbg	FALSE
bbbbbbbbh	FALSE
aaaaaaa	FALSE
bbbbbbb	FALSE
aaaaaaaajf	FALSE
bbbbbbbiiheffjceichbi	FALSE
abgbbbbbbbbabhjfahigiihdh	FALSE
aaaaaaaa	FALSE
gjaaaaaaaaaggfgbc	FALSE
bbbbbbbcff	FALSE
ehbffaaaaaaa	FALSE
bbbbbbbhehf	FALSE
aaaaaaaaag	FALSE
hichajaefggaaaaaaa	FALSE
bbbbbbb	FALSE
aaaaaaa	FALSE
aaaaaaa	FALSE
bbbbbbbafeggbb	FALSE
bbbbbbb	FALSE
bbbbbbbfjdegdgafe	FALSE
igddfjhfjffaaaaaaaa	FALSE
aaaaaaaabgccbcdaje	FALSE
bbbbbbbcggffeccaej	FALSE
bdaedifdjeijcafjjeaaaaaaa	FALSE
ccaegefgbdhebbbbbbbb	FALSE
bagdaaaaaaa	FALSE
jcjgbaaaaaaaa	FALSE
bbbbbbb	FALSE
aaaaaaa	FALSE
bbbbbbb	FALSE
aaaaaaa	FALSE
aaaaaaa	FALSE
bbbbbbb	FALSE
aaaaaaaa	FALSE
aaaaaaa	FALSE
bbbbbbb	FALSE
aaaaaaa	FALSE
aaaaaaa	FALSE
ebagbhbbbbbbbbgacabejfb	FALSE
bbbbbbbbbb	FALSE
jhhhefhjaaaaaaaageiaijji	FALSE
bbbbbbbeggfafabcefffiah	FALSE
adfadbgiahdaaaaaaaa	FALSE
bbbbbbbibcgfjbebih	FALSE
bbbbbbbbh	FALSE
jjhaaaaaaaaaafgfjcbeijf	FALSE
bbbbbbbb	FALSE
bbbbbbbbgcajcc	FALSE
aaaaaaa	FALSE
bbbbbbbbijgche	FALSE
bbbbbbbb	FALSE
cgeiaaaaaaa	FALSE
figbbbbbbbbadbiecbbbdge	FALSE
bbbbbbbecdddajjhfda	FALSE
bbbbbbbfbjjfbhdfei	FALSE
bbbbbbb	FALSE
bbbbbbb	FALSE
bejaafaaebbbbbbbbg	FALSE
bbbbbbb	FALSE
fdahfaaaaaaaaicgj	FALSE
jdidjgdgfbbbbbbbba	FALSE
aaaaaaaa	FALSE
aaaaaaaagea	FALSE
bbbbbbbgj	FALSE
bbbbbbb	FALSE
ibbbbbbbbjddbibhbidbedjf	FALSE
aegdeaedgjfjjeecdhaaaaaaa	FALSE
dfabbbbbbbbi	FALSE
bbbbbbb	FALSE
aaaaaaa	FALSE
caaaaaaaabh	FALSE
hgahfgjihcihiaaaaaaa	FALSE
hhjchgjeebaaaaaaa	FALSE
bbbbbbbbdcaicjhfb	FALSE
bfgecifhechaaaaaaa	FALSE
hagbbbbbbbbdfbh	FALSE
bbbbbbb	FALSE
aaaaaaa	FALSE
bbbbbbb	FALSE
jehdaacbeaaaaaaa	FALSE
bbbbbbbdbhf	FALSE
bbbbbbb	FALSE
bbbbbbb	FALSE
aaaaaaaabajdb	FALSE
fagdcjbiebeddgaaaaaaaaegi	FALSE
bddaaaaaaaadhj	FALSE
gffciafihaibaehdabbbbbbbb	FALSE
eaaaaaaaaghbdjih	FALSE
bbbbbbbdhbiibgachbc	FALSE
fgaaaaaaaafgdfbid	FALSE
ieaaaaaaaa	FALSE
aaaaaaa	FALSE
fcjbbbbbbbbgedcbh	FALSE
idbbbbbbbbdbbhigejfdbbbdi	FALSE
daaaaaaaaaa	FALSE
ajfgbdhhjeahchbbbbbbbbb	FALSE
iabbafbbbbbbbbh	FALSE
aaaaaaaa	FALSE
eaaaaaaaa	FALSE
bbbbbbb	FALSE
bbbbbbbbddhddgafbigdchf	FALSE
idccdaaaaaaa	FALSE
bbbbbbb	FALSE
bbiccgbbbbbbbbjge	FALSE
cibgahbbbbbbbbhfghfaac	FALSE
geihjedcaaaaaaaa	FALSE
caaaaaaaa	FALSE
bbbbbbbgddhbaejjcaefcfeh	FALSE
ibbbbbbbbdjgegeibaabc	FALSE
gfhaaaaaaa	FALSE
hbgbcaddcdaaaaaaa	FALSE
aaaaaaa	FALSE
bbbbbbbgigfdb	FALSE
bbbbbbbgjgjeabaaahd	FALSE
aaaaaaaa	FALSE
hhbejajfhdgbafaajjaaaaaaa	FALSE
bbbbbbb	FALSE
bbbbbbb	FALSE
aaaaaaa	FALSE
bbbbbbb	FALSE
aaaaaaaa	FALSE
bbbbbbbefaahijia	FALSE
jjaaaaaaaacfahgagjeehf	FALSE
ddgaaaaaaaah	FALSE
iiebejgieaaaaaaaajceg	FALSE
iiijjchcbbbbbbbbfh	FALSE
bbbbbbbb	FALSE
bbbbbbbbchgh	FALSE
bbbbbbbbfa	FALSE
bbbbbbbfahgcefgcfgcae	FALSE
bifchcaaaaaaaabibcf	FALSE
bdhgfadhfejaaaaaaaaacd	FALSE
iaaaaaaaaiagc	FALSE
bbbbbbbgbga	FALSE
hehbjejdgchciihaaaaaaa	FALSE
bbbbbbbfdcicifeef	FALSE
bbbbbbb	FALSE
bbbbbbbhegajahcjcgbaicie	FALSE
fiacebbaiihhjjaaaaaaa	FALSE
aaaaaaa	FALSE
gbbafiaaaaaaa	FALSE
ghefefjgbdgjbgfcjaaaaaaa	FALSE
aaaaaaa	FALSE
ddaiefeaaaaaaaaahegjcabfb	FALSE
aaaaaaa	FALSE
bbbbbbbbgafd	FALSE
aaaaaaa	FALSE
bbbbbbbfgdhhihihhgfcfjd	FALSE
ghdjbbbbbbbbdgbbie	FALSE
babbbbbbbbdccbifgbfjbi	FALSE
aaebaaaaaaa	FALSE
edjaiccbjafjjbaaaaaaa	FALSE
bbbbbbbajbabcibcebcece	FALSE
bbbbbbb	FALSE
bbbbbbbbfb	FALSE
bbbbbbbbg	FALSE
fcbbbbbbbbjdccj	FALSE
bbbbbbb	FALSE
aaaaaaa	FALSE
aaaaaaa	FALSE
bbbbbbbihjjaecfchgcccidgb	FALSE
bbbbbbbbgfbg	FALSE
agbbbbbbbbhbhgcidf	FALSE
aaaaaaa	FALSE
igagchjffbbbbbbbbbgj	FALSE
fdfbbbbbbbbbigf	FALSE
ddieaiejbdedbaaaaaaa	FALSE
ifafddehjdejbbbbbbbbcec	FALSE
ejfggaaaaaaaaabcdeddehe	FALSE
ifhfbbbbbbbb	FALSE
bbbbbbb	FALSE
baaaaaaa	FALSE
bbbbbbbbhedci	FALSE
aaaaaaa	FALSE
aaaaaaa	FALSE
cdjfabiaaaaaaa	FALSE
gdjaaaaaaa	FALSE
bbbbbbb	FALSE
bbbbbbb	FALSE
bbbbbbbb	FALSE
hbbbbbbbbbdjgf	FALSE
bbbbbbbffgb	FALSE
giaaaaaaaajcce	FALSE
aaaaaaaaihd	FALSE
bbbbbbb	FALSE
bbbbbbb	FALSE
bbbbbbbhbhedbgih	FALSE
hjifefhaaaaaaaad	FALSE
aaaaaaa	FALSE
aaaaaaa	FALSE
bbbbbbbecjceedcg	FALSE
bfeijcbdfieebaaaaaaa	FALSE
bbedjifagcebaaaaaaaa	FALSE
jaaaaaaaaefh	FALSE
aaaaaaa	FALSE
bbbbbbbhfhbhahe	FALSE
aaaaaaa	FALSE
bbbbbbbcahb	FALSE
bbbbbbbcaaeecddfcaiehab	FALSE
bbbbbbbfjjec	FALSE
igeceicebjbaeeaaaaaaa	FALSE
aaaaaaa	FALSE
bbbbbbbbbighjhjicchfegcaf	FALSE
bbbbbbbbbhjdd	FALSE
aaaaaaaafacegbdhaag	FALSE
bbbbbbbejbgjbjahjce	FALSE
bbbbbbbd	FALSE
fhaeidiadbggaaaaaaa	FALSE
chgheiffijegadbbbbbbbb	FALSE
bbbbbbb	FALSE
aaaaaaa	FALSE
bcjhbbbbbbbbjgeeihcdeifa	FALSE
ebjcaaaaaaa	FALSE
aaaaaaa	FALSE
bbbbbbbddbfahgjehdggec	FALSE
jchaaaaaaaaa	FALSE
hahhddiafaaaaaaaa	FALSE
jgeeijdbdfcbhebbbbbbbb	FALSE
ffhbiiaacbhbhciiaaaaaaaa	FALSE
aaaaaaa	FALSE
eaajaaaaaaa	FALSE
djbbbbbbbbjihaeaffcgc	FALSE
bbbbbbbbbiibdaefeiiijj	FALSE
bbbbbbb	FALSE
bbbbbbbegbbiifac	FALSE
bbbbbbb	FALSE
dgdadifdbbjhgjaaaaaaaaib	FALSE
bbbbbbbbb	FALSE
bfbbbbbbbbh	FALSE
bbbbbbb	FALSE
bbjhagafdjccbjaaaaaaaajd	FALSE
bbbbbbbfeedfebgga	FALSE
bbbbbbb	FALSE
bbbbbbb	FALSE
bbbbbbb	FALSE
bbbbbbbji	FALSE
gibbbbbbbbdha	FALSE
dbbbbbbbbbbd	FALSE
aaaaaaa	FALSE
eahjcaabbbbbbbbbdbjh	FALSE
bbbbbbb	FALSE
iibbbbbbbbeebiaeeefacacc	FALSE
ibbbbbbbbe	FALSE
bbbbbbbahghaja	FALSE
aaaaaaa	FALSE
dfaaaaaaaacafagc	FALSE
bbbbbbbb	FALSE
fgfacaajcfjebaaaaaaa	FALSE
cddedbcjcbaaaaaaa	FALSE
cdjajaaaaaaa	FALSE
bbbbbbb	FALSE
abbafgaaaaaaaagc	FALSE
aaaaaaa	FALSE
bbbbbbbagbjfbgjacbgjb	FALSE
bbjiiidhfdigadhigfaaaaaaa	FALSE
aaaaaaa	FALSE
aaaaaaaa	FALSE
aaaaaaa	FALSE
edjgbdjecfebbbbbbbbce	FALSE
jdfafdahaaaaaaa	FALSE
jcibibfcaaaaaaaaea	FALSE
bbbbbbb	FALSE
aaaaaaa	FALSE
bbbbbbb	FALSE
aaaaaaa	FALSE
bbbbbbb	FALSE
baaaaaaaa	FALSE
bbbbbbb	FALSE
bbbbbbb	FALSE
fhabbbbbbbbbbia	FALSE
gihjdecjaaaaaaaa	FALSE
edaaaaaaaacjji	FALSE
jhhaaaaaaaaebidiaig	FALSE
bbbbbbbicb	FALSE
bbbbbbbdeiahgicjgjfc	FALSE
ibbbbbbbbd	FALSE
edeaaaaaaaa	FALSE
bbbbbbbeagbfdiggecji	FALSE
faaaaaaaaifdfcafdeid	FALSE
abacbaabjibbbbbbbbbb	FALSE
aaaaaaa	FALSE
bbbbbbb	FALSE
aaaaaaa	FALSE
dgbbfgbedaaeebbbbbbbbjcd	FALSE
cafbjjfebjaaaaaaa	FALSE
bbbbbbbhggbhacfcj	FALSE
iijgbeaaaaaaa	FALSE
icbbbbbbbbbc	FALSE
haaaaaaaaaaddfbiehfffe	FALSE
igfdbhfifecfcaaaaaaaadjch	FALSE
gaaaaaaa	FALSE
bbbbbbbfggdba	FALSE
bbbbbbb	FALSE
bbbbbbbfggdaaih	FALSE
bbbbbbbchghijjfcddebdhgj	FALSE
aaaaaaa	FALSE
ecbgcbbbbbbbbef	FALSE
cjiccfcehaaaaaaa	FALSE
aaaaaaa	FALSE
cajbdaaaaaaa	FALSE
bbbbbbbfabdiaajecbibfhdi	FALSE
aaaaaaa	FALSE
aaaaaaa	FALSE
aaaaaaaagchh	FALSE
aaaaaaa	FALSE
bbbbbbbjafebgbjegg	FALSE
acaidbbbbbbbbb	FALSE
hidjfhbbbbbbbbcaieeag	FALSE
bbbbbbbdccchciehj	FALSE
bbbbbbbcficaaaj	FALSE
bbbbbbb	FALSE
bfehefcaiabfgjiaaaaaaaa	FALSE
ibfedigbbbbbbbbede	FALSE
bbbbbbbejidfeahaagca	FALSE
aaaaaaaaaiccbfjjfeeec	FALSE
bbbbbbbgiceiifgegidafjf	FALSE
aaaaaaa	FALSE
bbbbbbbhea	FALSE
daaaaaaaa	FALSE
aaaaaaa	FALSE
bbbbbbbcjich	FALSE
dffiabaaaaaaaabj	FALSE
bbbbbbbdcdhdejiihjehf	FALSE
aaaaaaaadeccdejibh	FALSE
bbbbbbb	FALSE
bbbbbbbahebdba	FALSE
bbbbbbbfdegicdbhiadjj	FALSE
cgiajchgdfbjbjaaaaaaa	FALSE
bbbbbbbidihbhchjbie	FALSE
bbbbbbb	FALSE
bbbbbbb	FALSE
bbbbbbbeccecd	FALSE
aaaaaaa	FALSE
bbbbbbb	FALSE
aaaaaaaacegee	FALSE
cdhejcfbbbbbbbbj	FALSE
icehdihjgcaaaaaaaa	FALSE
bbbbbbb	FALSE
bbbbbbbfhcddjdiaejhcefeia	FALSE
bbbbbbb	FALSE
hjbhfgdbbbbbbbbcgbgebaa	FALSE
fcjhhdgiiffdaaaaaaa	FALSE
bbbbbbbffcjgcjfhaeejfed	FALSE
djdhacaaaaaaaa	FALSE
jaaaaaaaaig	FALSE
cegaadcffgbacaaaaaaa	FALSE
jaaaaaaaaiggjga	FALSE
bbbbbbbhed	FALSE
cheaadhbchagjficfaaaaaaa	FALSE
bbbbbbb	FALSE
cejicdgjgcabbbbbbbbf	FALSE
bbbbbbb	FALSE
bbbbbbb	FALSE
bbbbbbbbdc	FALSE
aaaaaaa	FALSE
fhhbehabebhebbbbbbbbbg	FALSE
bbbbbbbb	FALSE
gggfjiaaaaaaa	FALSE
bbbbbbb	FALSE
aaaaaaa	FALSE
bbbbbbb	FALSE
bdaaaaaaaadfabcbfhcaiegc	FALSE
egccagcacfeaaaaaaaa	FALSE
bbbbbbbjc	FALSE
iiejjfbiaaaaaaa	FALSE
bfffjhdccdbbbbbbbbjchibj	FALSE
hhjijaaaaaaaajeggcacgd	FALSE
bbbbbbbbjcjggbhgggg	FALSE
bbbbbbbhgafdjgbjjba	FALSE
aaaaaaaajdijghhdfidhiaeg	FALSE
aeihjcicjaaaaaaaa	FALSE
bbbbbbb	FALSE
aaaaaaa	FALSE
bbbbbbbggdaijig	FALSE
gfegbbbbbbbbaa	FALSE
bbbbbbbbaeiajhigdgihb	FALSE
