M1XjKEBzc4lOqHTHVX	TRUE
1dq	TRUE
fbd4	TRUE
ejN4BmyqwPpfq	TRUE
Pu	TRUE
cPch3JlTSQsQlmAAM	TRUE
cO	TRUE
lwmUyMDGtrXK	TRUE
foa21KXqgbqkagMLGuep	TRUE
ajrBlUqXumYt2a1XBhUhf	TRUE
SKJc4RQlxJueSvgG	TRUE
GN	TRUE
xE2sX	TRUE
nVbXNZj3oW3mqZvXMdLyMpWQC	TRUE
tnYeLmWhbpFLBvGvh	TRUE
3XjAGSfUnzeZoIm	TRUE
g	TRUE
2SBb	TRUE
YbnBBqRdpZLuF1lSYGEcu3o	TRUE
mPxgc2gcE1VHBzaMM2PT	TRUE
UPcfAVzxNEMRnPL	TRUE
B1GC4MLekO	TRUE
K4sETmyAWNv	TRUE
kLAdLDyLgDyLHedLqiRbk	TRUE
OHeNZiwJASCEYbh	TRUE
gY2omh	TRUE
q4x1skfukiWl2	TRUE
otlmrxzejLma13yiJgzg	TRUE
ztjlN	TRUE
iqWFSw	TRUE
Qn21pFActpD4sSAUrbME	TRUE
hRlmiPbRjBF	TRUE
SKQDXwQllhioUfYmU	TRUE
FXIHwOfH	TRUE
eW	TRUE
rhiy1EZqziuPyyBD2Q2R2gM	TRUE
SK1WEF1NWqjIbjJvwls2w	TRUE
ZCWzURdWmyNis	TRUE
2FLLZNPaBxUbVfRZHyyKNGvJ	TRUE
BJbyQm2dhzLAJdGFNk414J	TRUE
gTTRmFNe3WJTZgva11wjoc12	TRUE
Qxf4	TRUE
RPeydEiVsw4pGPhIgoIfxUOU	TRUE
eI	TRUE
ByHzvzvtGlrV2oeQMhcyMA	TRUE
1RUIJoiQiAZ	TRUE
GaDefieDrOJG2haM	TRUE
ekUxz4tmGwDnmNiDBtCgDi	TRUE
uTBx3oYb1	TRUE
O	TRUE
rDVe4lH	TRUE
h	TRUE
ejmXnW	TRUE
rFtzmFa2t	TRUE
EElrRH1VwXdAg	TRUE
HM2CyGNrDwcvnNRTv	TRUE
iksaXIQKpDWEEkyflOPyyT	TRUE
UQl	TRUE
vSU	TRUE
BUbMsfHpp	TRUE
B4RXVmLEzRmWt	TRUE
YPlnEaW23zH	TRUE
O	TRUE
iwKghRIwCzned3Um	TRUE
UBnMt1foxfcxadKcly	TRUE
SISURErtR	TRUE
NFBv	TRUE
zzfMIVcPoCYiBuNDQ2sYItt	TRUE
p	TRUE
cjTabZJtcRDOumc1EA3	TRUE
hEimhBIRsfukNrLhwBZC	TRUE
bOYXTxXEy	TRUE
2rlnuWqJqHTcUsmNWN	TRUE
Lb4	TRUE
mULrasTcpNpOHEMMU4MhGpmR	TRUE
t4egMSaSJdelis	TRUE
tVBvOOKryWTR1RfHC1Fg	TRUE
As3vUkEZ	TRUE
ek1N3ugTgVcJ	TRUE
3uZlcJboHpHxfz2YfZkft	TRUE
xBoRTbWMkvaPOuHhpj4YBrwHM	TRUE
Vef1srqRozmFu	TRUE
DFibnvGOlk	TRUE
1ddqVhKG1y2LR4GqKTm	TRUE
zaKVQQAA3WAl2DWCCoh	TRUE
TBVOxNfNxhhpeuI1R4vUNgEZW	TRUE
QyxnsFxYGRomfUzR	TRUE
GHXEvgJgFKtFFfMTNs1IYID	TRUE
TTp2YDzvjA	TRUE
EZsxZVm	TRUE
aQeOoEJN2m2Z	TRUE
VDZV3ofOilwDLp2nQ	TRUE
lN4OboUKoKWg4fxLIXeLfgH	TRUE
4qL	TRUE
4wOZdtTesUIyP	TRUE
LwtER2	TRUE
kvTkuMQKsecwIxIM	TRUE
glhqdqiCUvSTRU3NU	TRUE
bGc1ojInQAdKkcHIm	TRUE
OMMlvQCgfNxunq	TRUE
TbFIIjfdcQpdZmB	TRUE
WlLyGvPZVmjE2F	TRUE
NNVwAwZy	TRUE
2TVIAbMKbNcPfnM	TRUE
TSTQmIFtkyD1MpHw	TRUE
EnJ2igoS2	TRUE
bwk	TRUE
mWsxXlLLWsiInI	TRUE
qdG	TRUE
N	TRUE
WgNOHOcyU	TRUE
d1imgO2GwOwJPouCG	TRUE
ZJSYP4sabaZsXDBAWmafhlNtW	TRUE
avoLebAqw3rZGwAmG3l	TRUE
awFMZcqJyPe1iOy	TRUE
rETMog13aO	TRUE
vCQ	TRUE
1vWIPgKrgJ4fiejE	TRUE
tAP	TRUE
vQULbUPB	TRUE
xfDAjHFsxZG	TRUE
RIA2JfR	TRUE
wrJ	TRUE
Wpqj4A3NnxRIiE4pYvMnEOdE	TRUE
xyuUGMlJpAzyi2i13vVQkKyno	TRUE
UY	TRUE
vT4lHjyZZbeN31FvqayHTD2H	TRUE
XyJRVYtpP22IefIHkgOK	TRUE
1CIJIx	TRUE
ji3FAsEDLbnlGKRD	TRUE
mLvfah2i3e	TRUE
CMAsNONMZd4	TRUE
pLqUX4RWksJwPzLbJDXEqRK	TRUE
BYN	TRUE
Je1Y	TRUE
sbau	TRUE
EAlqs	TRUE
XYNvelnKzpDtHxZDfiFCVEJi	TRUE
MaPdtqlgkRbqjvZpNEs	TRUE
mOuEZmgJr4qNW	TRUE
nJJXZJuShd	TRUE
shcaeofrP	TRUE
YphOjpN4aUhl	TRUE
YZeewoG	TRUE
aHqoI3jwEQPRQpDkYnKrXhHw3	TRUE
nTegAqeBt	TRUE
dh43NYzwnSAMky	TRUE
Iqdd1XjquDCpBiIkyYLGjJ	TRUE
qPvkSXBzY1kFgajYwLjqDy1DG	TRUE
G3vAsVQSIchziAr	TRUE
DA3Bg	TRUE
zWTwq	TRUE
GehNDkP2L	TRUE
MO1tJsfwK3TSEThqwXcF	TRUE
zERPgUIR	TRUE
fyOMDyGddAP	TRUE
sWbiS	TRUE
bg1KVeFHJAkqIT4aKHx3xKDM	TRUE
DS	TRUE
bUFpHwwRVlz	TRUE
W2umo4Rz	TRUE
iacpGj3FXRUctYE	TRUE
WpskrWHpRXMfGW	TRUE
KSFxmHiZRLV4wzMJ3mxsw	TRUE
oUZkVspNfLW2OhXkPi	TRUE
A4SUUbjem4QZg	TRUE
Av	TRUE
w	TRUE
LQy	TRUE
Y	TRUE
yCjvAhUK3dSqGM	TRUE
YMFhz	TRUE
ETXGXaRMk2GxEA3tWyqAq	TRUE
qqsmntVO12WxhUHnXpTmHAH	TRUE
WfrLyHibYb	TRUE
XlRCAOSKuATjfJN	TRUE
jfLPVCvif4o	TRUE
ZojvnyE	TRUE
1YNtCzTrqFln	TRUE
UEfvMLoJahZSobdxdmB	TRUE
LqfA1S3Am	TRUE
WdGYJzkMvZlujNokPbs1g	TRUE
RDOMS1d1eOjDrSmp2BEMVs	TRUE
js33qZBBcpMiEeupt	TRUE
StQIjfKUCVcNznl	TRUE
wuqDervqHYozYeahxsQDy	TRUE
gctRoWPnvIjoBNtaRcvCKANh	TRUE
1utBAHHGQn1urm	TRUE
LEUiWZHL21GjoUmmJgP	TRUE
OqETmanZ	TRUE
SdBgMEnTYjf	TRUE
JwDIeXhPAIknNMmEUqbtkhnB	TRUE
dyNSahWs	TRUE
lJFbSdKz3XPw	TRUE
UPckwEHMvWeYQZglgiyS3Opt	TRUE
GT3sWx	TRUE
Wm	TRUE
r4Fr	TRUE
WtjIbEoyIEWIzEUwX	TRUE
Y4ozQoAZNfcTORBKoR	TRUE
HsqStbIJErMRKyVUCZsu	TRUE
wWzWnUAzS	TRUE
qYCUWsfmPbxJeX2SAFFc	TRUE
gxiTWSF	TRUE
NIvBYtrGrOgKZCXAczbNVpXHh	TRUE
pbyLPn	TRUE
px1kzHBIaYCkEoxnYF3faD3	TRUE
GMWR	TRUE
qLerfJgbPfJNuJe	TRUE
Gc	TRUE
a	TRUE
tPUfv4Dpoinss	TRUE
iiWqlS	TRUE
cwTdm1jWEoCGTqJ4fbZK	TRUE
gzqqAmnKSDPoTgRPPN4Ch	TRUE
llIKLCSBHZ	TRUE
q4mvPsqsbLjWO3NnB	TRUE
xxaHLH	TRUE
p	TRUE
gsDSuX2ryrEGEdZtmKh	TRUE
bEngoRK	TRUE
FXJe	TRUE
wWWqzjfKb2ZD	TRUE
VDZqtSvxmfDJofoElznY	TRUE
ZGlXYzbkORlWboEqfi	TRUE
vSLU1IRfScdfaia	TRUE
4hswBSRn	TRUE
PEKRcBtsh	TRUE
T2NszTGqAk	TRUE
YVQ	TRUE
uKEjbLh	TRUE
cYeciuqQnfknChPmry	TRUE
wY3VeJH4	TRUE
2pSBgCWuqZVK	TRUE
QDAhhMTUuNrGcuCu	TRUE
kzVikMCwLhUJIm	TRUE
mQfiJEefkgURZCWazMO	TRUE
JfjrAFxdv4aVrQng	TRUE
z1SWy	TRUE
xEONdyBXaXLl	TRUE
cXgy	TRUE
GrBcMma3AODvRgCjXZ4fzKs	TRUE
XlhnjdVZOUXugkPEHABQLFX	TRUE
oAZNv3HN3fgdsc	TRUE
cUs	TRUE
VLMXms3gvWcnrX3l	TRUE
JspXAAqn	TRUE
iiQiudtBnBZSjmWkRlJAZn	TRUE
w3LMIWSiwmNiq	TRUE
v1xEsPwLlaizMdDAZ3RKp	TRUE
HpCRPc4JDWtQxn2UVs	TRUE
IKzM2nYmvKiMmgx	TRUE
FDCV1T	TRUE
ovowRkMF3IbUehdUpGdPAO	TRUE
VooQZi2Ug3	TRUE
FuFjoHaqfVGe	TRUE
TPOMACPZlWUvM	TRUE
WmzbGr	TRUE
fuVheQXvYXAOJB	TRUE
fj	TRUE
XokFk4wAWLiGxTwvPtYl13JyW	TRUE
TCbeXwBbJXuXCgezGoCwSH	TRUE
BjH1gKAvP	TRUE
WPgEnQMIkOXPitUqyHeYv	TRUE
COmEapWcudCcYd3lRDPpvpG	TRUE
AF2arDObcAzitgdckT	TRUE
4p2rGZPZYkmduJkbnuRMu	TRUE
efYEUKOsRRkePivBgkUgButl	TRUE
BcywkXkzXSl2KBQwT	TRUE
Vl4pdFIZiXxSptd	TRUE
aV4RQfGPQHGq3RNSBSeHwryYz	TRUE
Qzl2HRnjy	TRUE
M	TRUE
Aw	TRUE
D1uvAtkuZUe3ztkUuEo	TRUE
1Jl4HhHEOG	TRUE
tGanqyG	TRUE
ZKNGBxw	TRUE
bPCMQCYF2ytbI	TRUE
LFwXBv	TRUE
ZQPxfgVADJp2TekqMKTpp	TRUE
p1M1xnwrrv	TRUE
OzneOydvkqHSVMgAryOFCGUMp	TRUE
1zMvuKqEeF	TRUE
aSjKrw	TRUE
AHGMQxIBIhbb3zl41FyPjO2gy	TRUE
sXQYMYQODDCDWc44WEyMcUcBI	TRUE
bgVSGFKbmtWShPWrmrTYf	TRUE
ir1ci	TRUE
QSsB2XJkNtlDVuL4	TRUE
ybJHW2kmMrQjGojv	TRUE
hspxXXUeRsE2hWLKyKMQ	TRUE
UtimK	TRUE
k	TRUE
uZnmK1PXNAtjU2EpX11	TRUE
BuZwfbfmRaLiwEDc	TRUE
RA3gnTuSe2lGZa	TRUE
PtgpNgikSMKv	TRUE
1PhTtebKzEKFZftKZjpwV	TRUE
SYyrNlQQDymTYZWRz	TRUE
2O	TRUE
QCO1L	TRUE
bLWDtly4D4VRyIEQOYMYo	TRUE
ofzKYoeybZKb	TRUE
PZRniVsrZZkIE	TRUE
moGEeGXjTNdi1bcAlz3inML	TRUE
F43YkfSs	TRUE
ZumN	TRUE
vsD3uM	TRUE
egvJsoEjaiItgcYRxCFqgYdbH	TRUE
am2rzTdo	TRUE
zZSyAftvBXojW	TRUE
dFoW	TRUE
TqYCjQeFVXjwnkiIn	TRUE
ntJpiWuTq1hYyeOKXY	TRUE
tTYLHPfHDilpEFxBRPRGyb	TRUE
YwaDivtxgSB	TRUE
2NEhfsEnEDpB	TRUE
sjv1odfaOGtXuXc	TRUE
gmUubPVVMygjJ1jsJ3k	TRUE
fHmLq3ZKWCRzxk	TRUE
OJDjY2JkQdAZsFmXUAakIk2	TRUE
jsjotqnHbb2DNHZmV3AyTN4	TRUE
lnWzq2ByG	TRUE
JkQbawXxwZJaPZSlt	TRUE
xGbYPfkLaMfCBTLOvinhDND	TRUE
INMUW3wfjMfS4Gd	TRUE
HCHgwEQjiNOW1Xn1Dy	TRUE
AbNOFLfxaO	TRUE
FjBosguUQasgQA	TRUE
fcEUFilJLo	TRUE
tlkAcDqyKx3a	TRUE
vdb1NKyCYEduyKF42bIva	TRUE
EIJBZEVf4nVPKFZt	TRUE
oaumDvMXCqVXKjcYA3J1j	TRUE
XB3WGg1Y1DFOnmgHbX	TRUE
QnJYuqH41m	TRUE
pRJ	TRUE
mrBBuG2YdnDDE	TRUE
C2SILu	TRUE
lyKsYWPvvf1	TRUE
g	TRUE
jNhiLofl	TRUE
yKLAkxQZGmCUGxEPXycvDjF	TRUE
IPioYWdtQz	TRUE
hsVjUcAVBRHT2h	TRUE
bYzkX	TRUE
v2qwa4M	TRUE
Jd3TVkKaU4vGDUOK	TRUE
gUfcwsozx2prQHL2lSVtKiLu	TRUE
kSFgwJmOtoHEnfM	TRUE
EkY4ddfLqoYOpXNBeN	TRUE
uNQlqFjoA	TRUE
XlHkbQ2hxypbXd	TRUE
P3M	TRUE
XqgieddMjXXtanPBOqvMQUyte	TRUE
v2MM	TRUE
JuKquQoQdRhyBvdPMP	TRUE
n	TRUE
y1R4zszFSGA	TRUE
YXLCbDk	TRUE
qb4LFZLsImGiXDcBgK1	TRUE
Zemf2CRKSQTMq	TRUE
4XTaTuokYFKfjXciXMo	TRUE
AhsZOlf	TRUE
FfhYnA	TRUE
NASCrl1yshidfnZLtZTE	TRUE
WDz2flLQXkhTfDDUrS	TRUE
F3rjwYxLFdJSP	TRUE
O1Nf2doRvBp	TRUE
A32xRJDgsNjYKY2YOkvSZz	TRUE
ViYxJTvvReDZZiZP	TRUE
E3PgGsmZeJReBJtznwz	TRUE
ba	TRUE
nzfEydsP	TRUE
SsLZNzKTBTwpQhnuCo	TRUE
fHeaBGDMqzYcTL	TRUE
gCPZSXMCkgq3	TRUE
OATSc	TRUE
rVSyKr3Xy3IFOWBkyvu	TRUE
1AEtTm2jzMLrVXPKcmqQbDyuL	TRUE
WYRCEfYM	TRUE
FFR2HLMLvWSnC	TRUE
1heHg	TRUE
2y2PJEWGTwygwKOOeBOzfSQzm	TRUE
dYV	TRUE
wfiXwhdHA3sBZxEHyUHZ	TRUE
2eOMm	TRUE
UrykfLefXzNENkuskwmAg	TRUE
jl	TRUE
xqZvgmDdfOt	TRUE
XR1huF2WZVjUJwg1EeOW	TRUE
b2iNFCW	TRUE
y1T2g2RAjjoeW4Afkkg	TRUE
HqqxtC21ht4aLwtAYHaFGNP	TRUE
BvvvzJTKY1TFx4RmHwEuG	TRUE
TEjZQtWofriu	TRUE
yjoYTTwyPqRjddj2Zk2VLZ1	TRUE
g3GQlTQz4fPr3fvQH	TRUE
COWcjjgdZFzdXM	TRUE
gT1fuiNFD1TimKgxHXXWUyBr	TRUE
4per2kso	TRUE
VM4B1tFFFCKRpAGPlxLpsEil3	TRUE
PVzzYlJvuQXGRzM3l	TRUE
EXcokgHwrceZKtDKlFt	TRUE
iX2DCK	TRUE
laobd	TRUE
qomhW4xQXIjLi1fXEzKcPF	TRUE
n4	TRUE
FVJLqbHWVs1HwzcQLq	TRUE
qSVqQ	TRUE
G	TRUE
IE2FkYBxIZyGeGBYQBDKi1	TRUE
Rqc	TRUE
Zdvf	TRUE
TCw1IeJiFfYwWPBCxCQpAL	TRUE
vaNAnOuydzfG	TRUE
mkobIlxDu43f	TRUE
Hs3tFZxXmm4DGUf1cFj3	TRUE
BugKtz1O4	TRUE
naFD2xncq4YJaMcvRbwFXLNo	TRUE
IveWpx1	TRUE
xB	TRUE
JFoq4EunQHHiBSPDjuouoQ	TRUE
dp2c	TRUE
dOgxpggPV3phblbAT3cEDa	TRUE
oFW1dkrVmxL1ZNPRD1qOnSf	TRUE
AgI4TBDMFnkdNWXmG	TRUE
Lo2AYsyDKUH2qPRGABUW	TRUE
JSIh3EINKP	TRUE
lVLrj2sF	TRUE
VPqMVO	TRUE
P	TRUE
doPatTSEIvKx	TRUE
jp	TRUE
uxTDIlDQnJTqo	TRUE
P3dfh	TRUE
vnKdfxCed3jZ4pYx	TRUE
Ed2tsJWGmRBAQuDWzBsGOh	TRUE
EC	TRUE
scwDO4zDFDnELTNonVoLFN	TRUE
4QCh1KIvHoqDUIaa	TRUE
JDvUTFcEvP3OSquzylZtqDGM	TRUE
ishUsxJiCIK	TRUE
c	TRUE
neLRWDMPyAlmwRuadL	TRUE
Pey4ZiIXvrpeTI	TRUE
gxz33	TRUE
C	TRUE
s11NljaXDPbk4YW	TRUE
gB1dYPMrwnUstY	TRUE
aueFWoso4MKiKcF3gfuSJpcm	TRUE
TVkuqpC	TRUE
euQfwtY1UXSsASrQFZT	TRUE
BhswISEZeR4weMCQD3L	TRUE
YoBeWfsEmrfRthaAAPeE1EU	TRUE
2wLflhisIjI	TRUE
2g2vqDCCHTSHqpkgzGa1	TRUE
ih4eOU3gcjYiQhfnn2	TRUE
wloJ	TRUE
4WIh	TRUE
nzzH	TRUE
fIAU	TRUE
yHZyLI1I2B	TRUE
KzN2t1TP	TRUE
RNFiNPYz3xdNpGKflZYNQvyB	TRUE
OVP1Kp	TRUE
4lxGSAmUtea	TRUE
eWzqw1UmQjZjlncCEDX1mG	TRUE
FdajIuUCX	TRUE
MPXx	TRUE
K	TRUE
MkDqPqlS	TRUE
BQhIAiSAPpniFkq4X1	TRUE
eNqeSCXGrmuokfiFxWukfazU	TRUE
N	TRUE
oLLYYzhcc4eDgGUEpTZzfcqn	TRUE
GdWL4m	TRUE
TpeTCzq	TRUE
XDFC4IcgRFBhqef	TRUE
HV	TRUE
bSikXrxbnxFVFy4f	TRUE
iMNBddb	TRUE
ZQsRPbwSzRrgXGtJW	TRUE
m2fnWBpbINNUzHU	TRUE
1b3riB3BPQr4SOGSOReOrAClJ	TRUE
gys2GxbuUmOuBLNRX	TRUE
VfyJqGdXbs	TRUE
tgfrHHnbkjE	TRUE
C4lpe	TRUE
1Trxi12aDHzM	TRUE
TKS2BD1xsijkaXF3C1jlBJ	TRUE
rJeWyus3KUCfCRYQidQf	TRUE
W3x	TRUE
KNB	TRUE
hv1LIDn3dW2	TRUE
HyYGuoU	TRUE
XTYnaHVlC	TRUE
AwQzV3uMcNYvhenSJmkJgSexJ	TRUE
AVKj1RQ	TRUE
aLbbbbbbbbU	FALSE
aaaaaaaaPpjAo	FALSE
RyY1kwaaaaaaa	FALSE
koGNqGaaaaaaa	FALSE
bbbbbbbJxnxUpdVKYyAOENL	FALSE
bbbbbbb	FALSE
bluuISaaaaaaa	FALSE
ZnHj2YhKaaaaaaaaYjcFKlCgl	FALSE
HhrLbbbbbbbb1DGcv3fjOT	FALSE
bbbbbbbbdvorXGZeko	FALSE
pe3Laaaaaaa	FALSE
VdbaaaaaaaaTVSSyiGKYOUXY	FALSE
bbbbbbbqo1MxnBNJtVIiU	FALSE
bbbbbbbBsviZpL	FALSE
bbbbbbbmJxEZ4mZqRw	FALSE
nSsuV3hIhOpyaKPasHaaaaaaa	FALSE
bbbbbbbuUHKvoqmZmOW	FALSE
bbbbbbbbsL	FALSE
bbbbbbbITgQiiUiGluoiy	FALSE
YmaFMb4s4zhFaaaaaaa	FALSE
bbbbbbbdcxcfXMJv	FALSE
WIkJSuBelIXMZaaaaaaa	FALSE
aaaaaaaa2	FALSE
bbbbbbbbP	FALSE
eVdLFloVjlWbbbbbbbbABGl	FALSE
bbbbbbbKdbSOJUKcVPRlnRJvL	FALSE
zabbbbbbbbC	FALSE
uYaaaaaaa	FALSE
bbbbbbbidz	FALSE
RSfaaaaaaa	FALSE
2SM2FFsbbbbbbbbFnsVVfX	FALSE
zaaaaaaaar	FALSE
lvJsgjiPopCYsoBavpaaaaaaa	FALSE
BaaaaaaaaK	FALSE
bbbbbbbO	FALSE
bbbbbbbb	FALSE
bbbbbbbRFrksZgfGojCI	FALSE
bbbbbbbbVFLd	FALSE
bbbbbbbmkZekU2XAxOK	FALSE
ySmzzbbbbbbbbdF	FALSE
DlxSSZOwaaaaaaa	FALSE
bbbbbbbvtXSUr4	FALSE
xnjhoubbbbbbbbjADMXpalb4Z	FALSE
HfbbbbbbbbM	FALSE
bbbbbbbQlMORZW3Z1crFeW4sM	FALSE
bbbbbbbb33N	FALSE
qzvzhbbbbbbbbh	FALSE
gWHnsVrpMXCaaaaaaa	FALSE
NbbbbbbbbgZsW	FALSE
DKjbbbbbbbbpUYnu3kJrJGu	FALSE
bbbbbbb	FALSE
IbyJpwm2VbbbbbbbbPPJzMC	FALSE
oaaaaaaa	FALSE
bbbbbbbbRGHeDYNko1z2zC	FALSE
kiS4y3bbbbbbbb2wqK	FALSE
bbbbbbbbwLqf4sWM4iiGK	FALSE
lYUvJmGtnQnsaaaaaaa	FALSE
d1hMBjbbbbbbbbJp2	FALSE
vaaaaaaa	FALSE
nVlRGTlnIeGHdDjsaaaaaaa	FALSE
mOXaaaaaaaaxIc	FALSE
YbbbbbbbbRA2Qd	FALSE
bbbbbbbb	FALSE
aaaaaaaa14KPskL	FALSE
yjlitbbbbbbbboEeahd4qPfI	FALSE
txGgAtaaaaaaaaXxbokXvBeei	FALSE
bbbbbbbxErI	FALSE
Fsaaaaaaa	FALSE
FWXbbbbbbbbjxYs	FALSE
vHEcbbbbbbbbnoSQ	FALSE
KpfzzjDQUHGqTgzAaaaaaaa	FALSE
bbbbbbbb	FALSE
bbbbbbbbHsGfnpzU	FALSE
dWoaaaaaaaaULqWjEYpP	FALSE
CGaaaaaaaaSJ	FALSE
11cVR4Sk1zIaaaaaaaalojR1	FALSE
aaaaaaaaFv	FALSE
aaaaaaaa	FALSE
CXcHNfGB2fibbbbbbbbV	FALSE
bbbbbbbkIzaZ1ThJ1xUcH	FALSE
lmygrhUgNraXEaaaaaaa	FALSE
aiWrxaaaaaaa	FALSE
urCZcZOerupztaaaaaaaaGk3R	FALSE
qIwSBfaaaaaaa	FALSE
AAVubbbbbbbbLUP	FALSE
aaaaaaaa	FALSE
bbbbbbbXps1PpH	FALSE
Qjuaaaaaaaa	FALSE
KCbbbbbbbbLIxpQIuLyGs3	FALSE
TlbbbbbbbbYwZfdKclPa	FALSE
aaaaaaaalqAZ	FALSE
wy2OrrcFwcaaaaaaaaNTWlH	FALSE
bbbbbbbQqL3qhIJJhOUXMWFuI	FALSE
OwSaDbbbbbbbbjC	FALSE
obRyTc1FROhX4SKaaaaaaa	FALSE
bbbbbbbUgoqLNEfzsA	FALSE
xISADXiJfbrVaaaaaaa	FALSE
aaaaaaa	FALSE
v4YtAaaaaaaaaVb	FALSE
bbbbbbbDurlHQAx23hhn2	FALSE
bbbbbbbJV1utrKyo	FALSE
bbbbbbbB2Ux	FALSE
bbbbbbbQcWuXuDK1Dfma2dQ	FALSE
GOcJCOIIfaaaaaaa	FALSE
bbbbbbbbSxJWZOnUx	FALSE
bbbbbbbj	FALSE
bbbbbbb	FALSE
aaaaaaa	FALSE
bbbbbbbQLAlxdDVC	FALSE
bbbbbbbdq	FALSE
bbbbbbb	FALSE
bbbbbbbtRbibWPWmBDQXIau	FALSE
bbbbbbbctF	FALSE
bbbbbbbni	FALSE
bbbbbbb	FALSE
vRRncbbbbbbbbJsN	FALSE
z2rCaaaaaaaaUSPL2LK	FALSE
qMWjaaaaaaa	FALSE
aaaaaaaadgJ2busO2mpQR	FALSE
KzqZqqEaWqDooaaaaaaaaCDk	FALSE
Hgyvbphaaaaaaaa	FALSE
bbbbbbbJZwpGfJwr	FALSE
bbbbbbbfVbx	FALSE
NicLbbbbbbbb4ZGY	FALSE
OzbbbbbbbbxL	FALSE
bbbbbbbgBEMciV4b2	FALSE
aEaFaaaaaaaaNb	FALSE
bbbbbbbLSQYTTpyfakO	FALSE
XzagO4GeIOolDeTaaaaaaa	FALSE
bbbbbbbiUT3lJpHVqh	FALSE
1rlz31mDfdCYKSCaaaaaaa	FALSE
aaaaaaaaZjRUp3HKo	FALSE
bbbbbbbZJwZVEfgu2dv4TCkM	FALSE
aaaaaaaaNfC	FALSE
woaaaaaaaaahpKBiGfBQrLRa	FALSE
zbbbbbbbb	FALSE
QPjbbbbbbbbCA	FALSE
LYsdHnxrfYSkQ4Kaaaaaaa	FALSE
1ezSbbbbbbbb4rRnM	FALSE
bbbbbbbbl1LfYWbNjm	FALSE
RbgPmiW4aaaaaaa	FALSE
xmUTmvrPaaaaaaaaGgONCq	FALSE
bbbbbbbwlE	FALSE
vcLgZJMObLaaaaaaa	FALSE
bbbbbbbjl	FALSE
dZ2S12wzMaaaaaaa	FALSE
bbbbbbbATOymOn	FALSE
bbbbbbb	FALSE
BIaaaaaaa	FALSE
hG4yjoDKbbbbbbbbgp	FALSE
crFWzFYaeApaaaaaaa	FALSE
NBEBebbbbbbbb4	FALSE
bbbbbbbFeCZhcAWLjQNL1YUYj	FALSE
mBLLWaxYnbbbbbbbbYHIKFcnh	FALSE
bbbbbbbVjlSPUyXioi	FALSE
22mHaaaaaaaa2UdIZTYs	FALSE
aaaaaaa	FALSE
vA3JSjJTaaaaaaaa	FALSE
1aaaaaaaaXgfxVhwoKD4XqcW4	FALSE
aaaaaaaa	FALSE
y2VbxCaaaaaaaa3lqvyig	FALSE
bbbbbbbDSdYomI	FALSE
aaaaaaaa	FALSE
bbbbbbb	FALSE
bbbbbbbCaEN	FALSE
bbbbbbbubpYHIyrbUnm	FALSE
EcNaaaaaaaamXsqh3wx	FALSE
CBlJdJtaaaaaaaaqHw1FI3Lu	FALSE
bbbbbbbVSqrsdvCgB	FALSE
3mZVktrrNDyhLFsajaaaaaaa	FALSE
bbbbbbbmZ	FALSE
Hn2ltjVbg31cKnNXaaaaaaa	FALSE
BmLvVD44khLaaaaaaaa	FALSE
bbbbbbbbMY4ORrLwGOWidbfZ	FALSE
bbbbbbbYeTNb	FALSE
LsbbbbbbbbKFOciXir	FALSE
Mizaaaaaaaa	FALSE
gwOhqGkuZk1Ikaaaaaaa	FALSE
bbbbbbbzQGzQScoAGOvc	FALSE
WbbbbbbbbPv	FALSE
Bbbbbbbbb	FALSE
bbbbbbbgWDTbQ	FALSE
rwpARHHUorAy4MMcaaaaaaa	FALSE
JbpezioZidXbbbbbbbbpz	FALSE
bbbbbbbfxXDZcwd	FALSE
maaaaaaaaspCfqzpJ1nrUrN1	FALSE
HcoZsEMqzFvkEaaaaaaa	FALSE
aaaaaaaagvsMguCyUNHj	FALSE
AEPbbbbbbbbvskpzi4oHgrH	FALSE
ZjoNmaaaaaaaazRpQp2SUf	FALSE
bbbbbbbgB2tOBUjbzr	FALSE
W4xUKIbbbbbbbbDFQ	FALSE
bbbbbbbeMS3wmUaTkiw	FALSE
bbbbbbbhm	FALSE
oTVfkZptmK2aaaaaaa	FALSE
xSGHZilGG4HbbbbbbbbN	FALSE
bbbbbbbbh1	FALSE
bbbbbbbEvbGJY1meDHurfmSyu	FALSE
DJ2zzAmhbbbbbbbb1cNq	FALSE
bbbbbbbcZOZDGfoXn2WkicPDo	FALSE
ZdISueoPqottj2nyaaaaaaa	FALSE
EJYLePspxhxKtfaaaaaaa	FALSE
JKUNkwuxkK4Naaaaaaaa	FALSE
rXczEPhkbDi4aaaaaaa	FALSE
Fi3ITCq1diXhdbbbbbbbbH	FALSE
bbbbbbbhxoBv	FALSE
bbbbbbbbBI	FALSE
zjAMraaaaaaa	FALSE
bbbbbbbHqtfUJnIVrv2Mgday	FALSE
coaaaaaaaaj	FALSE
bbbbbbb2bBCar3JSHqTTPza	FALSE
aaaaaaaayTcl	FALSE
bbbbbbbbSyXKid4FYxaRp	FALSE
DSAd3yDMSaaaaaaaavA	FALSE
IhgoYxcO1kzPWpHaaaaaaa	FALSE
Xaaaaaaaah	FALSE
aaaaaaa	FALSE
vMDXFvL2yzSwVlOKaaaaaaa	FALSE
ilQ2ypyAriBjaaaaaaa	FALSE
CaQrZaaaaaaa	FALSE
bbbbbbbMVKyMFBrjlPsam4zU	FALSE
GPUkBRAPpJQA2vWU3aaaaaaa	FALSE
BPAjBZbbbbbbbbw	FALSE
aaaaaaa	FALSE
aaaaaaaakljDm	FALSE
bbbbbbbNSIvZ3	FALSE
RpvmaaaaaaaaGGr	FALSE
bbbbbbbqviqlX	FALSE
bbbbbbbnzWIf	FALSE
maaaaaaa	FALSE
bbbbbbbdv1bqzs2wynTByCl1	FALSE
bbbbbbbbFzwPKmEj	FALSE
BsriNRJWRWaaaaaaa	FALSE
2MchDoAnJgWaaaaaaa	FALSE
mbbbbbbbbQT	FALSE
TaaaaaaaaCT	FALSE
bbbbbbbbWJ	FALSE
ES44QvaQwbbbbbbbbEpLOYuB	FALSE
bbbbbbbpjAlYwJLKXaMAbqt	FALSE
P2vpwfaaaaaaaa	FALSE
bbbbbbbs	FALSE
Uaaaaaaa	FALSE
wTMiDGouydtqxnJH2Gaaaaaaa	FALSE
4WbrcpSYZaaaaaaa	FALSE
bbbbbbbIAbPnwg	FALSE
Focraaaaaaaabkb	FALSE
bbbbbbbtqCR4PsfPoYIijdeq	FALSE
MjpJhmmxbbbbbbbbb	FALSE
mQHYMgWAbbbbbbbbxPajb4Yu	FALSE
bbbbbbb	FALSE
bbbbbbbdkTGkW3	FALSE
m4H2aaaaaaaauER	FALSE
VamF4oG3LATMu2aaaaaaa	FALSE
aaaaaaaaSwxtEohz1F	FALSE
bbbbbbb	FALSE
bbbbbbbGU2yjUJszaB2Pf	FALSE
bbbbbbbDcyVeqGBlfWAwe	FALSE
rMGbbbbbbbbU1O	FALSE
bbbbbbbb	FALSE
JXbD4bbbbbbbbSWhd	FALSE
bbbbbbb3zDc3H	FALSE
AbbbbbbbbU4tFiGtM	FALSE
rPbbbbbbbbLquiPHDHg	FALSE
bbbbbbbqcGsa1FP4	FALSE
xCjB3OJaaaaaaa	FALSE
bbbbbbbaigxZ1yif	FALSE
bbbbbbbNRCrOVzxxwVU1f	FALSE
bbbbbbbgk	FALSE
daaaaaaaaURQg	FALSE
dkGahvqEbbbbbbbb	FALSE
aMaSBSaaaaaaa	FALSE
tUW4WfqGfSFJSYaaaaaaa	FALSE
bbbbbbbhyX	FALSE
BoqBuqIwM3UHddaaaaaaa	FALSE
bbbbbbbwwPio	FALSE
bbbbbbbSwwyCgBT3wEv1F	FALSE
AwFsaaaaaaaaJ	FALSE
paaaaaaa	FALSE
coGKwSqYBR2sbbbbbbbbJJT	FALSE
bbbbbbb4OlFrQTY	FALSE
DNYOLaaaaaaa	FALSE
ADGaaaaaaaa1f	FALSE
ZSHbfGk1wkNnQaaaaaaa	FALSE
jmlLfaaaaaaa	FALSE
Zv1UUImJXbbbbbbbbq	FALSE
bbbbbbbb	FALSE
iaaaaaaaaG	FALSE
Obbbbbbbb	FALSE
WbbbbbbbbcL3H	FALSE
xIaaaaaaaa	FALSE
bbbbbbbb	FALSE
odaaaaaaaapVcn	FALSE
BMZEAOhSlaaaaaaa	FALSE
ApplOu3aaaaaaa	FALSE
EihLMZycVCbbbbbbbbNzPo	FALSE
bbbbbbbJhfRfhlCtrHvJ	FALSE
nViaaaaaaaaK	FALSE
CKFOizZJa42CLVKaaaaaaa	FALSE
aaaaaaaaI	FALSE
ibMVbbbbbbbb	FALSE
nfUG1TUaaaaaaaanbdlEfIfE	FALSE
bbbbbbbbwaeDGyuDnoWSO3S1t	FALSE
3aaaaaaaaOhDdW2rcscp	FALSE
pdrLPaaaaaaaajWAn3	FALSE
bbbbbbb	FALSE
uaaaaaaa	FALSE
bbbbbbbtnn	FALSE
bbbbbbbuZAxQ	FALSE
bbbbbbbYSHaVxHCx	FALSE
XTTmEZRLK3b4Ylbbbbbbbb	FALSE
zNaaaaaaaanMXHwVS	FALSE
bbbbbbbUecesuFts41yAFMyBF	FALSE
laCnDHekaaaaaaa	FALSE
VKaaaaaaaashtL	FALSE
WCzxRKDsqbrKbtbbbbbbbbn4z	FALSE
4g11hgSDBD1wGTOaaaaaaa	FALSE
bbbbbbbp	FALSE
wvCHwcwUaaaaaaa	FALSE
wL3aaaaaaaa	FALSE
bbbbbbbKwEH	FALSE
bbbbbbb	FALSE
bbbbbbbxG	FALSE
bbbbbbb	FALSE
juXgNZHtyGUbbbbbbbbGNw	FALSE
WNEm1YNjbbbbbbbbWLnjoXM	FALSE
DpNNfnqbbbbbbbbmC	FALSE
2sjJEAGN4bbbbbbbbfwFuBY	FALSE
aaaaaaaa4izFyprqt	FALSE
UQMYEbd4RN1bbbbbbbbVzA	FALSE
WjKFbGTuaaaaaaaaEWa	FALSE
anvDRHUGkvLqlaaaaaaaa	FALSE
I2bbbbbbbb	FALSE
IUuNlXd2eMaaaaaaaagR	FALSE
aWaaaaaaaa	FALSE
bbbbbbbpKVoqVethWTL1QXckm	FALSE
ULaaaaaaaaq2cxcoUfRUq4gZ	FALSE
KyrzQafFQfbbbbbbbb	FALSE
qKZgAubbbbbbbbngJx	FALSE
QJZaaaaaaaaOy	FALSE
YUXHdDGQA4Julbaaaaaaa	FALSE
2bbbbbbbbgtiQ1K3i	FALSE
bbbbbbbZK	FALSE
R4vaaaaaaaaoheU3Avf	FALSE
ORRbbbbbbbbG	FALSE
xsrEYaaaaaaaa	FALSE
bbbbbbbAiVLyCyjBm	FALSE
YY3IaaaaaaaagvnMTAm	FALSE
VbbbbbbbbDGddVBt	FALSE
aaaaaaa	FALSE
BAQP3bbbbbbbbYtghJflSCEt	FALSE
ITAE2jZjYOJaaaaaaaaCNGSWs	FALSE
dZTbVt1UbeKaaaaaaa	FALSE
tKz4aaaaaaaa	FALSE
cIaaaaaaa	FALSE
Sbbbbbbbb1WdxJV	FALSE
bbbbbbb	FALSE
aaaaaaa	FALSE
mcbbbbbbbbFRPqQMDbqI	FALSE
2bbbbbbbbo	FALSE
bbbbbbbkWsWYIvxuI	FALSE
bbbbbbbnRgANmB	FALSE
cBs4bbbbbbbbZsQ	FALSE
lQ4aEKZfyghbaaaaaaa	FALSE
bbbbbbbZV	FALSE
qGJKIyBvaaaaaaaa	FALSE
bzBBpaaaaaaa	FALSE
IXujtaaaaaaaaGUIl	FALSE
bbbbbbbjhjIMPFRrvrXIGn	FALSE
bbbbbbbbk	FALSE
pZIuMilCKhvFaaaaaaaarS	FALSE
TNaaaaaaaaQ	FALSE
mH2lhbbbbbbbbBhCrl3XXat	FALSE
UlCepKZPaaaaaaa	FALSE
4gaaaaaaaakLd3xaXjhFf	FALSE
hQK3HFKpaaaaaaaai	FALSE
Qybbbbbbbb	FALSE
pvIRIaaaaaaaa	FALSE
a1ortqbbbbbbbb	FALSE
eTjJmOUaaaaaaaan2VG2	FALSE
EQV4nMOG2CBZaaaaaaa	FALSE
