hdfghha	TRUE
fdjjdge	TRUE
hfcaeddf	TRUE
fdfhhebddfdgdj	TRUE
hjbcdj	TRUE
eccbfjdiijibhffjfidjjbbic	TRUE
hf	TRUE
jieifbjjfehcfbaeja	TRUE
hidacffaadhdcicdhgfd	TRUE
ffbejfhjcjchff	TRUE
jefjfehfbacaihjgaaeee	TRUE
hijidi	TRUE
e	TRUE
iddcbea	TRUE
gjhddcaajefeihhiagejd	TRUE
de	TRUE
aiaigeichccffj	TRUE
ahjecedihii	TRUE
ic	TRUE
icbdcbbiig	TRUE
facj	TRUE
gbgfiefiaegcieh	TRUE
iehjgcjgcfiejaa	TRUE
eeafccdda	TRUE
hgfbfjdfddigacfjiaj	TRUE
beegcidbffafcejfcdcahag	TRUE
ecddffcehjchdadhefeh	TRUE
jgjfdaedfce	TRUE
bdddbcggfbgieejcgfjd	TRUE
dehfbgdb	TRUE
edfgehdff	TRUE
ifbjiiifbef	TRUE
fcjibhjdfhghaffcjdhief	TRUE
ddiiehgcf	TRUE
eecaf	TRUE
bfgefccjecc	TRUE
ddbhfaadf	TRUE
gcecbfbdbgceiaeaeccg	TRUE
cbcjcbjbebfiejfaaiejaeg	TRUE
fhgjhceecgchhdbdjafdgdidh	TRUE
bhcgdjdgchfjiegjgedig	TRUE
djbjjcjhidejebbdigejich	TRUE
hejeiihbbgcegcid	TRUE
ecfbiecbgjfigg	TRUE
fbbhhacjgjc	TRUE
idhhejfbgdbjdejibh	TRUE
fgghcfgdiadhdhgf	TRUE
jaidgciai	TRUE
hdjjdbheaeagedidjjhhjafah	TRUE
aficdaaighgfajefc	TRUE
gdcfdciebiibb	TRUE
fjjibefich	TRUE
h	TRUE
cjefbfbfbchjeaaaccgdghe	TRUE
bidfdbaice	TRUE
bebhbhhfhhejbjh	TRUE
cjghbcggccfhdaei	TRUE
ejjbhg	TRUE
ejh	TRUE
hgi	TRUE
ig	TRUE
fcfdcjgjjiggjcacd	TRUE
ibbbhgjeggiiaadef	TRUE
jecighidicjijhfddc	TRUE
giebghcghhcfiddhc	TRUE
d	TRUE
cbjhgibgjijhahiijdcjefhg	TRUE
eiieajiciegajfeheh	TRUE
hjhc	TRUE
cbicdihggccijb	TRUE
dgcijfccecfgfe	TRUE
ccghcdgiehecidjbhefcf	TRUE
bffgbciidjccfcjicajggg	TRUE
iic	TRUE
h	TRUE
gggeechehgad	TRUE
fgjgdfadefhcajchciagej	TRUE
eaaahfdidegh	TRUE
dfbggehjffidegfjij	TRUE
jc	TRUE
fce	TRUE
feadc	TRUE
jegbcdhbfjeddffecbdaicfei	TRUE
ejcgfa	TRUE
egih	TRUE
hdgficifeiafjaaggefgjhf	TRUE
cbbfbggbbifbbfej	TRUE
bbeidacfc	TRUE
fdaccgcdhaje	TRUE
cdfdjbbjgiiebjjijdbaidh	TRUE
fjjagiehgggdcafcafcecfieh	TRUE
eidaaajgiidfjchefjdccc	TRUE
cbfdidcdjbdfadcj	TRUE
gjebhhfhjhicjbidfd	TRUE
ibchefgeacafda	TRUE
fegbdfgjhjghfcggdgafa	TRUE
fcibghed	TRUE
bbbchhiheibbbjhjdie	TRUE
gigfjedegciffafjahfdcg	TRUE
ggedggfhaha	TRUE
jdhfcihc	TRUE
iebecjcicgcijicbccij	TRUE
iggj	TRUE
ghbdbefijcgdjgjhgdcijcfi	TRUE
eighfbdiiaaffaiacghicej	TRUE
eha	TRUE
cbgjgefjgcjfbiihigfdfdib	TRUE
ggefgfifdghaiijih	TRUE
jdbe	TRUE
g	TRUE
dehfah	TRUE
fchhdchhijjjggfhdijaghjjd	TRUE
ibjdicgdgfcibhfefcjgia	TRUE
iicaggjhhjgj	TRUE
ecg	TRUE
b	TRUE
gbhfbhfcfdcbdgfbgebghdg	TRUE
cjgbcaigjdfjffjgieg	TRUE
cifjhgbhhhddc	TRUE
gjihjjggfhjcgfhbbfgihij	TRUE
bcbfigjedddgdh	TRUE
didcdfhgefdeg	TRUE
chjjjbafd	TRUE
ciffhdfhjfbfcjeaehdeadah	TRUE
ijceahh	TRUE
ccehfecjcbbjefghbdddjaa	TRUE
ddececcijcdjgjbahh	TRUE
dafahahdedejefjcaeghhiahh	TRUE
ggdbicibhffc	TRUE
agaidgiahiejj	TRUE
eijfigfj	TRUE
aeddfjgjhfhdhchaeggaidi	TRUE
hdbdicjfjjejaaf	TRUE
daiiiggdihicgdchdg	TRUE
dggbdebbafjfe	TRUE
jeehdicjhd	TRUE
edjeffjfegchigihdhaaehfh	TRUE
hddffgdegj	TRUE
hichedefiie	TRUE
ahefjecgchji	TRUE
fb	TRUE
fdijici	TRUE
hjijjfjdedhdbehcifidh	TRUE
dhh	TRUE
gcehd	TRUE
bfdiccbh	TRUE
ibdicfbdagchcgeea	TRUE
agcfeffeefdgcjgffjeej	TRUE
hceicedhjbea	TRUE
gjjhf	TRUE
gfbhfehaeechfeedihfafdg	TRUE
fjcjeejijedghgeeacc	TRUE
gggedeefdiafeifehdj	TRUE
hgecfgjgafecghdje	TRUE
fhb	TRUE
dfdgjhbhbhejj	TRUE
fffehdgddigffhdcecb	TRUE
cdhebeaddajhhfc	TRUE
gahiejgaj	TRUE
cjhgbbgeifhijig	TRUE
gdia	TRUE
bfdhebhbbdbjj	TRUE
gddbaajhef	TRUE
gfdhjbihaidjedfdf	TRUE
ieidjhehghjfjchacjfd	TRUE
cgijf	TRUE
dcefhcdhebhijbjcidi	TRUE
fgdfcfff	TRUE
ebccdaigfjfegjfjaa	TRUE
eccciaijcjehhfi	TRUE
idh	TRUE
geageiifdchcea	TRUE
jafahdgjigehfh	TRUE
higadhicejeega	TRUE
jgjhhhjiejfiifgfdijghcda	TRUE
aieggcfjfdhg	TRUE
biigcfiehbhjgeibbi	TRUE
jgagcg	TRUE
hgdehdbjjbgd	TRUE
gefg	TRUE
jhijbijifccaf	TRUE
jdcbfbbfijdjddj	TRUE
cdjfffbcfjjdgfbcgajfff	TRUE
a	TRUE
ajjehicfiifghfccicgcjjcjf	TRUE
dfec	TRUE
jchgfffaijgggdifefjehche	TRUE
ijfgifgjhjgcijbdfbbafj	TRUE
aaejhhaefeccd	TRUE
bdfef	TRUE
egeijfbgadiiadedcahg	TRUE
iddigaccjedhad	TRUE
cgijieiafdeeaacfighd	TRUE
eja	TRUE
cbeijbdgah	TRUE
debeigfjbbhjehcegcidecg	TRUE
hgfiig	TRUE
dbfejd	TRUE
id	TRUE
ihdigeafadjiiaicdd	TRUE
aiecddfagjahfedhf	TRUE
ccbcghjigbdgfeca	TRUE
di	TRUE
dbcbhgfifgjghgiefjajgfjg	TRUE
cjfgafdgjceghjjca	TRUE
caah	TRUE
gjjghcbjgcifefe	TRUE
ibhjjaj	TRUE
bhdhdha	TRUE
jahdae	TRUE
bgdhejgcbedeahaa	TRUE
icjhahic	TRUE
jifdbeifbhffcgi	TRUE
iigffgbggaaahdcf	TRUE
jgedhedggaeeedhjdaaidjgh	TRUE
icbdfgidigcihaddg	TRUE
hffdbachheddfcc	TRUE
djaj	TRUE
baedjfedjadcdijdef	TRUE
ejhjjfgfcfdafdcafehjea	TRUE
cdicjcaij	TRUE
jffcgbbfjhaceidfaccciigad	TRUE
ibgh	TRUE
bjedjacjgejiaiidac	TRUE
afeeg	TRUE
jeecgddhc	TRUE
fhaaaegjhedgae	TRUE
hhcedjegbhfgjd	TRUE
afjafgf	TRUE
egdegfaj	TRUE
jijbbehgejehddiggdcjjfjdj	TRUE
bcbccjijgjgcbejehh	TRUE
fcfijhaegieifiaecgajf	TRUE
gechbdiecgafjdfdc	TRUE
ghhfbecdacfdghejihiaghe	TRUE
bbchibhdifjhbidchaafdedej	TRUE
hbejigbffcddhicghaaie	TRUE
jibce	TRUE
g	TRUE
gcdbgbbeffjjgedhb	TRUE
bgcihfefhjgichgihgdah	TRUE
jgjegichifeigebcjjd	TRUE
eiejehaafagaefdf	TRUE
g	TRUE
biijeicfjg	TRUE
cjcjfchifcebghjjgighijic	TRUE
idfjcfiejhcbhdegjhcdi	TRUE
ieeiaeeadi	TRUE
hhgbbbgebgbaeggidgjfgdffi	TRUE
bhhfe	TRUE
fce	TRUE
fjbdibjebiccjhhfjhbfdbe	TRUE
jbfcchfddcdddghahdg	TRUE
gcghifcigihdf	TRUE
ifahai	TRUE
ciffj	TRUE
ecdcbgeagfcifegigceah	TRUE
hcifbbggihjj	TRUE
hdejgdieahdcihdiij	TRUE
ebbdcgaidfiej	TRUE
fiihgicddbgibejheahgi	TRUE
bjijibdijdjiafaid	TRUE
hgaaeijacjdchaf	TRUE
d	TRUE
hhhffjediachga	TRUE
gcieicfiigejiaaheffe	TRUE
bjdddddebcjijhfibgdeegfc	TRUE
bjhajcf	TRUE
jggjbcb	TRUE
gehjfjedjdjfbdfaicf	TRUE
eahea	TRUE
bf	TRUE
ihdcdhbghhajafdedadfahcf	TRUE
ceifgdcaigijcjjhhegjjdcc	TRUE
jidfdhbgh	TRUE
ei	TRUE
ejfjeaeiagffghhah	TRUE
i	TRUE
fc	TRUE
cdbadhghjhdcgjhc	TRUE
eefjhebffgcddiaj	TRUE
cedadcffechfaggejigfda	TRUE
hfhdgbbaecjjifchihdgiccc	TRUE
ccbec	TRUE
bjjgidbgdfjhchfifdhcgcaej	TRUE
egjcffhefhicjbghihhgcje	TRUE
beigjgieghibjiajfigfijfc	TRUE
ffcejajidjacfejieigci	TRUE
cciedccjchb	TRUE
hibhhheehfdgeejbc	TRUE
g	TRUE
fddcgbdffgbbhcbchcci	TRUE
gbjeeedhcgjdgjchfjig	TRUE
hdhihgcbhehfa	TRUE
ijici	TRUE
idc	TRUE
hhhjgd	TRUE
i	TRUE
h	TRUE
bbagajici	TRUE
bcaciiegjii	TRUE
gfhgdigbhheafh	TRUE
ijjdjj	TRUE
cjhccgcfaaahiiad	TRUE
ihgifdhegadfg	TRUE
hhbbae	TRUE
ihcijfdffdagd	TRUE
ffdecdc	TRUE
dfjffbc	TRUE
ehcecfae	TRUE
hhdig	TRUE
biegggbbbddihhgefege	TRUE
ghbjdcbi	TRUE
ccea	TRUE
jebcghbdbjh	TRUE
fafddiieddgagececgi	TRUE
ifdghjebhbehfadf	TRUE
hbfbeibhahdag	TRUE
adaiffjdcjdjcgdcdgjgj	TRUE
gciaheij	TRUE
efiheeedjgdbejjbbeficfii	TRUE
ceifghddfggjcjghafjccf	TRUE
hc	TRUE
jfdejhcdic	TRUE
edeidcbjiifdigbghgbajdeij	TRUE
gcgeb	TRUE
bbdiecihijjghedcgicebb	TRUE
jbedjdiibadgegfc	TRUE
ggafacdgjf	TRUE
ddicjaiegjijahdehffhfahe	TRUE
ae	TRUE
aeageeeacigehihhdhej	TRUE
cgcdidjebeggchbjgai	TRUE
djeijhbbfjibfgeafdg	TRUE
ebdhbfdffjdhgb	TRUE
hgag	TRUE
jcgejf	TRUE
bedbcbddhbbfhie	TRUE
dh	TRUE
bah	TRUE
aaiiehjeeiihahiahe	TRUE
djfdffghbaia	TRUE
ghgcedffbedfbhbhjibfa	TRUE
ieadidcc	TRUE
jjbagci	TRUE
higcidfhacg	TRUE
cdehjaeai	TRUE
geidfeeahhh	TRUE
daejddjgiageajecegca	TRUE
dffajciifiijiijjaie	TRUE
bbhedfbcefcebga	TRUE
didehhgdaaci	TRUE
ejceeicia	TRUE
jgcfjhcgcgiebedfbgebih	TRUE
hfchgfcafcjfa	TRUE
eff	TRUE
ihijjifd	TRUE
hibgbgcjjgifghhdfbhid	TRUE
bfcggfhcbhjdaeggiihgjacf	TRUE
jjfjffjg	TRUE
hfiggfji	TRUE
jhgg	TRUE
dijchji	TRUE
hhiejdjgjcgjj	TRUE
jaiij	TRUE
jja	TRUE
fbbccdgcbiiiifcc	TRUE
hfdigdjddjhfbajaeihjgga	TRUE
aedfjeddeeaghdiehfied	TRUE
ifbcjfjgdbcghedgbhd	TRUE
i	TRUE
eiifajcc	TRUE
ehcadijg	TRUE
geghbggeiicdi	TRUE
ifeb	TRUE
iibeeaehdafjefjeciidch	TRUE
acaggefci	TRUE
dadafdefa	TRUE
ijjifhaeiad	TRUE
hj	TRUE
ddhbgfhfjcebif	TRUE
gejddbefjja	TRUE
didjieiiiebajhejij	TRUE
ffjchghhidjcj	TRUE
fiebbcbjibfiafigehf	TRUE
cbhieebghcce	TRUE
eegcgijfegcegejbjhcf	TRUE
bdgccecgfg	TRUE
bfidfifhddegijffgjfebbhh	TRUE
cieefbdcihcaficdhcd	TRUE
ghgjhhjfegbbhjagcgecdf	TRUE
hebaaiidie	TRUE
ib	TRUE
cgjfefajgi	TRUE
aiaaaic	TRUE
cdeefdcdc	TRUE
iijdhhcdhhajjah	TRUE
ggdhhhiggaiehgfigajdfa	TRUE
fbbjdbi	TRUE
icebf	TRUE
djdhcifbdbdhja	TRUE
d	TRUE
jegehhcghhbaaccg	TRUE
gajee	TRUE
cdjiifdhhb	TRUE
ih	TRUE
hbeccggijhbjdbd	TRUE
gac	TRUE
iigjgiehfhhfcgcjd	TRUE
c	TRUE
jbbjfecfjhhbdi	TRUE
eiajfe	TRUE
dcdbfea	TRUE
ehhgebjihcejjbbh	TRUE
hegdih	TRUE
cbgacefhjfciajgdafh	TRUE
jfffeefj	TRUE
bcfig	TRUE
fba	TRUE
bbgcdbhce	TRUE
aggjihjcaj	TRUE
jachjhjfhg	TRUE
bjbjeciiiiaic	TRUE
cecdigijeidaaheajdefajd	TRUE
jeegjjehgicdhcghbf	TRUE
a	TRUE
digjejbhejcbbgcgfcjaigc	TRUE
jdhijg	TRUE
eh	TRUE
e	TRUE
gb	TRUE
ddbccceehjfcccgbbe	TRUE
bcfiidbhbjeafhje	TRUE
hjchbbbbaic	TRUE
ddbcchjgbjafjgffidjgfj	TRUE
dhbbjchcjedibicgbcdi	TRUE
fada	TRUE
fjggjbbgdacc	TRUE
jfbgcg	TRUE
icif	TRUE
hgcfdeaeacea	TRUE
igifeeibgiedebdfjg	TRUE
hchebbebihdbbgdcecffghcga	TRUE
fibhgfhdgihdcbidjegcghec	TRUE
jib	TRUE
giifcceefejacjg	TRUE
diidccchbjjcjiaai	TRUE
ghhfggcdedbiihfigjc	TRUE
bgjbbjeehfhe	TRUE
gfdjggedbba	TRUE
fgegaddejhagcgdaehajgjici	TRUE
dbaedgha	TRUE
difdefiibcfeahheddeigce	TRUE
edficidcgh	TRUE
gedfiffcddfdbaggfda	TRUE
gcgfhbedfifjcbc	TRUE
bcjecedbbccdfiddbjeibcegh	TRUE
jcdhgbicfjjc	TRUE
edbifbgijhjjiej	TRUE
jec	TRUE
gffgibcdchfffiigefed	TRUE
cjhdgic	TRUE
badeahc	TRUE
ighficbjhaifjdjifaedaf	TRUE
ihjbgibfedij	TRUE
jjha	TRUE
bifbai	TRUE
bigddaggg	TRUE
acjdafdicfdahdahcggigi	TRUE
jbdihhieaccahfede	TRUE
hdefchfbifjg	TRUE
ddhebgffbgcdghdcifgee	TRUE
iiegdicdejcbifbfegbj	TRUE
jbafehcgjaddejgc	TRUE
ahah	TRUE
acifg	TRUE
hcgbgeh	TRUE
cjcbhijbbd	TRUE
aggfegijafc	TRUE
dbejfeihggfbbcehdbia	TRUE
hfcfifagifejagggfafiiajca	TRUE
fgeeiggfig	TRUE
bahjgjgedajagchf	TRUE
jciibfdge	TRUE
gdfibdgjdjacjcijjacccjhcd	TRUE
dh	TRUE
egd	TRUE
cfdhfdebgjg	TRUE
igdgch	TRUE
jebhibjjbbjc	TRUE
heib	TRUE
afhiggfieedeadajfdghgi	TRUE
iefgjedceii	TRUE
a	TRUE
edibafieejjhhejgg	TRUE
dbidiedcfejhjcgbgibhiccja	TRUE
ijdgjfghjdgahfc	TRUE
fgjhbgaheej	TRUE
dhbbgbejbbjebaigdfehf	TRUE
hfgfccffcgfajhjaggdj	TRUE
hjiaecjabdieiegebcjgj	FALSE
gcieadabj	FALSE
hebdbagabii	FALSE
ahffiebacfhjchhchbhhg	FALSE
caajbhjgji	FALSE
ghaabebajhdhfhfc	FALSE
ab	FALSE
ab	FALSE
jjajfabj	FALSE
acbcgigfcj	FALSE
ggbgeahbecfg	FALSE
edfibaidbfcijaefigfifdhg	FALSE
dafifdeegadgcdcchbbgii	FALSE
fdfhhbaabg	FALSE
aeeaedb	FALSE
gachfbhebbdich	FALSE
ghaacbdibj	FALSE
aagecgedgdiab	FALSE
hbffbijdadaegib	FALSE
gahihfdfabedcjbch	FALSE
bab	FALSE
iiacfdjbdbb	FALSE
ab	FALSE
dijadfadbdf	FALSE
abbghh	FALSE
abejefb	FALSE
hbjaiabiihc	FALSE
ahb	FALSE
aib	FALSE
badddccdafadahabd	FALSE
abb	FALSE
cgdficfjaajjjadbeibbhe	FALSE
facafdgahgdcb	FALSE
ajajbbigfijfgdgcdcgd	FALSE
fdfccjafcdabiegdibj	FALSE
ahjb	FALSE
ajaiefdjggddghafbegebeba	FALSE
dabjeejdahddgbbjbabid	FALSE
ahijieabbcdiiecbie	FALSE
hbiafabigigaebdfi	FALSE
aabb	FALSE
adfifcdaabjhaagibjcbdi	FALSE
fajhebigg	FALSE
deeabjeda	FALSE
jahieeiacbhcie	FALSE
cbab	FALSE
ahaddgcadbaaedadiadgfbj	FALSE
gaaahghbhbbdd	FALSE
iahdbhic	FALSE
cfcagffidfdfab	FALSE
abaa	FALSE
bdaaffagbgchgjfgh	FALSE
jfjacjcfb	FALSE
djchafeba	FALSE
acjcgbgjafdiege	FALSE
ajfecbffachgaj	FALSE
icijajgdbbcdf	FALSE
iiajdbjibgd	FALSE
facgheafagfjcijcdddabbega	FALSE
ebhjdfaejhbffefada	FALSE
hedahhibaijchcgadchfbd	FALSE
abjffdfejbhahbjigaccjbb	FALSE
fdhhaffb	FALSE
ajabbbja	FALSE
daejaiiabbh	FALSE
ebfgdbhbificahhibejiahhea	FALSE
bajfefacfdgiihb	FALSE
ciicaggdfafdfffb	FALSE
bgbigdbafgahdab	FALSE
agbeajhbdeecifib	FALSE
aeaibcjjeheifd	FALSE
ifcgbdajbccaheabjdb	FALSE
acedgjfbabibec	FALSE
egjadfdceajfbeg	FALSE
abjjag	FALSE
abgaa	FALSE
jbaceagciibhcbidcbhhechbf	FALSE
cefdbdehdaafggfbf	FALSE
iaiceegihcfeaaffbgihbh	FALSE
ab	FALSE
djageagfgjedibcbadfccjj	FALSE
jaggdbbagdcbfjdeghi	FALSE
higajfjcaidhibieg	FALSE
afdbd	FALSE
gchafjdgb	FALSE
aabab	FALSE
diahagejeafbi	FALSE
addiejgdabdhgbfccddbca	FALSE
cghaajbhgfje	FALSE
gfafcdb	FALSE
hbjabjbfd	FALSE
idbaifbfhdhjd	FALSE
fiadbdb	FALSE
ab	FALSE
aggabb	FALSE
dbfacfdbhccbhbjfhh	FALSE
caccbjgcibjahhdc	FALSE
jabeggiidjbh	FALSE
aaheibaiiaibbib	FALSE
habi	FALSE
gaabg	FALSE
icdbfhcfbaefjcbabj	FALSE
ab	FALSE
hagb	FALSE
fgfdhjhaejbeijfjadjbhi	FALSE
baedgb	FALSE
aeifbfcigfbjbij	FALSE
cehab	FALSE
afifffhbagbabfeibjbhc	FALSE
febgfdbacfdabb	FALSE
bcbibcajijdagcdbba	FALSE
aaiba	FALSE
hcehcehhhebadaejibjgj	FALSE
dgcddedfegecffdeaijbg	FALSE
ifagbcjaigjjehfgfj	FALSE
ebdejab	FALSE
jibabdbcdcbbige	FALSE
abh	FALSE
fibab	FALSE
fgaibgjhbcbbga	FALSE
abcefg	FALSE
hfiaciaggfbabiafgejj	FALSE
eajgbabacfdachcdad	FALSE
effibifjcbajedaaahafb	FALSE
jaabdgeffajbdafejcej	FALSE
ggjjhhhaiabe	FALSE
aiabcebidgefhfag	FALSE
ccbgabdaffbiidf	FALSE
fajcegabechfeafjejeijbji	FALSE
gefgfagffahjafbg	FALSE
dcafiggbijgiagjibhabi	FALSE
cgcfhfjcfeabhehaafb	FALSE
gfejbaefhefbfcgejcjjeg	FALSE
jcjiieaaidbed	FALSE
ajgeadhighgdbijbjfbj	FALSE
hacaeaaidgaabe	FALSE
iadicfajggidffbgdfcaebigc	FALSE
ahcdgheabfchfbcgidcaccbg	FALSE
jabgaibfedhadffjidbidcgfi	FALSE
bciaffbegabhbbihfiedif	FALSE
ieajbbdajbbb	FALSE
hadbcci	FALSE
affaaejffjibeajjdfaeb	FALSE
adbdgcgbahccbibbeiea	FALSE
dab	FALSE
abh	FALSE
fbjbiccjgafacehbab	FALSE
jbebgidcfabf	FALSE
bhfaacddiaggiaheeabdib	FALSE
afb	FALSE
adejhahjadahiaaabbcbeji	FALSE
dffccfbaaabjabbbijgb	FALSE
cdibiagdjb	FALSE
adaibhfbcgcdbbgjae	FALSE
jgcajhgb	FALSE
hbaahegbjgab	FALSE
dfdabbebejifdhcjdgedddf	FALSE
agfiafddibhhh	FALSE
cjicadjicbaadbb	FALSE
fffafccaaebecf	FALSE
jacdiafcidggegecibfhb	FALSE
acbb	FALSE
hijcagiebejaacciieieebhb	FALSE
dibdafgbbehgjcgeiebghgcfe	FALSE
jbafgbida	FALSE
egaeibh	FALSE
egbjfaajiaidhgfchjedafdjb	FALSE
gedacbeg	FALSE
begabghchiheghcggb	FALSE
gjdegahjddb	FALSE
ab	FALSE
iagbciegfaiccjibd	FALSE
edihieffceiahjeeefgeaheb	FALSE
hhabhhfebe	FALSE
chaabahjieb	FALSE
hhab	FALSE
fabga	FALSE
hbceagddajbbjahdbiijjibji	FALSE
ab	FALSE
jgjiecaacgddjjhbcg	FALSE
jjagaabdcifgh	FALSE
abhgjihiaeb	FALSE
ab	FALSE
baebcfabcb	FALSE
iacabdbbhaabhafgfgbii	FALSE
gfjichjejabgfc	FALSE
cijjaiccgbbiehhij	FALSE
jhaibhb	FALSE
fagcdafffbgaighibfe	FALSE
aahfbdd	FALSE
cbcbcfabhbddgighhfde	FALSE
afbgabgj	FALSE
cebjaejabjbeadj	FALSE
fbiaficb	FALSE
faicbdcjgjhiidafghcbfbb	FALSE
gafgccjhedbhb	FALSE
feabei	FALSE
abcba	FALSE
gbdcdigfaebg	FALSE
dafaeadab	FALSE
bigdjfiabgdcbhejfejjebeb	FALSE
hab	FALSE
abecfidc	FALSE
cafagbhaafgaac	FALSE
dddhgijaagcahcbhdjed	FALSE
jeefcghcdafccbhj	FALSE
ahijdbhg	FALSE
abb	FALSE
ahb	FALSE
agfeibf	FALSE
dggabagfdhaffddddhbh	FALSE
ddggijhdgbiigfdhafbb	FALSE
abfcjjgdeaeib	FALSE
dfadfb	FALSE
cjcaacdcdeggificfabccibd	FALSE
gaajgebijbgcdhe	FALSE
daahfiaccbdgahha	FALSE
dajbfdjaidhgaiagabbcah	FALSE
acbb	FALSE
iicbjafgihffgdbjgdhfhbj	FALSE
adacdffcecggbbbbhjafbbgi	FALSE
jejcaebb	FALSE
adhjaebajbehgfebafbjjbg	FALSE
ab	FALSE
ffadba	FALSE
efiajb	FALSE
giaejhdfb	FALSE
heedcfaffcigibfbhjedf	FALSE
hgdciibefdigcacghecib	FALSE
aghdhbb	FALSE
ibbigaifhaicbbefj	FALSE
dghcaiecbfjjc	FALSE
ajb	FALSE
fbdcfabhib	FALSE
aahdbfbfbfcgabb	FALSE
eeheaecdfjehifhbbhfb	FALSE
iddahgbfahbfjg	FALSE
fihbbbabdjhfjebbiibhcdh	FALSE
aahdagfjcabfjg	FALSE
fabeabc	FALSE
abbhd	FALSE
bdbahdbcjbcggg	FALSE
ajibahggjefbeej	FALSE
aabigddiic	FALSE
bafgbhedhg	FALSE
hbfaajdfgbh	FALSE
fhfahcbecbhjbhfdhdg	FALSE
fjedadadaejafjb	FALSE
ihbibafihfbcfcab	FALSE
fhadbgef	FALSE
abffhacgjchihfhgbe	FALSE
hehacbjafgcfibidjfgec	FALSE
ggabjaibijggbbefaggccbcc	FALSE
ab	FALSE
ab	FALSE
chfdaiijbfacijaee	FALSE
hfaacdfahbebedgfeeb	FALSE
dibbfabh	FALSE
baidcdidhbeg	FALSE
fbheicccaiijafahcbhbbbid	FALSE
jaeaahajdhaedjibb	FALSE
eijiciieahdgbhhbjihcj	FALSE
adhbe	FALSE
dadgbffibbieedieibfgigd	FALSE
dbbafbd	FALSE
eajdafddbi	FALSE
hcddahhgbce	FALSE
egadbbjbfecgf	FALSE
ajbbhbdcgajdibchdfbjaah	FALSE
eiheceafcjhcggbdbgh	FALSE
aabdb	FALSE
beabded	FALSE
abbi	FALSE
adcb	FALSE
ghahdggfbjc	FALSE
ehaceaacaeccabcg	FALSE
ibcgchebafdabagdjhejbc	FALSE
dahbeajhfadfcagbbjd	FALSE
afabbbibb	FALSE
gabb	FALSE
acaagjeeieaejgbiijec	FALSE
afibcj	FALSE
ibfaib	FALSE
adaeehfdceccghcbejfhha	FALSE
ggdfdjjhabjjfadib	FALSE
hbeaejhfebcdhcfifbafd	FALSE
ejeifebdgajafccccfbc	FALSE
gaejbbeaaihadeiiehijebdgi	FALSE
faeiaeafbjabibacbgghha	FALSE
fafecgdgaaifdhfccb	FALSE
jefihigacadfbceead	FALSE
abeacjci	FALSE
ibfbabahicbbefgjidb	FALSE
gehaba	FALSE
aegbi	FALSE
fggjcihahab	FALSE
hagffieib	FALSE
ccfjabiebiecbcif	FALSE
jabbdiggdhfebiggjbidddhe	FALSE
ajabhae	FALSE
dab	FALSE
abgbidibcicgghia	FALSE
jhabbgb	FALSE
dab	FALSE
eafjgcfaegdaghfgdijbhd	FALSE
jehbajaegfaieffbgg	FALSE
abe	FALSE
eadeibbhfbadbjcdj	FALSE
ab	FALSE
ejhcdbhdjagaahhbaejb	FALSE
iiccaahgabcbibfjcgbhih	FALSE
ab	FALSE
djeffabcg	FALSE
hadecjhadafdafbj	FALSE
aiadecgibh	FALSE
ajabdbabb	FALSE
ehafbffcebafbcg	FALSE
djab	FALSE
aiaabgfgcegegcbhbeg	FALSE
aicbgeacbgjb	FALSE
gbbecccabbbej	FALSE
dadhabbeajbbbabdc	FALSE
hjcacbfaihaffbbbcfb	FALSE
jgjahcdbca	FALSE
gaacajaefadbfhaffaafh	FALSE
bfjjcahbeg	FALSE
ffdcjhagiecaaffaccecjgab	FALSE
aaaajb	FALSE
afabdfegcgdb	FALSE
eaeejchbacabjddig	FALSE
adbdj	FALSE
acjibbab	FALSE
iabedicigfhdggbh	FALSE
caebgebijcee	FALSE
dihhbjcaibbccdacghf	FALSE
eagfiaegbbed	FALSE
chdagiafccaidbdbei	FALSE
aacggjhjjfbi	FALSE
jabcf	FALSE
jdhabdbb	FALSE
eagb	FALSE
caedgecifjbijidhdij	FALSE
jhbgjiabgbhedjehb	FALSE
ab	FALSE
ab	FALSE
egjcgagggaaaaichbce	FALSE
aibf	FALSE
faddabjccbbjb	FALSE
abb	FALSE
agbcbd	FALSE
hfbdabafgej	FALSE
eagiabadafi	FALSE
eaadbcgbf	FALSE
adgbjicdhfhihefjdaegjciah	FALSE
aijbicjaeaeacchcbjbcbifb	FALSE
achceacbefbfa	FALSE
hajbh	FALSE
fhbigafcfcgbihb	FALSE
dejijaeegjdbgaacbhghdcbje	FALSE
eabcje	FALSE
hgaeihbfeeabhfeffieabb	FALSE
iaiddgbggefhbgbfbdghh	FALSE
hgiafdjbhbj	FALSE
aiabb	FALSE
abhfc	FALSE
jbajhahdgcgab	FALSE
jbaheiibcbgbdhacgjfcbddjb	FALSE
hdjgffbjcecaiddigchefba	FALSE
fadjgiaehjefhfgbjiggg	FALSE
aghahhdahbbjhcj	FALSE
eaeijgeibjebbhhagdi	FALSE
fdafjiebdghdifdj	FALSE
cihhajbgjieiafj	FALSE
bagegabbj	FALSE
gheaceacghbfhhicbecce	FALSE
ifchfjajffadhjabcfg	FALSE
iajbfbfgfbga	FALSE
gidghfejafhajigib	FALSE
aeiggibibegbfgehfadbijedg	FALSE
eiegajehjjdbaebhgbc	FALSE
abcihgafefcdh	FALSE
jiiicdbifgcejbfiabedbdh	FALSE
aceccedidcbjjfjacadbga	FALSE
cddabeabjajgjbadfdcegedg	FALSE
hieajibec	FALSE
gfeaafegbeaeebiaba	FALSE
eaahbe	FALSE
jejhaeiajbdjafbdibdiebd	FALSE
dagaaidbi	FALSE
iaagjchgaefbefbhiicb	FALSE
jedeabjaadbfhaibfafjiffeh	FALSE
heabidiegaijbiegfef	FALSE
fab	FALSE
aaghbd	FALSE
aabbbdcb	FALSE
adbb	FALSE
aaaabdgdcbijjdfjiejadeee	FALSE
dabafjfeabbhhbjd	FALSE
gcacdiicbdbgfh	FALSE
ccigcibfcgahhbjdbbcdjcjgh	FALSE
gchcibjjaeifdebcjjdigic	FALSE
abhbddfiaeiheebiiejd	FALSE
edeabahehbccabcaaede	FALSE
hcagbeheeccfh	FALSE
fdfdgcijgafb	FALSE
ihbgeiaccdigb	FALSE
ecfabdaffcjb	FALSE
hdgccjdgeagdagjajhb	FALSE
jfeafghahiddcbff	FALSE
afahdb	FALSE
iab	FALSE
acjb	FALSE
gddjgijfdgfajeiedgba	FALSE
aaifbjbaaggahfhjbbhcagfga	FALSE
acbfhf	FALSE
diicacjaabh	FALSE
ab	FALSE
hicegbaiicaeagaffhjabaf	FALSE
cgiedjaieejgbagja	FALSE
efaahbafedb	FALSE
abhffbabajdc	FALSE
dhdidejaab	FALSE
adjgbffgj	FALSE
biijgjejcdbaffhadadibfcfi	FALSE
jacaibeiehddibfeg	FALSE
aagadjibcd	FALSE
ibbdadgdgibjfabjg	FALSE
abahibja	FALSE
djgabcacafhhbbefhd	FALSE
gjihajbjdicbfagafjja	FALSE
ahecebg	FALSE
ifgbjjagbbjj	FALSE
gacbcgacgcegiiffdbafchbe	FALSE
ehaccebfgbhbggddgg	FALSE
bhahaafdhdabdd	FALSE
abag	FALSE
jjbddhbdhabjfbcgajbb	FALSE
eeaabhgfadbccachdgbghc	FALSE
ehagebjhbbhh	FALSE
cicaaabidbeghagjhb	FALSE
aaaiceb	FALSE
ceafdadjbcifeicjdbedhdh	FALSE
afeegehabiiifhehciafbcdd	FALSE
jadhhibf	FALSE
jgfhjabb	FALSE
gafiebf	FALSE
aifebcabba	FALSE
abcdi	FALSE
cjfagcebgchbefbffbbbfcceg	FALSE
adbd	FALSE
haeeaijijfbdee	FALSE
facb	FALSE
abe	FALSE
bab	FALSE
chiehajiiejibeei	FALSE
cabihbgcah	FALSE
dbaehafahjdabfgicjfjaf	FALSE
fadabba	FALSE
cjgeeeeffabedhdjchcbbaadb	FALSE
dddfbadhcbfbhebdifjeabae	FALSE
jabbfgbbaidhdb	FALSE
ddcfafeaecahjigjdabjhhh	FALSE
iiahhbbad	FALSE
ab	FALSE
ab	FALSE
edhhaacfecggjijcibjhaie	FALSE
ejejgaefgdb	FALSE
heahacgaehdhacb	FALSE
aehhbhaehb	FALSE
jedbaiaabibhajii	FALSE
fciabijadfejdd	FALSE
afhcjbeafijbiehf	FALSE
ahfbib	FALSE
daeehbjhbi	FALSE
abfafeadcgcbdabdfdgiidaei	FALSE
ab	FALSE
dabjj	FALSE
gcbgahccejccgabccdcebdhh	FALSE
gbhdaciejab	FALSE
fdhiaagbdfcfgjgbdibjhhi	FALSE
