c	TRUE
EVEArOFUQMg	TRUE
jzCcytNiqYvlrGXBZD	TRUE
Hrvqh3fDXszTtTMvh	TRUE
OMIhQYy3TKW1tzGWxRvwRcD1	TRUE
4t2uF3iKuS	TRUE
3MoXadGxHOjY1g3u1D	TRUE
d3fa3RHzXjb	TRUE
rVPjS3	TRUE
AbjXVzrXMVMz1xnY	TRUE
qvrOEhZUOUGy	TRUE
4	TRUE
3BqQocT2T	TRUE
4YhCJRVPrOEFezJpzoK	TRUE
ySlrEUWcivMZNEPoRypg1yGo	TRUE
dxMy	TRUE
GSDg2zmIbgly	TRUE
naRLWx	TRUE
hQG	TRUE
ciTNbnCBmQ	TRUE
yjCrNGogbePsuZnHEGP	TRUE
c	TRUE
EHyZwtRegSbsZVZSa4Xgf	TRUE
KdywCYizQyuj	TRUE
K2pUdxpjMBmizFKAtukuKftUz	TRUE
WmHgJHfyoBxR11cFOMcFm	TRUE
dvVgdESd	TRUE
4iN4KkPqlOVCTnnwPwbRjZxgP	TRUE
uAXbAfqFpVinqSbOkFeHQW4ex	TRUE
QmB	TRUE
GQbOTjiRSRezpuYemT2Jpd	TRUE
jdjhzuSqLBBl	TRUE
ulpSMcjzz	TRUE
KWu3eVIOJIyqocRkUuRSgRr	TRUE
UMj	TRUE
QI	TRUE
NzOnPc4xU22F1zFn	TRUE
QUDuCmizRtbNeLTpm	TRUE
YUCp	TRUE
HrjGSBcHH3CHyHCndQzK1WR	TRUE
mcpBbOhOjnBg4Q	TRUE
LUGQaRF	TRUE
VMVl	TRUE
VYRwj1viO2GPTLwrQRtmXVQT	TRUE
cfRPJwbWg2jsZ1wH	TRUE
PUFSgoC	TRUE
t4NmZHTtpGrq	TRUE
PTbiT2sjzhBwzX2ccmBtxC1OE	TRUE
SUsSbrmzeBWyXPWpYlxKCfCT	TRUE
Y	TRUE
iGu2Y3fdg	TRUE
UEIvneRsg	TRUE
xkxanIBoq	TRUE
U4ioJ22jczw2V	TRUE
yjuOIfAXFc4VR1TpIPKDb	TRUE
hQ3ADHLGVnDgMtNuj2qL	TRUE
YvCRbtaR2vuAcoaoa4b	TRUE
UGtUlmhgDKFeSEPo	TRUE
wjBYBcNd2W	TRUE
bFgNMlHeMMMMEf	TRUE
oL	TRUE
kwWZonBJiTJpCqtwas	TRUE
QkbkzKnpShvRwkzUlX	TRUE
C	TRUE
RDAPml	TRUE
HpHqYMWRuXl3Jh	TRUE
dHUnXjFibS1AfqW2VwFpSB	TRUE
uNA2gwmYWKd	TRUE
rKBtsieYmBmqXHI2WDAt	TRUE
OYOwOdF	TRUE
ZsPg2jTwqhfSrr3yG4sC	TRUE
ISAc	TRUE
C4K	TRUE
ldoHEUJGtNqEGeyhr2xn	TRUE
ejeG	TRUE
Vx	TRUE
XinERnLjvQ2BVU3da	TRUE
N	TRUE
WwKSqmTHrbpFUobGpVmzUgqS	TRUE
DDFlsjV1eam	TRUE
fu	TRUE
CkKJrHvo	TRUE
LMoafZeaPX	TRUE
N3yPrsIPJBF2MJEXbDdNkJ	TRUE
wX2P	TRUE
tweJviQtpEDwGGafSZTqN	TRUE
gTivdB4RBHEnplOpVQ	TRUE
F2hDkFpmoC	TRUE
CnPVlTvrn3f	TRUE
BB3XGKXu	TRUE
FWpM	TRUE
RrRtWLqmX3VGMAxbZWZ4G2X1	TRUE
cLhntlSkROdB	TRUE
Yt1ZyThRmtphiDtEDiifCCHj	TRUE
IEJgmuPiFFRgq	TRUE
a	TRUE
GYrDIosRA4uDnJ2utv	TRUE
MsbZQmsQftyxKfiRKWCkJPsiW	TRUE
spf	TRUE
EUF	TRUE
zdRTdGnnQ1uXVaoNjUhevg	TRUE
bNEJfVMai	TRUE
aJYTK3BMGHe	TRUE
Wkhzi2GTlbaQODi2oAo	TRUE
DIPkxYegspDD	TRUE
4HvY	TRUE
DGyEMvBfboOpkwtIeiiBxS3w	TRUE
AUNWQmnNv	TRUE
bdaBsSM	TRUE
oWGTnmJlGfSISw	TRUE
INpZqk	TRUE
SxnNB3QI1vgHQf	TRUE
EjLBwDB3dAxP	TRUE
WXF4rYR1	TRUE
4FEkGvPzBhrmCU2BhvtV1bJ	TRUE
QyPQZtglgaNq	TRUE
GUtIfMzDPa1rARmybC	TRUE
woGUoGgNZReHuMHfqD1xqnxh3	TRUE
oKbETQqxjG1PZViZ	TRUE
1NjqYyZDeXiEYIh2	TRUE
YRDXjIvYj334IhMBjYNp4pjdH	TRUE
jLZtsCJgqb	TRUE
VdZfSa4ZnDxBT	TRUE
jGVqNLWC2DQaKbfCYVMp	TRUE
ov	TRUE
Sqqd	TRUE
jUbMpCphqYmUlYRmtgUOi3	TRUE
dPfAHtXCAjhNBaXHzFpw	TRUE
XvPwdMtNwiTQJaFf	TRUE
vUKtYAyr3BpceWcwnvnuoEVw	TRUE
IMVplMDsq	TRUE
LdfqVpxk	TRUE
IfQjUmPpsvKFHRLtiXwYDw	TRUE
ntz3z	TRUE
QJIbhYwbUwoAgaS	TRUE
XJjFdzIAktA	TRUE
YncnNpTK	TRUE
lPObCkeEoiKkzl	TRUE
I	TRUE
XTMiXfovUcKUqZGOIvzgpM1	TRUE
eufEDmeS1iXzCXUv	TRUE
Rr1KCFyVOnaMNJWhG	TRUE
faxHE	TRUE
Xuwb2FqabqWavfnRra3	TRUE
LCPLb	TRUE
CVTJZFaUm4mSiPkVCJfHROo	TRUE
E4Ei1ZtPRgREdcTeLYAJsIk	TRUE
WKvbrQtC3SebrjNu	TRUE
dA1WffR3h3	TRUE
JH	TRUE
ZFnBtqBHOpJcvw	TRUE
jB	TRUE
SG3kOgDSMfkIOesTdprbN	TRUE
ZDEwVdHJzR	TRUE
JOFiQW	TRUE
RmwyKRXdLgZ	TRUE
HbFgKyWlAFGHvyZseeHLJ	TRUE
aI1dcJSOuRVDlkOrLCYmg	TRUE
acD2APQtjD	TRUE
aCauYPzcXQJBuyYFsiLm	TRUE
pBvrc1wjFPJjtZn	TRUE
JE	TRUE
XY2DcTOh2yM1	TRUE
1LEnlVrtLqSqsl	TRUE
EvsGffJGtL	TRUE
UUGbL1D3iAFARXsBO4	TRUE
WsivamJasXAA	TRUE
MnMtWLxhZQU	TRUE
X3XdIhhJ	TRUE
d	TRUE
KyBvPppoWM24GtQnNiWNfHZVU	TRUE
ozOfURvNEO4nAtL	TRUE
TI1URHxsgtCcEGO4igD	TRUE
ImAWDbq	TRUE
ZTRSUFBuypqO1URzL	TRUE
Cvvbp	TRUE
L2HCs4	TRUE
oCdAF	TRUE
rTqytCQo1lJMxIFVWSpDr1H3	TRUE
ndEWEQLwxxxUcnlvysb	TRUE
RUvI	TRUE
OceZVVFbeXkWlOc2Wj2cN	TRUE
P	TRUE
Fv	TRUE
jCWtFPlAurwxFUbjiiNQi	TRUE
MgZGbieBmt	TRUE
JAyKb1v	TRUE
iZJLJmgXyQokT	TRUE
WlPvVae2YiOIkUrR	TRUE
HBxRW1DTGGDdKaDurAeVcX	TRUE
XonB	TRUE
e2ed	TRUE
c	TRUE
JqfUd1vZ1kmrLxiM	TRUE
hCRiGphsSVhKPpiJzthaJmU	TRUE
lPwWbrQgQJXZ	TRUE
gIOuavp2NEyMvs	TRUE
zQbKer2KtpVE	TRUE
bP3PzIJAVI	TRUE
LYTwEzYAw3CTE	TRUE
XhPFCH2vTKNSkXX	TRUE
fhmcm1eTohKZCvQYKpOEkplA	TRUE
KgROSpD1zBuExa4mWmgF1	TRUE
INnxaVVA	TRUE
VfVGFQahck4LseIazJWSZDI	TRUE
whnRpG3t1mToWN	TRUE
AfosLScWGzjcLttUjIn	TRUE
TTzLDZqunF1	TRUE
ZStqamjISUEta	TRUE
ORT1GMPCThkl	TRUE
4PGxJQSRrsEZmlSPN	TRUE
jqpBAKZcvcJvAIPBAKphnP	TRUE
hw2PAm	TRUE
hEAR2ndJoG1Cf	TRUE
EAnH4I	TRUE
YhAcmmDHMtQFkaER	TRUE
ur2RgTEpVtM	TRUE
rqLNzH	TRUE
Db	TRUE
gghpYV3woSH	TRUE
xziAeOnbNMiGCrorJ	TRUE
JTnK1jstUND	TRUE
4nwWISns	TRUE
DFyGFUC	TRUE
VX2xYxv3PUre4jUR	TRUE
2cwH	TRUE
UKh2gPJSAZ	TRUE
QRsZWPYbfmp	TRUE
zJAOEPqcNGNzCXX3yRjJGxMv	TRUE
wwVzSeddIppdKnr	TRUE
uTQsVqVfl	TRUE
nUiA1xqZE3fZxpwOI	TRUE
rzOsRt2extcebfEZ4ynEJd	TRUE
1EyXrACIcWWCxVga3v	TRUE
qhK	TRUE
CLktXVph	TRUE
LNMiRyc	TRUE
SStegkjSEM	TRUE
M3N	TRUE
qLQgQHyEgJCAsPxowIxRC	TRUE
HGZBJZP1fKBCXDVHdXetGIw	TRUE
gROc1Eo	TRUE
i4dEOe	TRUE
OD	TRUE
jUnsMAGjMDiJeMLMII2	TRUE
LELyfuBZCmRyasYQLXk	TRUE
VCZ	TRUE
M3O	TRUE
lQj	TRUE
dzWKFy	TRUE
sEagXQW1qBfdEZILmmwNtDrRo	TRUE
LOVKiMuV	TRUE
EfoHxUPaMwSm3MYe3lKsHf	TRUE
pzxmNuwlpDA4sqayiCQPUp	TRUE
noAFPbnsuBwGTjc	TRUE
swOXuOQYhhRSBLfVJvHpVlX	TRUE
Mbx	TRUE
iiTXwhTfxcrBt2vd	TRUE
mSsKBNKjxzPwcqnwAT	TRUE
hXBb3YlhkW4R1cc23YkKq1RSj	TRUE
4bSqLQGujc	TRUE
RJBpfpg	TRUE
esNZkRExxFcxuohnepejdzx	TRUE
RdOFosiklSfD2rV	TRUE
xRxLyYoC	TRUE
WVLq4	TRUE
ldkpdK12YehJQG	TRUE
qUiSmxMwHrXYpq	TRUE
3tAfidR1i	TRUE
TkeGeon2KtWEvTGGnk	TRUE
xpmVsodMfugi4D	TRUE
JvCCakGUxLIAGJysVhx34Gpr	TRUE
kaiHyFJDIaHUlrfKDWPlW	TRUE
F3IlCIDJIBHedlVSBENPSU	TRUE
Mk3b1J2Hp2dGNmbEylH	TRUE
ITHCSrYCkCU	TRUE
HNf	TRUE
gudYXewPw	TRUE
mbv2	TRUE
Vm4xxoVsbj1alCO	TRUE
A2KQoOAtdOTZeGWTq3s3c	TRUE
RcqOUpYbD	TRUE
xgC2nMMoIirLbk1cIMfP	TRUE
xWAoTiPabyF1oxBmVCahqXJ	TRUE
1WPcKmUY1ISKGhwpGTFLubYqg	TRUE
ktixy	TRUE
tdQpjHyDeKlUWOj	TRUE
G3HCphZZGVotuEepob	TRUE
MLGlOKmxjpEP4gtHQqw	TRUE
XyaEyqsyExyVRY	TRUE
PWtFizVUti	TRUE
G	TRUE
ye4z	TRUE
meGDc1wgecEDBIJLBsHpZq	TRUE
eqANsQwHhRsVMdIOMYqem	TRUE
p1isvzMKmCSmEbGbLmue	TRUE
z1HlwBgsGtbg3gEzr3G	TRUE
KJLPKOGn	TRUE
tyzdCvavKIT3HMbukc3RE	TRUE
yWPUWkMdSZe3F	TRUE
R2juVwCqHBlZCV	TRUE
gpiELLiiZHNeNXl3jeJG3jv	TRUE
iNeNjz4FJYIzvh	TRUE
EYevrYHkaJC4wm2WXWOJuvkux	TRUE
LB4QZOYcE34EZajcftpyLl2P	TRUE
2BUgJhAMohuFejXWUSl4Fog	TRUE
Z2xHWvgp	TRUE
NBzcuAP3VhjdOdGxQ	TRUE
oEwc	TRUE
aVKeOk3p	TRUE
Rl	TRUE
CqdZGMOqiTAmBXEToM2vMprlT	TRUE
baGJ	TRUE
XBpEKxpfsyEhOeYXiCrp	TRUE
Hu2deEhfhuGpP	TRUE
41BGNMVKIfWTLKIeDY	TRUE
bveut	TRUE
CXgcEFF	TRUE
YjuaRoIZXAVKbBAOTAdqL3G	TRUE
tfr	TRUE
kusQbZOkb3qYSjxqfWPTcIh	TRUE
UlHc42BlLpOOmxbcAWqIp	TRUE
HDimzAB	TRUE
QeJdEMvkGZXGcqmLurD	TRUE
qAWBoyhyzCxAxBuc	TRUE
wbeLiLesbAtyVCDEj4mefp	TRUE
ebyTfEUfSVG3rLKSjh	TRUE
usFid2pbvKgPRhmrz	TRUE
C2YDtTkOIzTmVqKdNwVOd	TRUE
woEuhJAZCPkrZXOmtGngx	TRUE
VmggUtk	TRUE
W	TRUE
QAPKuIKvv2WAwTMidP4R	TRUE
QLYtOX	TRUE
QVhTyuhkMwrkvRTnZkrx	TRUE
CsxWv2YhDDUzHT	TRUE
kPOVCNRZGI2qZTX	TRUE
XcKLDEKHAnCGTARfO4vEY3	TRUE
KuMkjHtGZO	TRUE
1MKRfcAKy	TRUE
vLSseVpj2UslBPG4X	TRUE
3HMdAkNXNGTpzReSgCjPLDlz	TRUE
XlDWOIpoRltaavkd	TRUE
uHIPXLJRbBPtbD4	TRUE
TJYvMuQAhTOeVwCzQL3	TRUE
HG3Sh1h	TRUE
GczXJteFk31QHTsizdzhp3D1b	TRUE
CMVGwU1qNz3FMluYputj	TRUE
PoCR3UiEB	TRUE
XnEgi1LpaZL	TRUE
IxhRwEIYjvT	TRUE
oWNhnjBvYJqSeipiy	TRUE
abj	TRUE
Yrifh	TRUE
o1Vyf	TRUE
W1GSPqV4ePVLjMJV4	TRUE
pHKQTd3NZy3kceXp1Y12ve4mC	TRUE
JWU4HGgKIrZ	TRUE
kUzG2HAyQ4c1f2	TRUE
SGplrR	TRUE
S	TRUE
ARytXzipiBLsuugNOTcW	TRUE
mWjVfvQMY	TRUE
dXltUzMf4dUQOSpM	TRUE
UTvdTwokIrSqddYNIPZBTJZC	TRUE
mxc3ro	TRUE
BVKoGtpIcMhiI	TRUE
ulOEVjevCtnB	TRUE
tJmnZPzJZylx1	TRUE
udP	TRUE
anISvkI	TRUE
ynhxYLxjyKCqNIIPrwDkuK	TRUE
cAjO	TRUE
NcBNgGBxmQkHwhQ	TRUE
fjZvHDwLS	TRUE
SlViH1zZQZBJpxs	TRUE
GSBBhEA3lHsmSLvIGsAe	TRUE
U1UQ2SpSkDLAGrR	TRUE
Pk3aVzpSASRd4nq	TRUE
BEpuscl1ND	TRUE
G2Xqirz44cWTroGp	TRUE
1StMxpIO2U2nWtTgx	TRUE
NYDuRHeYEHRwuRrfdcQU	TRUE
mQTsGpgkQJZEHtTT	TRUE
rJDBxY3crnMaN	TRUE
XvmB4CvpFaAMNOjRgsAZPZa	TRUE
uereJPHnkj4SsbpQvK	TRUE
shTFtvqJ2crDr1pWK	TRUE
Nwtz1eVpDYtIMNbquTxMQC	TRUE
fmClUUlAZHK3jd2	TRUE
23cYgtsOM4oHmmE	TRUE
Eq	TRUE
Obkj	TRUE
IpbCxOVHoCFeE	TRUE
nDumR	TRUE
rnJ	TRUE
Q	TRUE
ERUxdxqbsZU	TRUE
uZqVJu	TRUE
mlKiLdOPGGzVNhfcu	TRUE
4cXLsqAae	TRUE
jcYCTSwsG4qBFM4ftPWMuLrPO	TRUE
qMsecTPgqzPS	TRUE
v	TRUE
m4mXZG	TRUE
brKi	TRUE
1S	TRUE
rckxJlpCvr	TRUE
ZODSRUHcfV2LkRa	TRUE
ETTxmxb4lSuGXUuAGgbmWu	TRUE
gDolJWiUbAlKepqp1u	TRUE
ftnwfrO	TRUE
d2rpNirmBdoacTk	TRUE
y	TRUE
H1ntYPidAkTC4	TRUE
fitIvTTexey1kQzG	TRUE
mG	TRUE
EzZQoBlT	TRUE
BSCLTE1TPvUDLFxJVC2	TRUE
FiHtcAMBFiGnK	TRUE
GRLznLxd	TRUE
4WVUkjk	TRUE
Dxsw1rO	TRUE
XroFQzImEXczl2paclhr	TRUE
CdO3f4YPCoDCsMXNodzXis1l	TRUE
ruGZsK2uqgEEx	TRUE
1NLjRJIEB	TRUE
yZNirYmwjTeVCA	TRUE
oSEPhC3ZOwSF4	TRUE
IbFJvzfOlLWXcqVMTdV	TRUE
kK1kBFv4WllNwTAip	TRUE
1fY3Rcg2V42vWrcggxK2CGqpw	TRUE
IpNDB	TRUE
s4ZbLpZQCgFE	TRUE
mvPZAvepeIszbB1PXX	TRUE
fVfLLe2vFzSuWDlQvCjyfL2	TRUE
NfhpT	TRUE
oCEd4LgHI	TRUE
OF	TRUE
ANlxcWKneNUYQXEbYcF	TRUE
qMK	TRUE
wrFLf	TRUE
ae3ybEZjcqHQq	TRUE
Sd1v3liqgJmzovf4KGElZc	TRUE
GhIhoH	TRUE
wzQPNw2eqUvrhoNWc4IVgBy	TRUE
GpRPCx	TRUE
iF1CHi2p3e3x	TRUE
1NtUGshjTTgNXObNgj	TRUE
HvuOWgXuJjCBCIbyl	TRUE
tqKqyB	TRUE
xqaMUPhPnVIg	TRUE
seHzbvYMishuhIizquuSJKxYp	TRUE
WPaMhHUmmtEnujMAePAN2HMO	TRUE
FdQtHzd	TRUE
iTgtxshEumLbRovpqmiUK	TRUE
PWLRv	TRUE
BlWFk4Sy	TRUE
CV	TRUE
TOCMxfDeN	TRUE
BllTBFbKT2rQc1zDPhQa	TRUE
ohslXjFI	TRUE
M	TRUE
SC	TRUE
w	TRUE
1WmC1JLoxHosL	TRUE
DnAg4utYrvDXnpZRl	TRUE
LgN4pIUffxmyRgdpssTN	TRUE
Y2vi2polr4Y	TRUE
FqAylc1adlCRAPBqkMmh	TRUE
NkebX	TRUE
MMyMLouKhqDHR1Msbehzdz	TRUE
FfzjJPsdaPDrocJozJEEOt3fq	TRUE
xYXrb	TRUE
evZ	TRUE
UFRK1fI	TRUE
n4FazW4RxtJnGk	TRUE
4tmOhCk2bgDfNEJWoYSYp	TRUE
a	TRUE
2iCv2pWobrJLaXdCBICbzXlu	TRUE
WYmijID2FMDKehZQ4am	TRUE
hRvudL	TRUE
ohHTJpTojK	TRUE
FYZ	TRUE
zC4bprYOwcoTvwCOL	TRUE
qfdRr	TRUE
HC4QWdQOCvTkEeZ4J3	TRUE
RJpbwLHymVoek	TRUE
PL	TRUE
HBEeA	TRUE
2dLGyUbP	TRUE
lulyvctcR4AXytc	TRUE
HHqLpoGTufJCV31zfkj	TRUE
trwmo1RVGOHgLDxSvv	TRUE
fLan4	TRUE
IK	TRUE
TGLyONntcRnXNhHtQlYkucvdM	TRUE
fzQKMaOXJhKU2pagQCYkqdYP	TRUE
2MJBnNLxEry2NKpOsFYmkEm	TRUE
LjLYyh11tYWb	TRUE
yWQwUFatbJtbhkQbxFaa	FALSE
abbAaC	FALSE
aoxHbbNPxQajhster	FALSE
RabiviWQPbLAayVFPpAOVL	FALSE
iItnNjCabCgHJaojbiXaza	FALSE
a43HbbKCfebJxoZazkHVwzL	FALSE
rkd2mJLomajpXXbpba	FALSE
abba	FALSE
abObTnhpUa	FALSE
JHLPKPSJabuaebNbhj4acXJ	FALSE
O4PabKOAzFR2jadNVbbI2RFag	FALSE
abba	FALSE
abba	FALSE
aIolNC3bjCmcwbiaxUp	FALSE
FqIeaEbbTemza	FALSE
ApnaCbsTW2b3LSd3UDaNw	FALSE
aotbAWDbQtjaNDm	FALSE
rYgxaaTBFXbMxALUqlOrWbvQa	FALSE
MagKIYbUzbbaFxLg	FALSE
abba	FALSE
abba	FALSE
matDjNbwRbizgcURaAPQm	FALSE
abba	FALSE
zaZFbTqCbDEZnNPaudSfk	FALSE
abCdowbuPacPhqtP1ITU	FALSE
qwa1bH4bZBTVayDQ	FALSE
kx3bacEvr4abfbaS4FXTJc	FALSE
qxabnbCiad	FALSE
ahbObZCqMiQa	FALSE
qhLaZabDbEa	FALSE
FOatG1BWbQM1MLbNqwXaJ4	FALSE
E4aJqbbNTE2cybmXVCaZ	FALSE
awLbbaFe	FALSE
XpdCDHxPsbTa1blLnUbaa	FALSE
fjZabpiJdbU4aCFKVgYRe3H1	FALSE
abba	FALSE
abHudsbCKJVZOzpwao	FALSE
abbDaYU	FALSE
UadbyKyfbIaaDBzH	FALSE
aQbbatIYvp3TvRl	FALSE
uIxuSaLLdbYrIRcGbbHP4aX	FALSE
lGoaJbYKdbgU4a4UahsLDnV	FALSE
OAyxanAbbaB3	FALSE
OG1aPBbZnjbBKGaXS	FALSE
AaJuPbb4aaX	FALSE
gqEJaWbKdvJbRk1a	FALSE
hCip3HaKaKuFbbaoR	FALSE
McDaWbbebCaW2uRGSghiN	FALSE
farbbraJgd	FALSE
dbdrLabcbIuWba2	FALSE
abba	FALSE
iabiUbagcG1jv	FALSE
abqbSUXaxh	FALSE
uZabCabaxF	FALSE
nabfbDa41ll	FALSE
abbamq	FALSE
afkAQbba	FALSE
nazubrbaahU	FALSE
xaMKMbjxbTXqS1ZKhWWa	FALSE
abba	FALSE
Nab3aLXnbWaIh	FALSE
sabbSa	FALSE
l2aURbInFbNas	FALSE
abba	FALSE
OabbueVTUudWtwCDlaQ	FALSE
uabba	FALSE
OCaKbQbaaxu	FALSE
HoN4hjv2C1UznnYabKbOsaCe	FALSE
aJiMbbaMD	FALSE
WabuepPxvH3NbaUhtFe	FALSE
abba	FALSE
4UuPGfYRZkaHbZCb4aWZ	FALSE
abTgobawBJ	FALSE
abba	FALSE
abba	FALSE
abba	FALSE
abba	FALSE
tapbbTQPywa	FALSE
anbba	FALSE
abba	FALSE
aqbWbxaZfDIb	FALSE
qqUahbbVavpWLff	FALSE
ILva4mxebbBIFaKP	FALSE
DeTxPabfgJbyaJ	FALSE
abba	FALSE
Jabba	FALSE
abba	FALSE
rabEhJYbwEmdya	FALSE
dTRalzhbtXxbjqRby4BCya	FALSE
abba	FALSE
ZoOilHaDkKbbca	FALSE
baKbnubaQv	FALSE
N3agOhXbXYMimkcu4jVSabIEa	FALSE
abba	FALSE
abbbaxa	FALSE
aQUbbalA	FALSE
JiEtVaBBbbYagQHapH	FALSE
abba	FALSE
FwAiPabhYAbbDtbRai	FALSE
azM2sb4jxAbTEwCar	FALSE
GpShwuaLi2xhc1KbaobMSbatQ	FALSE
avSbbH1KaIKcz	FALSE
yLqHabQlbYFkUa2wWm	FALSE
kabbdbaJ	FALSE
eabbPa	FALSE
awbpba	FALSE
abIba	FALSE
acYlpPbb1TTa	FALSE
PTMlZTatabiRaSKwC4bla2	FALSE
abbIta	FALSE
zQaT3b1ZhHBYbda	FALSE
abbqbGaP	FALSE
Kabba	FALSE
AoUaEJXBbbbOa	FALSE
aH3uaBbWabe4AbrZaS	FALSE
ZjtAUaUxVBbvJbKSaLMc	FALSE
XFaOOG4rBTgbbtsaP	FALSE
abba	FALSE
zabRboqaY	FALSE
absba	FALSE
XXabba4	FALSE
abbLvba	FALSE
abbbdBp2f1adCIu	FALSE
aRIDbbIax	FALSE
zaIbbmXnza	FALSE
eWabYNArbca	FALSE
udbfaWVWbPoWxE1fbdak	FALSE
HabbHa2m2	FALSE
aqAHbSNEbax	FALSE
anOnXvoqubccba	FALSE
aakeGbazhebFcYvba	FALSE
aYQmdMbybaLdn2rCXAX	FALSE
O4MayFsbUbbOCTzhXatg	FALSE
CjPm2YSbGbabbjaJE4JJs	FALSE
YIabrmbO3GnJNaiS	FALSE
Lab4bah	FALSE
abba	FALSE
sabyahaAba	FALSE
a3rltbbN4YaK	FALSE
KYuaQEbbXa42	FALSE
gaehwIbShebC3RKa	FALSE
aHYKnbxOEWgRbSa	FALSE
makpbDVQGbApySBsagEAY1	FALSE
atEbyUbaa	FALSE
abba	FALSE
Olaf3bxbHfaB	FALSE
abcba	FALSE
aDUOVoFLJbbaaq	FALSE
aD3yQbrUbhgErpYahrpY	FALSE
aJmkv3VhbMeb4QzCykMaE3	FALSE
gU2DabmbjaZ1wM3BrG	FALSE
nabbadskZpruyK	FALSE
g4DpnfaDbKbCaQ1	FALSE
ruIAKE1aiAobbDSaf1gre3b	FALSE
ogaEbczcbCUJbqa	FALSE
abba	FALSE
pI2aRCdZHbFIffB4baYhEIk	FALSE
VgmaZ4HeNYsbMbgcToa	FALSE
NTWdcaOhAryzvjbVbIIEas	FALSE
3eq2faatt1bJyJbcP2nepasy	FALSE
babba	FALSE
abba	FALSE
4iabDZjUrDbaUtsEfL42	FALSE
uzI4EhkaQHbbnaSkvw	FALSE
GsF2aHATMbWTcqbFarubV	FALSE
KLaSmObhLVDbSvdIa	FALSE
qganVbba	FALSE
kabbB1YCraF	FALSE
1aMXkbaJoBUCbhaV	FALSE
uZabbal	FALSE
WaxQhbbzEZjRakazLrB	FALSE
aKvbbHIa	FALSE
abba	FALSE
RcadTbbrgzkzzVNxZCIb3AFa	FALSE
ablEba	FALSE
bTabba	FALSE
abbma	FALSE
aeebveba	FALSE
atKIkfxbpbaaasU	FALSE
aeZPbmuJbCdYMmaPl	FALSE
abboa	FALSE
e3saQsbknqPrbaGa	FALSE
3axbpbs1Fami	FALSE
abba	FALSE
2CaPqabbfPacEs	FALSE
abba	FALSE
abba	FALSE
ZhhBGabhFibuVlFuaD	FALSE
DabJbaW13	FALSE
mhVHqNaobtz2bgKF12XKbUia	FALSE
ba44beTXogbTpcnFazw1RH	FALSE
JpaKnbb2gGoJTcjXSgaWxBeKX	FALSE
aj1ubjTba4haZlDm	FALSE
abeWLboa	FALSE
YB1jSabmba	FALSE
abbDhtdam	FALSE
AHXafbbaIvx	FALSE
abbZa	FALSE
aabtVFMbOLClasqPuL	FALSE
Zah1xbbSbaDDC	FALSE
abNbka	FALSE
NEioaD32quuxK2bcba	FALSE
GanbJtbLbYYa32IGaQp	FALSE
abba	FALSE
kVqbRabba	FALSE
qaNbifbba4Ael	FALSE
oLabFKbebDjlaF4	FALSE
abba	FALSE
uTafxbbxeBraMcBma4Wi	FALSE
2aLfbcyfVqEJIlEbaBChSLJhA	FALSE
abba	FALSE
a3clbIbnRa12HkbdgbsaZPd	FALSE
aNbbfba	FALSE
TyJagKBsDbmQba3	FALSE
tJaxdhzbbaSOWEgIQsQ	FALSE
zWambbvXa	FALSE
abba	FALSE
rWduabbhqaGaq3	FALSE
IabDjb3bMag	FALSE
akFbJbSCERVa1	FALSE
abba	FALSE
abba	FALSE
HBmazPraBbbJrab	FALSE
a1b3jhbmWhRa	FALSE
sac1uBebLByb4UaTMqBx1	FALSE
GWEagEghv12cbbaq1J	FALSE
GDabk1XG4mOlRrzbaOET	FALSE
abba	FALSE
abbza	FALSE
abba	FALSE
aUqbLbneBio4oIa2XEa	FALSE
arudhBRd43mbbcOJaT4	FALSE
aobbDQXam3	FALSE
wsJgPDJaCcbbCpYK2XtbvFRa	FALSE
Iaqbba	FALSE
abbea	FALSE
ZabbajS	FALSE
GKalqbfbOLOaMrfSa	FALSE
Ug1WxyZrBmuatvp1bKObdmaB	FALSE
DaIozQnCVLrAN1brVebubVzah	FALSE
uabbaSxkBYIJa	FALSE
TKa3WSMobfbrja	FALSE
aGL23QMbCKsbLa	FALSE
d1oalhqjkbvbzm2a2N	FALSE
asJobkbqurw2WZCCVvqGlczaQ	FALSE
lSE4uDVGaFqgHbhDNbumbya	FALSE
ogabb4Ja4So	FALSE
abba	FALSE
LaNWFbSFUtJmqbbtaP	FALSE
uEabuGbNa	FALSE
nr3GdqQRIabMbAv4aB	FALSE
pEpqaIHqpeFbXpaabYbam	FALSE
ahW3tqH3M3RbbhJYaAGXh2aO	FALSE
arrIbkUgb4MUZnlHrIa	FALSE
babba	FALSE
2G4aZULZbuHaba	FALSE
CCabbvSs3FBbo2zAaGp	FALSE
ambbbSaQ	FALSE
labLBbnmBJaG4n	FALSE
eab4bPjW3VzYdQDuaVA	FALSE
2VWh2xznakbrbQhgx4cJa	FALSE
aw1NnNAEAxbAbmPab	FALSE
abba	FALSE
DzabKEuHMkIebuxmTabfXekV	FALSE
abbUdOaKOz	FALSE
abba	FALSE
abba	FALSE
abbcRckm4Ljl2iZjmUaBcqf	FALSE
XaqbXxnbahWzrFa	FALSE
abba	FALSE
WxPmjkGfaesFbbXOakQ	FALSE
HmdlfabbxrjxLBaB	FALSE
bRwxCaobbaBqGC	FALSE
ab2oQba	FALSE
iiatbba	FALSE
JnabLbsoal	FALSE
abbtXap	FALSE
TrEamZeSbztyt1DauZbOas	FALSE
abbtaa	FALSE
abVmba	FALSE
abba	FALSE
DETamuHIl2ugkKgbTbB2baets	FALSE
X4abDbwa	FALSE
abba	FALSE
RAakbXUiRUAvbAFaiIyZlB	FALSE
Y3g3abNbgcZhRCaJr	FALSE
abba	FALSE
a2vetbbdkGaFH3lg	FALSE
sNpkaTtBawbtbJn2aeZBki	FALSE
abba	FALSE
zabWXvbTa	FALSE
a1lbQW2DNsfHYH1Ozba1BkgJo	FALSE
GvabMbOGukDa	FALSE
abba	FALSE
abbaa	FALSE
MLnG2aMbcbGD1mavpK	FALSE
abGKb4jaE	FALSE
xmaTLaIb3Zbpa	FALSE
abba	FALSE
sCQh1tiVPabrbam	FALSE
DwElFabIxIbUZMBHCark	FALSE
QvsHaObb4uOeapGB14MbMqaFP	FALSE
fIcCjauwbbTKbaSDzabNpY	FALSE
abba	FALSE
sc1kaSkbRwabcKap	FALSE
Lpcabba	FALSE
sabSObhaNJiq	FALSE
abba	FALSE
abbW12HN3bLGfC2pZkiaa2FYd	FALSE
pRZabRObWJVA2YDXRQaMsPZz	FALSE
kcFaoabcbvJcwbbaXjSGocX	FALSE
ElNKaUbwbale	FALSE
abba	FALSE
ajaNObbiTa	FALSE
abba	FALSE
abba	FALSE
Bambbca	FALSE
NYwtoaYabT3bTa	FALSE
PabeDbal	FALSE
abzbtfbfDaN	FALSE
swXfHYalxL2oNbWJbBza	FALSE
SgnayKbRHbxRrvkMafMOo	FALSE
wrVaVHsbRLebebavc3	FALSE
draibMIFzPnbJafm	FALSE
BRa3DAlbDXFlASvVbbtUZAYa	FALSE
abba	FALSE
LeSD3TgabbwUbShijVagiCPfW	FALSE
abba	FALSE
a4bbaxs	FALSE
aS4ROnbbab	FALSE
OxazwaXYeNhbW1dbVap	FALSE
U2asFPl3wJbbbbNNtsUesKWaR	FALSE
abba	FALSE
rEkabCDbH1MiMan	FALSE
ba3nRIFbBByAIwbBiLtPaqlV	FALSE
aLaJz4cWbEpm4ahQWblah4a	FALSE
IWabbEa	FALSE
VMhhac1bEbPztXBibaA	FALSE
abba	FALSE
Mafb4aiTcAbbheItZ3oa4aChz	FALSE
aibJbDXa	FALSE
twpabbiaanFqO	FALSE
halbUbaRD2QEDrAARDhxCfkBM	FALSE
uxabViInbOihax	FALSE
aRbbma	FALSE
aPNmbbaR	FALSE
SeWTo21doaIbqJSbQma	FALSE
abHObYay	FALSE
m2FXDNYBRvrakkbba	FALSE
MahebjIKJnEQw1P4nwlvba	FALSE
ve1Va4qb1babz4myldTtmZvB	FALSE
wabLFdbaUKEc	FALSE
1qfabFImSeoVTimObjXwaY	FALSE
3xabtifHGGV4ObAbaX	FALSE
arbbna	FALSE
oZlWu1TCabdpbza	FALSE
2agbba	FALSE
abFOba	FALSE
wxJPpLdXSxDaqebbhba	FALSE
abba	FALSE
abbaR	FALSE
WabFbia	FALSE
CUabbRyLa	FALSE
UJSVmXnMBmsa4Eabpbag	FALSE
Llabobbqqu1ca	FALSE
abbyEa	FALSE
absbja3cm	FALSE
OjWtavL4bObagg	FALSE
baVbPhtUbPEGnsPia2lW	FALSE
xmYiUsqbHHzVahObbJ4Fasd	FALSE
2abAob3Da	FALSE
osqa11oSjbQsbgftvVakO	FALSE
anyTbqbaY4Q	FALSE
kAAca1bg2ZTblWWafcNsQc	FALSE
abblxYa	FALSE
abba	FALSE
hGTwMoLaGObbEva	FALSE
CzoEakBBbEnyXbaS	FALSE
bsalMbUaba	FALSE
fqZaDkbbnzLPZa	FALSE
sxabbUba	FALSE
DUvabdobizUFRDfa	FALSE
abtbrNkppCfah	FALSE
TRFuaJbcKFihbmOULiaqrCez	FALSE
nihtpa3lbdAqkJba	FALSE
abWAGbkda	FALSE
afbiTBbbXPOa	FALSE
DmDzdabxbauqqDsMs	FALSE
VabbvvpJ14RWt4eYIlRlbva	FALSE
EasbFXVbbjDaldLVDPrqE	FALSE
abba	FALSE
guwaMbbOawcit	FALSE
ovIgr4LabN3baHUQx	FALSE
hrcdcabXVuPstzWvbanfq	FALSE
RhafhSKbuMlICbaChact	FALSE
abba	FALSE
abYabbiKa	FALSE
1ZpasQaEObpiC2beGSoaH	FALSE
ap4bDzbQma	FALSE
abPJQrLh4xbNpbbvLaZZZ	FALSE
1NaEWZbzbc1fa2	FALSE
tajMkbMbNpQaMYej	FALSE
abba	FALSE
vcBzabxbpobQtDqXXa	FALSE
FOaEG2dpVg4LbbQyawXqD	FALSE
aebaebaBG4MVFC	FALSE
abba	FALSE
advFjbezbDa	FALSE
pfJarazbmbGYBDs13UvMga	FALSE
abba	FALSE
abzwbDTVaatx	FALSE
abiVbIaz	FALSE
MazHJbtaEcpbb1DfAVa	FALSE
AHaDZaZw2zMbbZak2	FALSE
VL3cGawba3PbfqMja	FALSE
m3DaosliLjUkb1YpUbVdWfaa	FALSE
abba	FALSE
uaHbZREwbhWevqLsAbdjDba	FALSE
aebIzjZ4Xb1xa	FALSE
abbza	FALSE
aZbiobgaBQ	FALSE
abba	FALSE
BabbzbQaRhR	FALSE
abba	FALSE
2xdEIWaQpqRmfXbPoJDbbaX	FALSE
aRlvc2bTZeGnbwXtUa	FALSE
kLXTyasKybdDbu4aF	FALSE
biPdazMXZbsbfR2nnZaX	FALSE
vbabbWyaT	FALSE
DfoabbvkaTw2O	FALSE
OaFALbbpFKTnEaVaTTZy	FALSE
u2bawCbMbhHaIh	FALSE
UaBHaT4dw1LbmbJNaAZ2g	FALSE
aLokbSbUXa24	FALSE
jw2apbxx1oba	FALSE
abba	FALSE
aAbKba	FALSE
sWbZN4Eapybmtqfb4AMaO	FALSE
PIsQaiYfFbbva	FALSE
labba	FALSE
abb2aO	FALSE
abba	FALSE
acbbfa	FALSE
aJgTbbraZ	FALSE
Pabbwas	FALSE
Xywvabj2cW2zkbEd3BAabp	FALSE
syfhPavvPbqwbdmuaxjpEaCXE	FALSE
abba	FALSE
abbbgNYapvehYFG	FALSE
aWPbnbIruVdqatgu	FALSE
ahX1klWbwmrvNEnKiGdbdpar2	FALSE
SaTboe4jRJMbAakGJ	FALSE
abba	FALSE
abBfbOBa	FALSE
RabbpWaaIeMm	FALSE
dabvtb3KfaFON	FALSE
kThaYBUOBbhwusbMaPd3wZ	FALSE
ZQacUNbbag	FALSE
abbaMAU	FALSE
ak4bbLSzjaP41vc	FALSE
GLSkabnbhHYDPFQyoOakddc	FALSE
erlMaobbCDaj	FALSE
3SCcelajnbbriPh2OpkaYkgCK	FALSE
3a2bUmeTuDboWXkkoartxiEl	FALSE
Kaj1bWbR2za	FALSE
abba	FALSE
ERaCrbbyKMaxyqnu	FALSE
YbnUwjqVZDaw1wbbaOKjt	FALSE
dIhVavAeRaTbgUhmbCoubya	FALSE
Ma2AmbJKeOZoKbaQyHbfHvoV	FALSE
HYNhKtiyDNz4LJGabKubXba1R	FALSE
yabQwtKaENLbD1aHlgr	FALSE
mfuujabqMeVDGHbDEeDamAO	FALSE
kzccP4RruabbMPV4ZMKD3aW	FALSE
D2hwW1aaNzbbaqUuj	FALSE
OakU2wbBJbH3Gabc42MTKjw	FALSE
iHakbWubVaE	FALSE
abba	FALSE
abba	FALSE
jBaVLqBbobTNKqeafWUS	FALSE
ab2bbOZa	FALSE
abba	FALSE
eKYwTQvvO1EwasbvpTbOa2vJ	FALSE
abba	FALSE
nqY1xaIeRFzJbbaKF	FALSE
rabEbLXpaV	FALSE
abIba3Na	FALSE
agWGYrAbEbvIYDMhwnozKSaC	FALSE
ahvbbDjcLaL	FALSE
aXbba	FALSE
abba	FALSE
SEHOazMbbhDa	FALSE
abba	FALSE
lMabObwgPwa	FALSE
4fzaUOzPutbbqe3U1kaPY12V	FALSE
y3abhbVa4Ibrs	FALSE
anbba	FALSE
abba	FALSE
aeZHbbPaY	FALSE
abkbuan	FALSE
