cd	TRUE
bdcbccbadaabdbbd	TRUE
cdbadababbaaddbbbdbddcdb	TRUE
bbcddbdacc	TRUE
ababa	TRUE
dcdcc	TRUE
aaadacbcd	TRUE
ddb	TRUE
dbacaa	TRUE
abcbccbbcbbcdbda	TRUE
ccdadccabacdccdaaa	TRUE
adcdda	TRUE
dbdabccaacc	TRUE
d	TRUE
bcbbbaabccbdcdbdaccbb	TRUE
dccbdabdcbbccdbdc	TRUE
cbddbbbbcdda	TRUE
bababdbbcbaacbdcccb	TRUE
ccaabccdbcacaabbdc	TRUE
caca	TRUE
ccadbad	TRUE
aacacd	TRUE
cbca	TRUE
bacdbab	TRUE
acdcbcbbdbadcaadbddccddbc	TRUE
badadaacddcbdcadcbbbabcdd	TRUE
dadddddbdaa	TRUE
bdddcbdbacbaaccdcc	TRUE
dbabadcdabcadbacabaaccc	TRUE
adbcabcbabbcdda	TRUE
ccddccccbccaba	TRUE
dbadaccaacbdabcdd	TRUE
dbadcdaacabbacdbcbcbb	TRUE
dadabaaabbbdacddb	TRUE
adca	TRUE
dabddbbabdbcbbadcddc	TRUE
cada	TRUE
baabdddc	TRUE
cacbcbdddddadcc	TRUE
dbaabdacbdabbddaacadbdcd	TRUE
cdaabddaacbdbacbadbdddc	TRUE
bcddaddaddbdbcddcbacd	TRUE
acbadddaddcd	TRUE
bdbdacccbcddcc	TRUE
cbdcbcdcabddabaa	TRUE
adccbcabababcbcdccb	TRUE
cdadddbadbb	TRUE
cbcbabbbbdbaccacdbcbcbb	TRUE
cccdbddcdbbdcacbdd	TRUE
dbdcddbdd	TRUE
cacccbbdadaacacacacabaa	TRUE
bbcbbacdabaabdababbdcddcb	TRUE
a	TRUE
dbcaa	TRUE
aac	TRUE
ccacdccaacbcaacbcdcdbb	TRUE
ddcbdccaaaaddbcacacdbb	TRUE
bcabbdcadb	TRUE
ddbaccdbcdaca	TRUE
cccccaaabda	TRUE
bcccbadddcbbb	TRUE
adb	TRUE
bdcdbcac	TRUE
bcccdddcbdaabbddbcabd	TRUE
ccabbcbabacdabdcccbc	TRUE
dccaadaacbcabbbbcb	TRUE
cdbcadbabcddbcadadacaabb	TRUE
bdccbcdaaab	TRUE
addbcccbbcaabcacabd	TRUE
bddbaccc	TRUE
daddddbadbbca	TRUE
babaabbbcbbdcdab	TRUE
cbdcabccbbbbbdbaaadcbcbdb	TRUE
bcbbdaadcbbdadddcb	TRUE
acdbcbadadcbcdcad	TRUE
dcddcacdbbdcdaddc	TRUE
bcbb	TRUE
acbbcacdbdddaabccccdbc	TRUE
abdbcbd	TRUE
bdcbcaababacd	TRUE
bdaddccddbdaacbcddd	TRUE
adbcbbadadaaa	TRUE
b	TRUE
aaaacadaaa	TRUE
ccccdacccdc	TRUE
dbdbcbbcaaacaabdabca	TRUE
ada	TRUE
bbdadbbdbba	TRUE
acdcbaadcdddbcab	TRUE
cbd	TRUE
cabdcdbaddb	TRUE
ddbddabbca	TRUE
bbbb	TRUE
ccbcbccddbbdaddbbdbcc	TRUE
badddadcdb	TRUE
bdcaccadbdccccadbdcbbdddd	TRUE
dcbacdadabcadddad	TRUE
acbbbbdc	TRUE
cccdaaaadccbaa	TRUE
bdccacbcdcbb	TRUE
bb	TRUE
bcddcccdbcdbdbbacbcabcbba	TRUE
ddcbaaabdaddaddccbcabd	TRUE
adccbacdbbcaccc	TRUE
dd	TRUE
dcacacbbdccaacaacad	TRUE
bba	TRUE
dddbb	TRUE
caacdcadcdddcabcbb	TRUE
bacabccda	TRUE
ddaaccdaadadbccbddaccada	TRUE
cdabccdcd	TRUE
dcbcbcbddbabc	TRUE
bbdabdbabcababbcbcc	TRUE
cadadaccccadbacadbcdbba	TRUE
daacabbabbddacabbccb	TRUE
ddadadaacbadcccdddbccdba	TRUE
cddccaabda	TRUE
cabbccacadccd	TRUE
cdb	TRUE
dacbccbbbabbdbbdcc	TRUE
cdcbadaba	TRUE
ca	TRUE
ccdccbdaddabcb	TRUE
aacadcccbdabccadbbabbbccc	TRUE
cccbcbbbba	TRUE
aabbbcbcdbd	TRUE
cbcdcadaacadaad	TRUE
ddabadcd	TRUE
aaaddcadddacbdddddd	TRUE
acdcaa	TRUE
bbdbcbcbdccdddbcb	TRUE
bdbbadcccaccdb	TRUE
bbadbbdcbdadcddcc	TRUE
dcdaaaacadcb	TRUE
cbdccabccdbbddabdbabbbdd	TRUE
acdcbcbccaacadabbccbcbbb	TRUE
cad	TRUE
abacbbadccbbac	TRUE
bcbacdadbdadbda	TRUE
abaacaada	TRUE
aacddd	TRUE
dacad	TRUE
bdca	TRUE
ccbaaa	TRUE
baccdacaadccb	TRUE
dc	TRUE
aaccadcddadabacbcddadbbc	TRUE
bccbcbcacbbbbbdcaaccd	TRUE
bcdccbbbaddbdbdba	TRUE
acabc	TRUE
cbadbbacaabbccddddcbccbdd	TRUE
cbcbcabadccabdbb	TRUE
adbdad	TRUE
ddc	TRUE
aabcbcad	TRUE
badcbdacddbbbadcccbaa	TRUE
cbdabbdbddb	TRUE
dacacaaddcaadddabdaddca	TRUE
cacadbdcbba	TRUE
cccdcdbdc	TRUE
bc	TRUE
caccccddcaccccc	TRUE
cac	TRUE
aaadb	TRUE
acababbaddbcdbbcabadbcb	TRUE
ac	TRUE
dba	TRUE
abbaababcdccbccdccdbbd	TRUE
ab	TRUE
cbdbdaddadbcc	TRUE
ddcadbbaadda	TRUE
bccbdab	TRUE
bcb	TRUE
dadbabdd	TRUE
bacdabdbbbcdbcdd	TRUE
c	TRUE
cdacb	TRUE
bcbacabbbcccacddcbbabac	TRUE
dccbbcccdaddddbc	TRUE
cbdadddbccdadbbabcddc	TRUE
addcbcdcddccdcdbcdaaabc	TRUE
cbaabcaabdabdacbbd	TRUE
bdddc	TRUE
babbdcddbadaddccaabbd	TRUE
adbbbcdcad	TRUE
bcaaccbcbddddcbacbaa	TRUE
cbbddadcaad	TRUE
cbcddbdb	TRUE
cabdbdaccdab	TRUE
bd	TRUE
baaacdcadba	TRUE
adaddaa	TRUE
dadcbaadd	TRUE
babc	TRUE
c	TRUE
badca	TRUE
addabccbabadbcd	TRUE
a	TRUE
cdbaab	TRUE
cbbdcbb	TRUE
bbdadbadadaacdcc	TRUE
bdadaadccacc	TRUE
ccbdbdaccbdabccbacdacccd	TRUE
bddba	TRUE
ddcaabaabcbdbcacc	TRUE
bdaabcdcad	TRUE
cdbcadcacc	TRUE
bddcbbcdacadbc	TRUE
adbaacc	TRUE
cadcb	TRUE
bcdbbacaddccdabccdc	TRUE
bccdaacadbdabacccbdc	TRUE
bdacdccbdcccabcacddc	TRUE
abcba	TRUE
ccaaccd	TRUE
ababcbcabdbabbcdbccddd	TRUE
b	TRUE
dbcdcbccccaaddccab	TRUE
ccaacaaadcddbbbd	TRUE
ccdbbbbcbddaacabdddc	TRUE
cbadbdcbaadadc	TRUE
da	TRUE
ddbbcd	TRUE
bbdabacccccaababaccac	TRUE
abaddcdcbddcbbadbbadbabdc	TRUE
daa	TRUE
dbccacbaddabbaaccacccb	TRUE
daabcdadbadbdabdddbbd	TRUE
bbcdabbcc	TRUE
bbdbcdc	TRUE
accadc	TRUE
ccbdadbadbaddabad	TRUE
cdbabbabbbddbadcacadbcbc	TRUE
caabbaa	TRUE
accbdcccdcadadbdad	TRUE
ccccadcbdbdab	TRUE
bcaaccbdaacdca	TRUE
cccadbaaaca	TRUE
aacdacdacbdcbbccdbcca	TRUE
aa	TRUE
dbaadbcbcca	TRUE
babccaaa	TRUE
dbdbaaadad	TRUE
babcbdcbca	TRUE
baddddccbdaacbdbdba	TRUE
cbdababcdbadbdddd	TRUE
cdbddacdabbbbaa	TRUE
cabccabcbacbbc	TRUE
c	TRUE
badd	TRUE
bdc	TRUE
daccbabcacdaccbddcabd	TRUE
ababbcdcbbbdcadddbbcbdcc	TRUE
bddabdb	TRUE
baaccbbbdbbc	TRUE
abdab	TRUE
db	TRUE
dcdcbaadddcbbdbbabb	TRUE
bacddcaac	TRUE
bddab	TRUE
cadbcbdaacbbccccdddb	TRUE
b	TRUE
cdacaddabdbdbccbaacbdcb	TRUE
cbaacacbbbddcbcd	TRUE
acaadccacbaccdabbaaa	TRUE
acbabbaacbbddbc	TRUE
bbccdbcdcddab	TRUE
bbabdabbddcbcdbbdcbc	TRUE
acdbdcdababcabddbdcccc	TRUE
bbbcccdbbbbdbdab	TRUE
cadcd	TRUE
cc	TRUE
aadbbbadacbbccdcddc	TRUE
bbcdcddcbabcabc	TRUE
bb	TRUE
aaacaabcbacdcdda	TRUE
addddddcbacabababcaada	TRUE
bccdb	TRUE
dcdccddcaacaddb	TRUE
cccacababdcccbbcdcd	TRUE
bdadccb	TRUE
acdddcbb	TRUE
caabcac	TRUE
bbdbdacacddbd	TRUE
cacaca	TRUE
bbdbdabacdaaddacbdbcbcc	TRUE
abcadddcbbadacac	TRUE
abbddddcdca	TRUE
bddbbbbdac	TRUE
bbbddbcbddcdabddadcdbdbda	TRUE
cbcc	TRUE
cbca	TRUE
cbbddbbcc	TRUE
bdaaaacacbbcbaaadabcbcd	TRUE
adaacccdaabb	TRUE
bc	TRUE
a	TRUE
bddbccbcbcabdadadbcaddb	TRUE
cabbbacbdbbdabdccaccacaa	TRUE
baccbbddbcaccccdd	TRUE
bbddbabdbcabc	TRUE
adcbcdcadacc	TRUE
bcbddcdcbaba	TRUE
bbba	TRUE
bdaacbdabaaadcbcccacb	TRUE
bddddabdd	TRUE
cdbbbcbddcbaaabadbdd	TRUE
dbcdcacdcaabcdacbc	TRUE
dacbcd	TRUE
adbbcbcbaddcbdabcaccdadd	TRUE
accdcbacbbbbddcbdadabcd	TRUE
bbcacca	TRUE
cdaabbbdcaccdbabaccbdc	TRUE
bdcabacbabcdbabbb	TRUE
cbddcbdcbcbd	TRUE
baa	TRUE
baaacbdbabddcadcddccb	TRUE
caddccc	TRUE
dcddcadbbc	TRUE
babbbdaaacbbccbbbcbb	TRUE
bababcacacaad	TRUE
dc	TRUE
bdcbacddcbaccacaddadad	TRUE
dadddbbddc	TRUE
babcaba	TRUE
cadbabbcd	TRUE
ccbaabddcdcdaa	TRUE
cbcccc	TRUE
aa	TRUE
ddcadaaaaaadbbb	TRUE
aabaacbdacdaadbbbdb	TRUE
c	TRUE
dabaadccdbaccdcdcdcabbd	TRUE
dbadbbdd	TRUE
adbc	TRUE
baddbcbcbbccdccacbaabbcdc	TRUE
cccbbddddcbd	TRUE
bab	TRUE
ccbddbbaadcacb	TRUE
c	TRUE
badcabda	TRUE
d	TRUE
ddaaabbddbdcb	TRUE
bad	TRUE
baaadcabaaaaa	TRUE
dcabdaaadcc	TRUE
aaddcddabcbddaabcdad	TRUE
acbbdaddbccabccbdbcbbdb	TRUE
ddbaccdccdacbaacbadaaabbc	TRUE
dbacbdbcaccadbbbbbccdcd	TRUE
cacdadbccaccabadcbacdba	TRUE
bdbbcccabbdcbabdbcbdaa	TRUE
acddbcdccbbcbdb	TRUE
bdbacdddcabcbbdbcddbdd	TRUE
accaaabaacacbcaccdccddc	TRUE
dcdadadacda	TRUE
cdbcbbbbbbdcbc	TRUE
dbaccddabccadcbabcdbca	TRUE
bddb	TRUE
dbbbcb	TRUE
caccccbdcb	TRUE
aaad	TRUE
cabcdbdadabbcbb	TRUE
dcbbdcbdbbccdaccabd	TRUE
acbc	TRUE
baabbcdb	TRUE
acdcbadacbccddabdbbbbbbba	TRUE
cabc	TRUE
cacbdabccbbaacaaccbc	TRUE
cbaabbacabdc	TRUE
bbdabdddacadbaabdccdb	TRUE
ddaaccdaabdacaa	TRUE
abaaaacbccbcabaabbcbbb	TRUE
cadbab	TRUE
abbba	TRUE
baddcbbabcdddcbacdbd	TRUE
bddbdddbacddccbbc	TRUE
bcbbcdcddbcddad	TRUE
cbcdccdacaccdaddc	TRUE
ccddadbdcbdcaabcccd	TRUE
db	TRUE
ddbabbcdcddbddbbaacdb	TRUE
b	TRUE
ddbdabcaccdcabdddbbcdb	TRUE
cddadcbabcbd	TRUE
dbdcdadcacdccabbbdcbccaaa	TRUE
ddaabdadddbcdbddbbbacbc	TRUE
dab	TRUE
aabbcc	TRUE
addabdbdbbababca	TRUE
aabbdca	TRUE
bdcacdcbabccdcabca	TRUE
acbbdbbbbca	TRUE
cbbabdaabaadcd	TRUE
adcaadab	TRUE
a	TRUE
ddbddbdcbd	TRUE
cabcdcdbbcad	TRUE
bbaddcbaacbcad	TRUE
daacdccaabaaccb	TRUE
ddbadaacacacacbcabaaba	TRUE
cdaacddb	TRUE
dadccadaccabcbd	TRUE
dcddcdccacbbabcaaba	TRUE
dddcbacacbdcbdbda	TRUE
adacaadaacddaa	TRUE
dabaccadbbddcdbbbab	TRUE
acccdcdbb	TRUE
cadaaadcc	TRUE
cacc	TRUE
aaacbccdaaaddcabab	TRUE
aa	TRUE
cbcabdbadcdd	TRUE
bcabdacbb	TRUE
ddaadddddbdcca	TRUE
daabac	TRUE
daabcdcdaccaaddcabbcabdd	TRUE
ddbdbcdabbbcbdabbccbdbda	TRUE
adbacdcdcbacbbdd	TRUE
ddadbbbacccdbbbcbacacbddc	TRUE
ddcdaabbc	TRUE
adacaccddbbbcddadabdcb	TRUE
dbcbcccddbccccdabbaadbbcb	TRUE
adbdabbbacaaacaddd	TRUE
ba	TRUE
c	TRUE
addaababdccbd	TRUE
cddbcddccbadaddb	TRUE
cadabbcadbdcdbcb	TRUE
ccacbbbabbcbbdcccab	TRUE
ddcdcddac	TRUE
cbcbabccddcd	TRUE
bcaccbdbacbaddabbddbdccd	TRUE
badac	TRUE
aadadbadbabbabdddddbdd	TRUE
a	TRUE
dccbdcabbdbcaaccdb	TRUE
cacbabbbadcabcbddc	TRUE
daddbaca	TRUE
abdbabbbd	TRUE
cbdabcabbbdbddbacab	TRUE
cbaabbbaaadcbdbdbddddddb	TRUE
add	TRUE
ccbbbdcbcbcdc	TRUE
dbbaadbacbcdcabcabcbc	TRUE
bacadccbdaaddcadaccbddcc	TRUE
bbdcadbddbcaccccdcda	TRUE
bbcac	TRUE
dbbdcabbdacbddcdcacbbdbbc	TRUE
dacdacbabadacdccaaab	TRUE
dacc	TRUE
c	TRUE
b	TRUE
bdbbdaddadbbcaa	TRUE
aaabdccadaddccbc	TRUE
acdbabcacb	TRUE
cdccdad	TRUE
dbcacdd	TRUE
cdabab	TRUE
bbdcbbbaabcabbadbdbbd	TRUE
daccccbcdadaddccd	TRUE
dbaaaad	TRUE
bbbcdb	TRUE
cacabddaccdcda	TRUE
daddadcccbdbbcccadabdddd	TRUE
dcad	TRUE
a	TRUE
ccddbdbbcdbcdbdad	TRUE
abddabdaabcdcaaaabcdbdcd	TRUE
dbaddadacdbcbc	TRUE
acccdbdcbd	TRUE
addcaabccadadcdcdc	TRUE
dcadbbaba	TRUE
dddccbaddcdbadabcacacbbbd	TRUE
bbbddaaddabbccabc	TRUE
aabcbcbd	TRUE
aadbbacadbaaa	TRUE
bddbbbcabcbbdbcbabdb	TRUE
badacccbdccbba	TRUE
caddcaddcbdb	TRUE
cbbbcdcdaacdb	TRUE
abdddcbadbccacc	TRUE
bdabcbbccbddcdccbad	TRUE
bbccabdbaa	TRUE
cbaadb	TRUE
bccdbcdbabaccbca	TRUE
dacdcbdcbaaaadacbbbcddbbd	TRUE
dbbbdcaacada	TRUE
bcddacbcbbdaabcabbbddbbcb	TRUE
bccbcccbacdccacaaaab	TRUE
cdcddbcccaaadadcaa	TRUE
aaabbcdddddbdbdbbcdccb	TRUE
caabddaa	TRUE
aabdbbabcdcaabdbbbdcc	TRUE
adbddccacabdabaccc	TRUE
abccbdab	TRUE
abb	TRUE
aacdbada	TRUE
caaabdcaaaa	TRUE
abbaabba	FALSE
abbaabba	FALSE
abbaabba	FALSE
acbbaaaccddbddbada	FALSE
bbabbaabba	FALSE
abbaabba	FALSE
abbaabba	FALSE
abbaabba	FALSE
adcdcbbadabbba	FALSE
ababaaabba	FALSE
abbaabba	FALSE
adbbccaabdcbbdaa	FALSE
aabdbaabbbbaabda	FALSE
abbbaabcbdabcbabbaa	FALSE
abbaabba	FALSE
abbaabba	FALSE
cadbabaabbbaddd	FALSE
abbbacacabbaacc	FALSE
abbadacadcaabbbacbb	FALSE
abbaabba	FALSE
abbaabba	FALSE
abbaabba	FALSE
adbdbacdabbabda	FALSE
abbaabba	FALSE
cadbbcaadccbdcbad	FALSE
abbaabba	FALSE
abbaabba	FALSE
abbbbaaababa	FALSE
abbaabba	FALSE
acbbadadbdbadbac	FALSE
bdadabbdababadccdbdabcada	FALSE
abbaabbaa	FALSE
abbaabba	FALSE
abbabacabbba	FALSE
abbaabbba	FALSE
abbaabba	FALSE
caabbaaabcba	FALSE
acadbbbddaccaadaacbbacb	FALSE
babbbcaaadbbba	FALSE
dabcbbacabbac	FALSE
abdbacdbaabcacacbbacb	FALSE
abbaabba	FALSE
aabbbdbcbaaaababccdac	FALSE
aabbabbcdadabbbdcacaacd	FALSE
dcabddbacabcba	FALSE
baadbbaadccacababba	FALSE
aadcaabdccbcaabbdca	FALSE
acbbacbadaacbbbacacab	FALSE
aacbcbdaacacadcdbbaacad	FALSE
daabbdadacabba	FALSE
abbaabba	FALSE
aabbdcbaddaabddbbbacbd	FALSE
dbacdbbbdbdaabdbccaba	FALSE
acbbbdaaccaadcbdccbcab	FALSE
bbadbdbbaabaabbda	FALSE
cbabbbbbdcababbaabdac	FALSE
abbbcdaabba	FALSE
babbacabaaabbcbba	FALSE
abbaabba	FALSE
bbacbbbacbacaabbbdadcbaa	FALSE
abbaabba	FALSE
cdacbdbababbaba	FALSE
abbaabba	FALSE
abbaabba	FALSE
cabbaabba	FALSE
caabcbbcaaddabcbaacbc	FALSE
abbaabba	FALSE
abbaabba	FALSE
abbbaabbba	FALSE
abbaaabbaa	FALSE
aabdbbaabddbdaadbbdba	FALSE
aadbbcbaaabbabab	FALSE
abbaabba	FALSE
bababaabbba	FALSE
dabbccaadabbcbbbbdba	FALSE
aabbaabbcbaac	FALSE
aacbcbaadabaabbdababb	FALSE
abbaabbba	FALSE
abbdbaabaabbcbba	FALSE
ddbabbaabbac	FALSE
aadddaabbbcbaaaddcbbabbaa	FALSE
abbbaacbbcbccabba	FALSE
acbcbcaaaaabbababdcbacd	FALSE
cbddabbdacabcbbabb	FALSE
babbaaacabbbbbabaa	FALSE
abbaabba	FALSE
abbaabba	FALSE
abcbaababa	FALSE
abbcdbaadaabdaabbaaadaac	FALSE
abbaabba	FALSE
abbaabba	FALSE
bacbaabdaacababcadbd	FALSE
abbbaacbba	FALSE
acbbbacabdbddccbddba	FALSE
daaccbbdbaabbbbbca	FALSE
abcabaabdcdba	FALSE
abbaabba	FALSE
abbbaaabba	FALSE
abbaabba	FALSE
abbaabba	FALSE
cdabbabbcbabdbaaaaadc	FALSE
abbaabba	FALSE
cabbaabbadaa	FALSE
abcabdaabba	FALSE
abbaaabbba	FALSE
adbadbbaabbab	FALSE
badbcaabbbcaabbabb	FALSE
abababbbccaabbcccbabddd	FALSE
acabbcbaabba	FALSE
dadbbbbaacdbcdbbaa	FALSE
abbaabba	FALSE
babbaabba	FALSE
aadbbabaacccabbccaccabba	FALSE
abbaabba	FALSE
abbbdbcbcabbacadbbcbaca	FALSE
abbaabba	FALSE
caaabbaabcabccac	FALSE
abcbbaaadbba	FALSE
abbaabba	FALSE
dacbbbaabbba	FALSE
cdabbaaabacba	FALSE
adadcdcbbaababbab	FALSE
abbaabba	FALSE
abbaabba	FALSE
abdbaabbaca	FALSE
abbaabba	FALSE
abbaabba	FALSE
abbaabbba	FALSE
abbaabba	FALSE
abbaabbab	FALSE
abbaadababaa	FALSE
bdaaddbbacbadabbadbcba	FALSE
cbbababaabba	FALSE
aabdabbadbbbbaaabbaccccc	FALSE
abbaabba	FALSE
abbaaabcabbba	FALSE
abbbbaaacdbddbabbcdabaadd	FALSE
abbaabaabbac	FALSE
cbadbcbaadabdcbab	FALSE
bacbcdbabbabbaaac	FALSE
aaabacbccbacdabbaa	FALSE
cabbbadaabba	FALSE
daacbbaaaddbbaabda	FALSE
ababbaabccdcabaccabbcad	FALSE
cabbaaaacbcbbcad	FALSE
aaabdbaabbbabca	FALSE
abbaabba	FALSE
abbabaccbbbaacb	FALSE
abbaabba	FALSE
adbabadadabba	FALSE
ccddadcbcbbdabababaaacc	FALSE
abbaaabba	FALSE
abbaabba	FALSE
abbaabba	FALSE
cadbbabacbdbddbcba	FALSE
abbaabba	FALSE
adbabbaabadbbdbcdbad	FALSE
abbbadaabbaaadada	FALSE
adbdbbdbbddcdcaadbabdbba	FALSE
abbaabba	FALSE
abbaabba	FALSE
abbaabba	FALSE
abbaabba	FALSE
abcbaadbbda	FALSE
baadbdbbbcaacaabbbbbcaa	FALSE
abaabacadbbdaa	FALSE
abbaabba	FALSE
cbcaabacbacabcbabb	FALSE
aabdbbbaaabba	FALSE
abbaabba	FALSE
abbaabba	FALSE
abbdbcaaabaaba	FALSE
ddbaaaddabbdaaabbacaaa	FALSE
aabbaababad	FALSE
aabbdbdbaaaaabddaba	FALSE
bddcaabdaadbadababaaaa	FALSE
abbaabba	FALSE
abbaabba	FALSE
bbbaabdabdbcaaacbbcbadcad	FALSE
adbcbacaabbcda	FALSE
aabcccbbabcaaccabcacbadba	FALSE
abbaabba	FALSE
abbaabba	FALSE
dabbabbbaabcbca	FALSE
abbaabcbca	FALSE
dadbbacadbaabbcaac	FALSE
abbaabba	FALSE
ababccabdabbaba	FALSE
abbbaaadbbbdaad	FALSE
addaaaaaabbddbaaadbabaa	FALSE
abbcbaabbcba	FALSE
abaabbccbacacacaaacbba	FALSE
abbaabba	FALSE
abbaabbada	FALSE
cbacadbbaaadabacbda	FALSE
bbabbbbaccdaaabadbba	FALSE
aabcdbbbaadcabbcaab	FALSE
abbaabba	FALSE
abbaabba	FALSE
aadbbbcbbcdbdacabbacda	FALSE
aacdacaadbddbcbcaaabbbaa	FALSE
abaabaacbbbbac	FALSE
ccdabbaabbba	FALSE
babcbdaaccbbbacdd	FALSE
abbaababa	FALSE
abbaabba	FALSE
abbaabba	FALSE
abbaabba	FALSE
abbaabba	FALSE
dabbacdabbaadbdba	FALSE
abbaabba	FALSE
abbaabba	FALSE
abbdaacbbad	FALSE
cabdbdaaccbbcabbdba	FALSE
ababbbabdcdabcaadbaadcba	FALSE
abbaabba	FALSE
abbaabba	FALSE
abbdaddbadcbdbbcbbaaa	FALSE
abbcaaadabba	FALSE
abbaabba	FALSE
dabccbcdbadbdabba	FALSE
cdcabbaabbba	FALSE
abbaabba	FALSE
ddabaccbabbaabbabbca	FALSE
abbaabba	FALSE
abbaabba	FALSE
abcabbdaacbbaacbbdba	FALSE
addadbbcaabbaca	FALSE
bcaabbacdaababcbbdcabd	FALSE
abbaabba	FALSE
dbbabbdacbaabdbbaaad	FALSE
baaadbbaadbbcbbcabd	FALSE
abbaabba	FALSE
bdbddaddabbbcbabacbcbca	FALSE
abbcaaadbba	FALSE
acdbbabbabdbab	FALSE
aabbaabdba	FALSE
ddaacbdacbbaaaaabbdbaba	FALSE
abbaabba	FALSE
abbaddaabbabcbdcac	FALSE
bdaadcadbbbaacaacbba	FALSE
abbaabba	FALSE
abbaabba	FALSE
abbaabbba	FALSE
cbcccdcabbababdbbbcbadc	FALSE
cdabbaaabcbacaddcaaba	FALSE
dddadaabddbaadaddbbaccdcb	FALSE
abbdadddacddbabdbbba	FALSE
abbaabba	FALSE
ccabababdaaabccadba	FALSE
babbbaabbdbaa	FALSE
abcbcacdabdabba	FALSE
abbcaaadbabaadcb	FALSE
abababaaabdcbdba	FALSE
abbdbbbdccbcbbaadbbbda	FALSE
adacacbbadabcbbccbbaaadb	FALSE
abbaabba	FALSE
badacaadcbcbaabbddbacabb	FALSE
abbaabba	FALSE
abbaabba	FALSE
abbaabba	FALSE
aabbbbbaaabbba	FALSE
abbaabba	FALSE
abbaabba	FALSE
aabbaadacbbba	FALSE
abbaabba	FALSE
aabbbbccdcaaaabbabdb	FALSE
abbaabba	FALSE
abbaabba	FALSE
bcabbababbbac	FALSE
daacbbbbaabba	FALSE
abbaabba	FALSE
abbbaabbadba	FALSE
abbaabba	FALSE
abbaabba	FALSE
abbaabba	FALSE
abbbaadbba	FALSE
abbaabba	FALSE
bddabbbbaabbaccddbba	FALSE
abbaabba	FALSE
bcbbadabbaadbaabbddabbccd	FALSE
abaddbbaaabbbbbbcda	FALSE
abbaabba	FALSE
caabbbbadddabaacbba	FALSE
ababbbabbabadbacbdcca	FALSE
aabbbaabcbadbacdda	FALSE
aabbbaabbab	FALSE
cbabbababbbcbad	FALSE
aaacacbbaabdbba	FALSE
acbbaabbbbaabaab	FALSE
dbacbacbaabdbaabacb	FALSE
bbababbcaabba	FALSE
abbaabba	FALSE
acbabacbbbcaacacbaabad	FALSE
babbabaabba	FALSE
abbaabba	FALSE
acbbbbaadcbadbabdbba	FALSE
cabbabababbbbcaaccaabbba	FALSE
abbaabba	FALSE
abbaabba	FALSE
abbaabba	FALSE
bbabbdbbbaabbdbdadacb	FALSE
aacbbcbbcaabbbbcadabacc	FALSE
abbaabba	FALSE
aacbbaadacbbca	FALSE
abbaabba	FALSE
adabbaabdbadcddbcbcbbcda	FALSE
cbabbaaaadcabbcba	FALSE
adbdbaabcdccabaaaadbbdbad	FALSE
abdbaaadbba	FALSE
bbbbbabdbabdaabbddccbaad	FALSE
acdbbcbaabbcdcabccbbbbba	FALSE
abbaabba	FALSE
babbaddadbbbbabdaac	FALSE
adbdbcaabbcbbcbacba	FALSE
abbaabbba	FALSE
abbaabcbaad	FALSE
dabbadbdabcbbac	FALSE
ccabbaaaacaabcbcba	FALSE
adbcabcbbaaabbbaa	FALSE
dabbacdabbbdbadab	FALSE
abbaabba	FALSE
abbaabba	FALSE
dabdbbacaabababacdc	FALSE
abbaabbcaa	FALSE
ccbbdababdcdabbaaababbbda	FALSE
ccabbddacccabbadd	FALSE
abbaabba	FALSE
abadbaabbcdcdbbabbad	FALSE
bcabcbacabbbdbbaad	FALSE
ababccbbdaababba	FALSE
abbaabbdbaaca	FALSE
abbaabba	FALSE
abbaabba	FALSE
ababadadacbbacca	FALSE
adbbaabba	FALSE
abbaabba	FALSE
abbaabba	FALSE
abbaabba	FALSE
babbaabba	FALSE
abcbbadababadaca	FALSE
aabbaaaabbcbdabba	FALSE
cacddcabbaaacadbabac	FALSE
bacacbbcccbbbbcbaaababa	FALSE
abbaabba	FALSE
cdcdbaaabddcdbaabcbdab	FALSE
ababbaabdbdbdacb	FALSE
abbaabba	FALSE
abbaabba	FALSE
abbaabba	FALSE
adbbaaaadbcbbabcdbbdbccaa	FALSE
abbaabba	FALSE
bdabcaabadbbdaababbbca	FALSE
abcbcaabbabcada	FALSE
aabbbdaaabba	FALSE
abbaabba	FALSE
acbbdacbdbabbdddabbaad	FALSE
accbcaaccbabadbbdbaccb	FALSE
ababbbaacbbabc	FALSE
abbaabba	FALSE
abbaabba	FALSE
dabbbbaabadbad	FALSE
dbcababdbbcdcadbacdbdbba	FALSE
dcbdaccbcbcabaacabbbadcd	FALSE
abbaabbba	FALSE
cabbdabdaabbac	FALSE
daabbcbdcbbbbdbaaaadcbba	FALSE
abaaaaadbdbddaaabababa	FALSE
abbaabba	FALSE
abbcababbcdaa	FALSE
abdbaabddba	FALSE
abbaabba	FALSE
abbaabba	FALSE
bbcacbccbbdabaacdcdbabda	FALSE
dabcadbabdabbba	FALSE
baabbcaabba	FALSE
babadabcdbdaabbbaaababaaa	FALSE
abbaabba	FALSE
abbaabba	FALSE
abbabcabdaaabbbcda	FALSE
aabbbdcacaacccaaadbdba	FALSE
abbaabbaba	FALSE
acdabbcbaabaabcbdcab	FALSE
abbaabba	FALSE
abbabadbacdcacccddbbcba	FALSE
abbaabba	FALSE
abbbaabba	FALSE
abcbbaabbba	FALSE
adbbbbaabbbdbad	FALSE
acbbaabba	FALSE
babbaabba	FALSE
aabbbaabcbbbda	FALSE
acbabbaabcaadbbaa	FALSE
badbbbbbbccaadaabbaadabda	FALSE
abbaabba	FALSE
caadbbbbbaaacacacabbbbaab	FALSE
acbabcaababccbacba	FALSE
babbaabbbdda	FALSE
abddcabadbabcacbdcaadc	FALSE
bccdddbcdabbbbaadcbdbdaaa	FALSE
cbabbaabba	FALSE
abbaabba	FALSE
bcabcabaacdacdabbbcaacdca	FALSE
abbccaaaaaabba	FALSE
bacccbbdaabdbbaaadbbbaa	FALSE
abbaabba	FALSE
aababbadaddbaabddbbabbcda	FALSE
abbbbcaabbbab	FALSE
abbaabba	FALSE
ccdbaccbccdcbabacbabbbaad	FALSE
aabbcaaaabbcaabbaaddaa	FALSE
abbddccbaadbbada	FALSE
abbaabbda	FALSE
abbaabbdda	FALSE
bbababcdbacbaadabbdad	FALSE
cabbdaaabba	FALSE
aabbbabadadabdbdbdaa	FALSE
abbdacbddaaabcbdccdad	FALSE
abbaabbad	FALSE
abbaabaaba	FALSE
abbaabba	FALSE
abbaabba	FALSE
abbaabba	FALSE
babbbababbdbbabab	FALSE
abbababcba	FALSE
abbaaabbdaa	FALSE
aacabbaabbabcacb	FALSE
abbdadabacacabbbbad	FALSE
acabbcbbaabbbdaacdadb	FALSE
abbaabba	FALSE
bbabcbaaaabbba	FALSE
abbababbaa	FALSE
aabcccbabaacabba	FALSE
aabbbabadaabacaba	FALSE
badcccccbdbdddcaaacbcbdba	FALSE
abbaaaaacdbbabaab	FALSE
ccdddacbbbdabaaabbadabaa	FALSE
abbbaaabbbdaaa	FALSE
abbaabba	FALSE
abbacaaabbbabada	FALSE
abcddbbacdaacadcaaaabba	FALSE
abbcaacbaabbcab	FALSE
aabbdcbcabcddabcbba	FALSE
abbbadbcadabdbdaaa	FALSE
abbaabba	FALSE
babababddaaaabadbbbca	FALSE
abbaabba	FALSE
acbbaabbaaabdbbaaaba	FALSE
abbaabaddaabcdbbdacccca	FALSE
accacbbddadbabbaaadbbcba	FALSE
ccabbaabcacbdacbbbaadbd	FALSE
cabbcaaddbbab	FALSE
aabbaabdbaa	FALSE
caabbbcbdababba	FALSE
caabbaaadabba	FALSE
abbaabba	FALSE
acaacbcbaaabbaa	FALSE
abbaabba	FALSE
dcaababbcaabdbacba	FALSE
abbaabba	FALSE
abbaabba	FALSE
abbabddaaaaddbba	FALSE
abbaabba	FALSE
bacbdabadaccbbbdacdba	FALSE
abbaabba	FALSE
abbabacbbbdad	FALSE
dbabbaaabbcbac	FALSE
aabdbbcbaaacabcbcbcca	FALSE
acbbbdaabdbbacaacbcccbdaa	FALSE
aabbaabbca	FALSE
bbadbccbdbadcbaadbdaba	FALSE
aabbaabba	FALSE
dabdbbaacdaadbdbacccaa	FALSE
daabadbccaadababcba	FALSE
abbaabba	FALSE
abbaabba	FALSE
abbaabba	FALSE
abbaabba	FALSE
dbaabbaadbbabcddba	FALSE
dabbacaabba	FALSE
abbbbbccadcadababcbddcda	FALSE
abccaabbaababccbdcbbbaddc	FALSE
abbcbdaaababbdaadbbcb	FALSE
abbdcbaababa	FALSE
abbaaabdaacacdababad	FALSE
abbaabba	FALSE
abbaabba	FALSE
abbaabba	FALSE
abbaabba	FALSE
abbaabba	FALSE
abbbaabbcba	FALSE
abbaabba	FALSE
abdbbaabdbbad	FALSE
abbaabba	FALSE
abbaabba	FALSE
abbaabba	FALSE
ddadaaabbbcacabbcbad	FALSE
abbaadbdaabcdbaa	FALSE
abbbabbbadaacabbdda	FALSE
aabbababaabaab	FALSE
