lHÉÒäÎ÷¸îfÎ	TRUE
ÛNÐcò¹¥µtiGy¬è	TRUE
ÅQE	TRUE
H8¹ìIp·º°¯ã¬£	TRUE
NÈÜSùiAmÝbÊN±ß´T	TRUE
e£	TRUE
JO»¾mÐÁL½ÞIN	TRUE
ðç°VÆçêÛ	TRUE
í¯Â×çÐ£	TRUE
6SsÑ636ÐHn¹ÃÕNFb×Ü	TRUE
ùtrõ3VbîÄë9Ò¾E¹mPõ	TRUE
°§ÔG°¹gL¹yÅv¨·5Röµtïê¥ÃQÏ	TRUE
zõXÒO±ïÀî6ÃÈw	TRUE
8­TM¤LëÜt©ÝªQøgèÖq	TRUE
QèKë¢s×	TRUE
ôõj·¸fpf	TRUE
¤RéêuÌ»À©5KÄ	TRUE
Ã¹íÍàç¤¥íppÒq¯£²Þ§¼ß¢µJ	TRUE
EÀÏ¸2Eæ¨NÚcù¢k£7	TRUE
Ia	TRUE
ÎÝ1½IÇ	TRUE
¡«	TRUE
yñ¯	TRUE
ZÑÁ»øÐ	TRUE
fd7c	TRUE
tìã¢ÀhU	TRUE
æäÒZÂìÏ1×½¬ÆLx	TRUE
w6ubÆÆÏ	TRUE
aÞHMgÑæhUljlÁçÅQPpD¢çJÐI	TRUE
ÌãOÎÜV4­«ÜvNåb­½Í9zø¿EÂ	TRUE
ëã¾QÂjZbÞÓ	TRUE
¬ÈQ¤­SH	TRUE
å	TRUE
ªVV©2ðOðîù×lÏÓ­	TRUE
KrGà¸êB¸äò¾À¯ÊíMïÕÀ	TRUE
«ÄDÖuÓJÄ«yÓä×QC·h	TRUE
cí2UÉC8	TRUE
Ø¸á7wÉírîóV¦¬ÐÃ¬Ûón	TRUE
Úxó­kËÕL	TRUE
áÄ»Ñ	TRUE
öa¦¸èîRèÂ§»5GÒÑcA	TRUE
õÏª¤R§åMyutDµZÂà³Z÷Õê®ë	TRUE
òØÛøêîWìÒ	TRUE
´uÁ	TRUE
¬é¾öSBxêo×ÌßuòÒÈ2²e¬R	TRUE
ÔÓ9äUUõS¤ÞuÎØBÆ·ÛF	TRUE
JìdÊ¥«IkVëË6ÊÌßèíòù°K2ä¿2	TRUE
MMËÌs7ë¢YáßµËk¢Õ	TRUE
Ó·P1IòëãÁ­y	TRUE
ÕÝ	TRUE
¡ÆÆnÛÕ²G6swÖµ	TRUE
ã¼Úk4F»6íÔÜi3OMäÞå£Æã	TRUE
sä±¸ÜyïæFíÄ	TRUE
§­øÂz¸L­­ùÉçVPlg	TRUE
®óæÈ¥R1rÉÅfÑÆÃ¿	TRUE
rÈZÁ´½ºEÕàP²¢¤º4ømêÖ	TRUE
¿¼³ÌJ³º°qQÝ	TRUE
yÇ¾c§nÃ¸Y7øØÍÃGUËGÌÃ5Ù	TRUE
¢óð¬Ýa¬¸æÚS®ÕyÆÞA¸AFÍ	TRUE
µWPçKh­Ösí7¿q«LÝp	TRUE
PFaª©kñø½ô6l	TRUE
¸¼RPöÌPÑe9ì¹4gÈfºr	TRUE
°3ùÜøÔîYn£S	TRUE
Ø¶å·ãulÄNªSã¥¬Ä¨56	TRUE
EyæÝ¬Ú	TRUE
©	TRUE
¤TÞj¶ÐÑ©Øz÷Sh¸Å¢OWð	TRUE
Õp¹d8ÚÄùtb§iuñKmy	TRUE
h×ÊÂðÏLÌZÇ	TRUE
ÂhvøË´§¦ôz¡öW»nÄ¿¤ÏÂQ	TRUE
LâôÝI5¥®æYrºzGMmÇT­bs	TRUE
»ÎHÍ	TRUE
ÒqìZîàÊ£wÐ×ÐjlËBu¥¹	TRUE
¤øÂÓF°íÈ	TRUE
Ó7Ë6è«¿áÝíCË¤UgZ	TRUE
V©Õç½áq¶S²yÖp²hyIÏø«ß»Ô¾	TRUE
ÒVíØÄQ¿«6²wB»Þ¨ôaBckÂë	TRUE
eæW7	TRUE
³óO4»¡â³òÇ·n¤cÜÛán¥Î´¦·	TRUE
vÛéÓVÆÙ6í¨	TRUE
rùºïÃÕ3ÞõÜXTòâOft2äiÏ	TRUE
Í½O	TRUE
Ê«dtHG¨r±èAª5×e	TRUE
WwRç¯Ä¶zÂI	TRUE
¨M¢ÐhöæÜñJÂ2TzºÃÑÙ±Ë·­°1G	TRUE
°×ºÃï¡	TRUE
µÁôu½dðÂé	TRUE
XtI¨LäµH	TRUE
D·¼çoîµ	TRUE
3a	TRUE
½h¤ëLA¹ß´¥	TRUE
VµØçp¯	TRUE
Ë´«ÅlGÇg©§¶	TRUE
Êî£Á­±9	TRUE
èrnQMÑQPÚéÎQcÛçfg­¼÷v±44	TRUE
GWN2eÉ1ÕKC55Fh£¼káÔëÇl	TRUE
ÍEÌ	TRUE
W£37òqóêÅ§	TRUE
¢èùshòCõNÖ¾b¾DP11Q¸É5b¶	TRUE
¬ËmïUÜhBñl4	TRUE
õ¸½	TRUE
ð³Ù÷ÌÓê¿6	TRUE
fÕ°×3u	TRUE
ÞáµÈIq·¶ìd4lOfåpÇGÎ	TRUE
º×EÕÝHðÒ©¸¿m¹dÃEÃÎÝÎá6´Eª	TRUE
ïUeIp¥£ÍcåFìÓçÅÓC»48EÒN1	TRUE
ÀG»ííÜ×C÷	TRUE
ãïÛðvPvÉâC4uöÙÑNÐôçÁ	TRUE
¡ÖyÇñFèèórPg´ºV§	TRUE
MÐÀâìj7iÞÊTLÔÌQG8Ëòwh	TRUE
÷¼ïwÝãdBgÉg§§4g¥7o	TRUE
ÃqæX¾ÐËäÑ¾ò©A×ÎÍfKhõ¸ÀÌê»	TRUE
GIÎ8ÏÞÁÁ¼	TRUE
T	TRUE
¤ì8ÈerÂ²¿Ï¾òBÝq±£´E	TRUE
fuÒÊTùµé¸Zc2ñòÇ¹x½	TRUE
¶Ä°AcÛ5s²K3yÓ¼9ó­ay	TRUE
Ò¬Ê·§ÐôÅyk7êµÛáÀx4¯¥LÐÕ	TRUE
æµz	TRUE
â	TRUE
·àTU¨áÒ«¹µNö	TRUE
ñ	TRUE
pðËíÂÒBJRVouHØ®íõ7AéÓ	TRUE
©d·ôc¨7±Lp8à¿9ßÂl	TRUE
éDè×x²©ËqvÍER599FhuY¢ñ	TRUE
æ¤ëàE	TRUE
1®N2¸ìVÖklzñ92g¾ÉÇâ»Pñb	TRUE
Ìmª½S°äÅ¯Óâ²ÐZ¹¥¦¾±NdPîQ	TRUE
¡ÊâHêFìð¡FÃ­ìXäoî«ôñ¯cQZÍ	TRUE
×öÝòÅïÒ¡rÚñ²ñ6³	TRUE
NÙ§ò×ÛhíàAaªÙ³	TRUE
ÐÂ´mã	TRUE
CÞ	TRUE
§RÓu×¯¬Bfª¦ðà	TRUE
Ò¶HÔpàO´°¬Y1±ðÔ­	TRUE
H§©ÓSSð	TRUE
AwçRñæó÷	TRUE
1Ô§Yt7õ9¦¬¶ÂìzÕI×f	TRUE
µiÁé	TRUE
wrE²K´Ø±×¿±qèô¥	TRUE
HltqØÎD¯m°ÈÈ	TRUE
êÀGÄ3DÇôNºÍ	TRUE
9X	TRUE
ÃL6æ4obTj×QDLèõðÒôaDm	TRUE
YíOwÇMZ§nÃrïZº¾4Bf»1¡Mæz­	TRUE
¢JÕãÇ³tjÉº»ËÐåêhÇh8¯t¤B¾å	TRUE
ZàAVªãTRíCyLB	TRUE
©GiÑ²8BI­k	TRUE
øVJRI3ãµ	TRUE
aå¶±ò»K	TRUE
óÄÅÐFwïÚÉÊPÙ6ÞëU§dtT£X£L	TRUE
v	TRUE
I´	TRUE
Mzdôt·á¨Fmåðl¨ðµ9ÑhBù¥´ßÐ	TRUE
²»BÄS¡õÌËÒÓ¶KÞa	TRUE
B¦¯iõ¼ÐZîß×8ììÑ·¡¬½âGGÐ®Ø	TRUE
SÃ¸Î5¨	TRUE
TNÄµ¶ñgëå5ï	TRUE
hDò	TRUE
gÇcÁ»Xïñµ¥Î¢Èº÷	TRUE
ZLTzãéNe¤ÆdÕ§¹øÌßè	TRUE
L¤âçW¼Ûô±1¬Ø¸Yê	TRUE
Aß§	TRUE
øí¬a¼õ4ðLZahñ±	TRUE
9¸xÑ¥îi9fÑ¡ä¬±h9HHâS	TRUE
YÙÌØê	TRUE
Á	TRUE
ÙÌôªÀUQnù¬¥B	TRUE
²±4sgð¾75	TRUE
©ÞÎäÐã¼ënE©pùäzv¼ë°övN	TRUE
ÛÃZå3XÃÙrbiußcç¡ÄCÙÐ¡¶¿	TRUE
qåz	TRUE
øÕHlÞCLJNæMDÏ¾ó	TRUE
¥°lµµO«Æ3®¤t´w»J÷ñÕ¹Ì	TRUE
o7ë¤ÚY8Ðjm¡pjÓ9HBr	TRUE
6å¾à8LGù¼âÉÎt¡éGuBz	TRUE
¤tSIÈMo	TRUE
MKa¾VùD¤®ÀÆjUA£è	TRUE
wÍNÅÄùf¡PÀª4ÏX	TRUE
Öñuyºnñåu	TRUE
qºOìÒÉCNð©µH3¬OQÈRØaíh¾X	TRUE
òÎ¸§JHÌæV	TRUE
GòÃñOHBÜÁÐó¦ÏØG¬TÃÁØ	TRUE
±ßcÂÐ2»ÅêlFfDt¹SÃhé	TRUE
Ù­Ç¼¯hÃ·»ÔëHäEÚÔdP	TRUE
îCsO	TRUE
o1wî7ÐÄlñ½å	TRUE
uî	TRUE
ê¾ßÀÉwIeÛÊcBî´J÷ç¯x	TRUE
ä¥ïq¼Ðt¥	TRUE
Fèö©¨¥xéT«¶éßµ	TRUE
cztÏ»	TRUE
lÈ9ìîæ½¡kbQßsÀÃsn	TRUE
I¥WÜfì6ÃYíËª¢¦ÆÄ1	TRUE
¹çãØ¾u	TRUE
¾ÔuÔ¡¨Ñc2	TRUE
ËÅ®±¼N²¥QæSh	TRUE
B	TRUE
Äð¤d¡¤ÔZaÌSÅ½sØ¢V	TRUE
ÑÅBâ	TRUE
²o±pø	TRUE
¸NkBN¢CÏ¾ìÄçÕøÁÖ±ÕìWñjì	TRUE
M7Ë¨3S1k¿ì¡	TRUE
ÑC´AµÐ­88Æ®7­J	TRUE
î¬Á´§Ö©äã´ùm9TaHA1¤X¢ËR3	TRUE
M2Õdd2³BDe¬ïÌéÙ®	TRUE
ïÖHõyªOÑVÏ¦yPÂéõËrKÛk9Ë	TRUE
øîÑlÛ¤N¶Ïg¼8	TRUE
e2ÉÌÉd¡îâÛGfv±ïøê¼¤£±¶u²	TRUE
¯°Ú¸QWÒuQ2â¾á®óF1Scè×Ùo	TRUE
ÀÓjK	TRUE
´hBRªÐ¿ïgêà÷j»ÚÞl¿Rl6Êìëß	TRUE
Ì9óAéeñ®M»´V©ºÛîµÍ	TRUE
´3Øë²Râ²àJÜE©ÏÉ³Åì§Üj4	TRUE
àøØãÉÏø¦ò¥ÃDÐeè¾¯	TRUE
Y»È¶lpÙ¸ï±K¹Â³f´§¤	TRUE
õÝr²ÙárñÌ¥¬K²àÀ4çn¦¢¿Yx	TRUE
gQí·´©¶n£ÝÕó72ãÝ	TRUE
ÚÌ¡fQq3Cì½ÌÚ¢µE÷Ø8cìgSÞÝO	TRUE
eCóòsC	TRUE
ÈÙíXµ	TRUE
Î	TRUE
Ñä¶3a×·ÌnGðA¥áÇ¢æ¢4	TRUE
áX×Xy	TRUE
ö6ØÚcqù«	TRUE
ôAÀ1âAõÏÒC­êñÍÕªðÒ±ðìn½éê	TRUE
ÇT	TRUE
qâå÷¦¢	TRUE
±½§PÃMÌÕxÂ¾wÇ±ßó4ÆK×ÀëX	TRUE
Ç§ØëµèÖId¢Åé¦rÄõæë1Dù	TRUE
¯vÒ¡Y8¿AøÚÉ¸m¨g¢ô©l·ðPMt	TRUE
î	TRUE
VÆpöMÒÄ	TRUE
êIP46ÐóãÍVËhºgéSGÚ¼ÍMA±A	TRUE
1g	TRUE
6CWC2h27ª3IX13u	TRUE
37cSRê	TRUE
O7÷­ñYé¾Ob»eø	TRUE
ÚlÂÉì¯Pd	TRUE
Dx¨Ø¥¯×ÅØ£öU¶T	TRUE
LS	TRUE
óÍGDÍÚaÇÆ¢¨¼l	TRUE
íIØãD	TRUE
ïCQ	TRUE
aÜÀh±¾ìçßLÑ´	TRUE
qvÌ®PÒ	TRUE
Dìf·1N2ËæHm	TRUE
46ÌßÊ	TRUE
ÉÐOëZj	TRUE
qÄ°d­©l£bÅ	TRUE
ºTsäT½Íôl·	TRUE
ØdõaðäqøàIUØÂ	TRUE
²SQºØkËØZqzJgêRï2åY¯AK¾­	TRUE
hBÙ¤Ê	TRUE
E÷ÓW²ðMS¢gÎÛßàÞVºJ½ÕÖãêÒ	TRUE
wÞá7JÉuÐë	TRUE
6µ±QñyÀïD9L¼¤¯V9á	TRUE
díÝIzÐ­ÝºëÀ	TRUE
÷äcæÂEJ°	TRUE
ÎÚrVfJxEè¹­µl9¶Ià5«WªÛdtQ	TRUE
AGGê¹1´«ËÓeÒ5	TRUE
SãÀê¾Bg¼L7JëSÌIå	TRUE
ÉIàé´tÎîÎºº©÷lcÛRù	TRUE
¤ásÇ7×³ößògezä	TRUE
96êoÃ­²oçÕ½ÌZÛ9R¯¨gÄ	TRUE
lK	TRUE
Çoãx	TRUE
Ã	TRUE
¾JTÝ­Ý6ÍPQÑÉA¹nª	TRUE
¤4pÑ³iYÆ8S»Û4Íw	TRUE
x¬H¦Ëc	TRUE
µÐÎe¾áïwçfAÍKr	TRUE
4ZÝÝÒh½ÛÇÚB¸	TRUE
ø	TRUE
asó­¦kjLa«ÞÊhmÃÌÙEh°ëSå¨	TRUE
g÷¸U°uðÞ3yÛH	TRUE
°bÂaíÎPÅ¿	TRUE
Og©ø©¢öÔMùâywÚ7Yo´¦Që·	TRUE
Yß´f²ÇøÎyÒl¸hÐâ7å¶5	TRUE
QivO	TRUE
dH¸R©Äv«ïÖÅ¥nÌ	TRUE
ÞÞïÄSm	TRUE
eS	TRUE
Y	TRUE
·	TRUE
ebNiÞùx±Sa¸	TRUE
Þñn	TRUE
ÌÞqÍÉoW¢»ÖÚ	TRUE
áÍw¯	TRUE
¶¿qzêíêD¹	TRUE
1bÓæQpÁÇ	TRUE
zBák	TRUE
½p»ÃÁ7¯BÏ7	TRUE
né8kzF	TRUE
x¡½FEÑÕç­Pcð¿y	TRUE
¡Öò4ÇIsØ©ÅÄEF¿«c±í±càvö	TRUE
fyÄÛÒ»ìe÷ÂF¹t¨ÝÛ´êÚt¤9Ôqc	TRUE
òl»fOD²ö¹£©°7pÂOÀAåévÅÃ	TRUE
4£âuêF6g¬R¥£uGqÒÂHµBòÀÅe	TRUE
¼zòQ±ôØñ­ÒX¥ÇçÍôaBGÓp	TRUE
×h¼8é	TRUE
Ùù7AêGje¢øÔ¨àóGTbÚ	TRUE
Ë8âÈqdM¯¹bPDQ	TRUE
®´î	TRUE
Â	TRUE
mBzsnß¶FÉbîth3è	TRUE
cåóÇa«Ò9ô5èØòTV	TRUE
Èh¬°æõ½Ð6óÆÝe	TRUE
òKÔµOâÔ³	TRUE
ß³ÓWäÛ8HÙóèÂ£îÎIÕzéu	TRUE
Å¨¶íôt¦Ú¶	TRUE
yßx²Ì§Ü¿Fmí¼C	TRUE
Ú­ÌwKcÉìÇS²ID©AänxäB6³	TRUE
óêh3ïéÑÀìîÚqqfÙìÍëK°	TRUE
r5dW	TRUE
®Ëã7äaÑ5ôsk¢´ékl7Ù²ËuäAÖ½	TRUE
ô¦X«°m¿®´ÜÀ¬	TRUE
W¿sóptpÝlËÒÄp±P¶±ªhsáé	TRUE
K©°íyÇå±óÙÍC«JÂ§÷rPÍ	TRUE
ôf	TRUE
±ùUä£Þpæ¥Äw²nÜ¢Vm	TRUE
h3Mx»ßZ¦jjÛÈå	TRUE
ßµOÐuÐÀM¦ÀcÎ£åQArëZ3	TRUE
GgèÙäÆYFÛæJzKë¯¡¸	TRUE
vZ5¿½åèP	TRUE
¬bWXf¨Rqð	TRUE
æÑQ¬Û¦ÍEÞYur3æ	TRUE
£ÑCu19¥5èá	TRUE
r¨Ëcl	TRUE
8Nc	TRUE
«¥òOhy«2Òêeñbfvm	TRUE
bØIÅsÒéÀ·òhöÀKïòCÇ2ó	TRUE
Z½wkuÌDìQ¾ÖÍÒÅõ§wßKÍR	TRUE
ËOÏTbyËÇîJð¤ñ©xÆFwD	TRUE
°ïôËÞ¶ÆUgë¢ÌtfÍ¾«¼ØhI	TRUE
«iË¾8êéëã8mCÏ¢UÎòº	TRUE
ÔLÚu÷	TRUE
ðTeÃÒéÀk8bHur4ì¢YÞ®ë²H1	TRUE
xÜnÅÙp¨xÓMw¡ÐWÐl¿áÝD÷i	TRUE
l­êÖÍ¡Ûè	TRUE
JdjÙÛI6àòç¡ñKIKïÓ¼7ÌøS	TRUE
®®Tôw¾»ÆÊÁ2Äº½ãõi³wCöÝîÆ	TRUE
gEÃ¦6ï	TRUE
¢òE5pÂ	TRUE
É	TRUE
¡£«r	TRUE
¨ÖHsÕRïÔjRylÙÖ¶ñÕ	TRUE
ÂqMÉË¯vÅèÓ¼g	TRUE
góiov×E°£®ÔÀv	TRUE
¹ÚkdXÓ	TRUE
vGj	TRUE
qÅZRWµäM¦lZ	TRUE
Cêé	TRUE
ÖåÕ½¤hRÕÀÍ·ÑÔ8yGºl	TRUE
sGQ£MÚÉñ¦pÖØS×ÃÎ«æ5ÙVê5	TRUE
´íÞ¤¾ÁeLol²«26D	TRUE
U¹ÑñBøºd	TRUE
Ú54Tñ7×yty£¼ÉáXx£Â®hùµ	TRUE
Å®läªÏÞàmÎ3êá9zFÒ¯ÂÓ	TRUE
²TÓÐàc¿m¾k©óÍ¨Ð3QÀmÙ	TRUE
óLó1q×ÙÃÝqö	TRUE
½êS¬ùæºJo×	TRUE
â²8ïL	TRUE
¾z¦ÔÌtÍõ¹Iá2Pä£åUeGPp9	TRUE
5RNpìE8ÃÊ9AÜ¶G9XÀ­áØ²Zk	TRUE
÷ZÀ	TRUE
Rój1ÓIn	TRUE
aLnÜJùåcñë÷bíeæCå8ñ³sË¾Ìw	TRUE
áÕÊo¾¶Ö´ÂUÊ¶êÐÞ	TRUE
·Ô²¸L¹Á¤áN	TRUE
Ztø	TRUE
34ìÉ¸ââN¤	TRUE
h¡E­N÷ôóºq	TRUE
÷V´Üh¹o¶OåmÕkè­ä	TRUE
À´b·­ÚÁØ2ì1eZùyJs	TRUE
CUUÁC2nnlÁuGh8cô©ì	TRUE
BÅÊeÁ¢Yu±hoqáÁºÝ¼ßî´Xôo	TRUE
Hn¬è±7fç	TRUE
MÒ5øÍìKÍÎjzÑYr	TRUE
ÃZ¿W	TRUE
Ê¹©¬Þô´Ï¯Õ1±·Ö·ps	TRUE
vÖZdO	TRUE
»Èz¿·p8u2	TRUE
øÞrô	TRUE
g²ê	TRUE
¬möïôÚÏKb2³çßÓ	TRUE
ÔqDëßd¤Ábx	TRUE
ÌÂÜãùÃn	TRUE
ñk¢4»éìwiLn	TRUE
dÅ4g¼2áGå	TRUE
êÏ	TRUE
¿íùVÝpäÎÂ¦7	TRUE
VoMNV3ù¢QÁ»Éù³Ò¼	TRUE
Ö¿wÎyNWªCè¹·Á²ªAÛ»£l	TRUE
¡÷pGÑÆ¤xBÄ½ùÕÆzX÷ÝCÐ³Eyî	TRUE
ÊPOIöÝÛFÖIðLZùxÔÈz¯e	TRUE
ÀTiÂòkèYìQ8IcÝ7ó9ª¼	TRUE
Khßl¦t2à7RänD	TRUE
ïÆM5áºÚ	TRUE
HÑÅguxÙ	TRUE
dßrè7W1	TRUE
Y2½ÑëWyõíÔ´K	TRUE
I¼Cë1TtHN¥ÚÛ¸yÏ	TRUE
øqÎJFÐá¾ÎÀ	TRUE
ÖÞ·£÷WØËYEêðöFÂ	TRUE
òÔÃÛ¨¼gòÎÄjæ	TRUE
óÚÒybQjmøYoaxP¯h¿±­	TRUE
óixÏc´èÉIò¤Cz¤1sIÇ¢ù	TRUE
9îÛ¦ØkYm	TRUE
DqõRF±Ãéì	TRUE
Óõf3ämì	TRUE
¶ÍÂ9ókO¸ëa	TRUE
C§äWk	TRUE
D¤¸YÍ©U¨òörÌÉeÝWEÊ¬S	TRUE
ÕpÊPÕzG÷ÔÄ	TRUE
ê­ÚÕÖGÁ2ÍösÇñ7hùGgÆZ¬i	TRUE
´¡º½Gò6XK¢d¤Þ	TRUE
HBîä½jrwz©õèÂwXovY¾ÕÃ	TRUE
D¢Þ­µoq»v¾3y©Ï­ÛÖÑeæ­	TRUE
µUG¤lïEèÏCê±kSEV8È®	TRUE
ªÝÛÓ¨ï¡»ªU	TRUE
Çhöf5våÜÀãIÒÅ	TRUE
ËWäØÜXîÕmÀÍÞÓ¯ç²z	TRUE
VC«aòÍÛ4­ïÉ¶3¿á±D	TRUE
RÛÞQ	TRUE
F	TRUE
Û×£yátU®²¨ìèfù¯	TRUE
lSzkHgeÂ5w×ö¡ÄÎÇJ	TRUE
tSéÙñOåÔgc£Ln«CE4¶¡Þ6Ç¯°	TRUE
A¦äæªºª¸ôòExÔºQêYáæ»òNÇÅr	TRUE
ç§®Ï¼È´òKI¦º727óòjí½íA	TRUE
ZE¦½ÌBBÆÏÙu	TRUE
qQ	TRUE
énõYsÉçÙ³	TRUE
¤ÃçÈwI¹BNJØØÉ·	TRUE
«Ú	TRUE
vÞ³bW¿²Ö§1©ieçÌÅu	TRUE
§µ´g7ê·gßYLÒ	TRUE
ë·HÃ°ôMv¦B¤wºTkê	TRUE
¡Ø¹©Ï½zæ	TRUE
õÒmHcxèî»ã	TRUE
óàÌpírK5î±Ï5÷°i9	TRUE
ðbPô	TRUE
7Òêç©Ói3z6µeÙdñè	TRUE
czfe¸ÓcvjO®tQßÇ¤6õC	TRUE
Så½ë±®Òc8uÏÛ	TRUE
Ã³D¯gp66b¼cw	TRUE
§µ¢µ¤exm4L¯Z¥6fÙP´xÄ9	TRUE
Ê	TRUE
MøeÆÛiæPÜ¯©®	TRUE
ÉÏ¶ÊVÀ4	TRUE
wfçk5®Ä©áÇføÆ	TRUE
y­h¯°	TRUE
2ÛàBi½MªPJHÅkÞ4ædòMe¯µ	TRUE
à¦­lèõÒIéÂVJ8	TRUE
ËgéIcÁV«¶°V8GGBÃ4fÓ	TRUE
¨°ä®ÎìN«ªègãub	TRUE
WN¬ñÃÏ21wo­­9«Y¾°lRZBu	TRUE
·	TRUE
¬ÌùÙ®wãE¹×sÒg¾q¾«Ì®kxÜ	TRUE
måv¿ÁÎ÷	TRUE
ó­ycøtîíwóÜ»y®óèË¯àíÆ	TRUE
sÌtÖmnDnµ¬xuI¤cBa6¼Á§PÐCñ	TRUE
ËÇÃ«ñaeFLQW9ajM	TRUE
©¶«øV¹ejÊaÈUh±Þn­z2k	TRUE
à²³DL¸¡»¸dêxÓr°ac¹rô	TRUE
mtPEdåVÃ¦¼l÷ó8c©M¾SîKWã³	TRUE
¸TâJÖ	TRUE
YÑs¾	TRUE
´¹5	TRUE
ô¡G£MJ¶dÎøMJ÷i«dQùuÖ»	TRUE
¼W4YH¤¾Éø§ÐijvãÂöo©c7ï®ÞO	TRUE
KÑêxUjYªÊµzV±¡	TRUE
Ï¼¦q¼	TRUE
íØ«äw¯ñZä7UµØrªÆ¡TÁ	TRUE
ÔRÅîóòê¿×å²»Ù¸HH§»ê§ðQáà	TRUE
ÛùvÆI3cD8	TRUE
êZ¬Vàâfw	TRUE
7Ì	TRUE
XÒ7g	TRUE
T5î°Â§êG¡¨Ã¦ÞªjÛ	TRUE
Æ÷±UÌ»vøÑ¡ÇÎu¸	TRUE
×¿³ãÝ4ðéÕjÊÓ¯aD÷§ÆnË	TRUE
j	TRUE
U9»g°êÕÂio³£í¦GÞik¨ç»°Ö	TRUE
°£ñbç3dsDf²Îê°4Ùr	TRUE
3pPÄjªKsôyãKíRN¡D7ªÑ±	TRUE
Ò¼9ß÷ÙÌ1¦È9ÓèëA	TRUE
Äå	TRUE
øÐñÚÓ¿íyq¶îmµGcÞ5ÞøÝ	TRUE
sqÖ¤Ûö	TRUE
zPñÇqôóà§q¯P	TRUE
çë½¸ó¢dºè7n¾gÒbfÀIU°´å	TRUE
ÖÞEdËóOî£´ÍcÊÓâ¸©9F	TRUE
É´C´dê³V£YãAxã¥1¨¹	TRUE
Í¤Ôî¹RW»ÁºeG18²é	TRUE
«iKLyOà¡Ó£»àº	TRUE
RjìñtszÕ±dgxMò	TRUE
6f31®	TRUE
²yíá4xUÞX¬DÙ²»V½Fn1­ïE	TRUE
rªaaaa·	FALSE
Óaaaaë	FALSE
V±rLaaaaè§²ñôølL	FALSE
BOaaa	FALSE
JuÒâåaaaaùbIY	FALSE
bbbØæÅaÜùÑ	FALSE
LYbbbb§	FALSE
bbbëe¿	FALSE
«î³UXXHÞaaaaSÌ´é³LÛ	FALSE
bbbbðjïØ	FALSE
ãpÂð÷çßsaøîdºÙÈaaaap	FALSE
MñmÒhbzËRbbbbeÊRà¯²»i¸	FALSE
bbbB¡7à¯§iÌv¥×nT	FALSE
µÃ×2Vs¼ùãUéF1Sw±MbbbbÈd	FALSE
4Ðäbbbb«	FALSE
Û7gP·aaaaalÏäì	FALSE
æÆgaoqàbbbb£Þ¾	FALSE
ÀØbbbbi	FALSE
bbbòçj÷I¹æòmExRÎ8â	FALSE
saaaaXÍ	FALSE
VFÙuÉÝ¶8÷WµR­u®3«Â¡tDBaaa	FALSE
8Ø°JV¤bbbbZÄ¼õ	FALSE
ÙákêyÕÖçÊåÐy¢aaa	FALSE
ò¦ùØ9Si³aaa	FALSE
WKqUaaaawV9ç	FALSE
bbbAc	FALSE
dáÒ4Zã9Úaaa	FALSE
bbbôc3Â	FALSE
bbbÇuÎ¤åÆ´ºiBõ9	FALSE
bbb8ÔÙöïfñm´2gd·u¼9	FALSE
bbbb	FALSE
Ãµ¾ÞÐaaa	FALSE
TcÐÅbbbbx½õhG9¢½9ß»±k¹õ	FALSE
bbbçg£	FALSE
bbbqàÐ´åGGáq	FALSE
ÄTqË¯aaa	FALSE
m¯saaa	FALSE
¸öMÕÓbbbb	FALSE
»aaaa©vNB­©Á	FALSE
bbbQÞw³¹½Âq¨2­	FALSE
BÀÁ¹ÀÖð¤qTEªUSõi·m¾aaa	FALSE
¤½bbbb	FALSE
hÐWÒDòxôt¿bbbbÇgÉ	FALSE
¡³hîáÃdñ¸aaaa¹8ÎùÖõ¬Û	FALSE
àçÀïK2É¿6Î¥¡Dbbbbvõ¿GñN	FALSE
DÀbbbbbpÁgñkfMÓSwmä	FALSE
×À¿bbbbÉ	FALSE
bbboàðô	FALSE
»ào÷jQëXôîÊHi2©åaaa	FALSE
dHáÇUbbbbb	FALSE
bbb	FALSE
bbb	FALSE
íÞÂaaa	FALSE
¥èåaaa	FALSE
¼ubbbb¢EbàÃØ«SÔS	FALSE
bbbbÚlFÞï	FALSE
9Ë¿3JË4PÚoäØ·»c7Fñwßaaaa	FALSE
aaa	FALSE
bbbkZëqåÛ×S	FALSE
jtÊaaa	FALSE
3ÚQGsaaaaÉËG¥¨pÌeR	FALSE
òMmcjaaaa	FALSE
Ì¯å32ÁbbbbèÑ¤¾õFy¥¨x	FALSE
bbbb	FALSE
Øß°¾ùówQxiS8§µcaaa	FALSE
aaa	FALSE
bbbØvCªRfHYÚå÷á½Íi×Jèsté×	FALSE
Saaaan8ôøùle¹hñ2	FALSE
bbbbiÒÝVU7ø8÷7I8ÓàëØäæÇX	FALSE
bbbk¢I÷KñB©°¢¬¤èUwËW¸µz	FALSE
gË§Zåi¦¨9ÊòÖTræqbbbb½²å®f	FALSE
¬Õbaaaaç½eëÒÍ	FALSE
bbbgÊn¶q²êé²xNNgÁ5«RÎ½9¸	FALSE
Èbbbb´	FALSE
bbbD´wÝêjo®åÜë¶	FALSE
èEÍJ¦Àëîjæù×TíbbbbR5ñ25	FALSE
bbbb±­ù	FALSE
øaaaa¼AÔð¡4pÚµÝ	FALSE
ÑnÀxö¯¨5Ñd­öbbbbá	FALSE
bbbÝtocL´º1uÓßAãó¿QPyÍá	FALSE
ÇìmmwÀÜdáê±Üraaa	FALSE
aaaaìÐ	FALSE
VbbbbÙ1cìm	FALSE
ocËlaaaa°	FALSE
obbbb¶gµôcU®¯«	FALSE
³w2Í©qbbbbµ	FALSE
aaaaÅÛ÷bÊö¿ña8òW	FALSE
1Qô¾7aaa	FALSE
È7¹½»6ca¯ÈßÊ´ÇËµïÝaaa	FALSE
ârMõÑK²Ðvaaa	FALSE
aaa	FALSE
bbbË®ÎÞn£ÍTÚ¾ÖZ9	FALSE
ó§½ãUéaaaa¾	FALSE
´3¹aaaa¸£jt¸WEêË	FALSE
öÄÐ£mÂe§5â5§òænaaaaÕìÐHÕ»	FALSE
Ö·aaaa¡R	FALSE
oyEgöã¨ÃÜ÷bbbbïq÷ëFKa	FALSE
Zbbbb	FALSE
ðaaaa®¨	FALSE
bbb	FALSE
»ËQðÌaaaazò	FALSE
Ë4yðGåC©FÔ©2ùó¡©2¿qaaa	FALSE
«ønE5ì°â²×bbbbuÜÇãG¯Cò	FALSE
çÍÜ×ÔxôvF¾ÉC±hÙÑµwUxaaaa	FALSE
aaaaÃ	FALSE
SQaaaa7§AsªÔÖcÑÖËq½CÓ6s	FALSE
bbby1¬e9twá×y©ÖwUÒ	FALSE
xaaaaèá	FALSE
ÁÄµóÏåÅFbbbbºÂÙo	FALSE
bbbb	FALSE
øZ»ØªPMðÞØaêaaa	FALSE
ófzr5YRaaa	FALSE
aaaaãè	FALSE
çLòYõëöMgs»ÜÍî¬aaa	FALSE
v¤ÏÙO«ñÀVbbbbóÓ¹ëVY2ð·ø¤i	FALSE
±aaaak¬yE¹ÜßÌwÜ×è	FALSE
¢®¦ÍL½íXÌ4aaa	FALSE
RCÇÎoÓ¼Lñ2aaa	FALSE
ãHSßÂ¼·nEØçmì§ßaaa	FALSE
®ÝÈFIbbbbJµÄe¯K·NPPZ½Rb	FALSE
§ÀÒ÷óaaaaÂ±	FALSE
ÄìQóï³óÁ1ËKâ¸záaaa	FALSE
ëÌäÖ®9aaa	FALSE
aaaahà½	FALSE
bbbÒ¡½¶OÅwç¹ÎÛW9±öÑ1¨i	FALSE
bbbX¦	FALSE
µÌèsj£xTQoaaaaF÷èB	FALSE
´k§1³º¡bbbbäVW¸álîk©	FALSE
bbbÝstÜÕ±§¨iº	FALSE
bbb	FALSE
qbbbb°	FALSE
Taaa	FALSE
Ô­ÌXcö3ÊÞÓ¦¨±5abbbb¹Ø	FALSE
ÄSHauPjKÁãe3NRR1øícaaa	FALSE
¨åØéÀblqP½æöôaaa	FALSE
bbb¤­Dðq2MÑ®A4oÝ¿Ç¨÷¹äÂÖÊ	FALSE
q2µÓs¤§bbbbX½	FALSE
×MÎWnVPìøaaaaÕË8x	FALSE
Rtàøh3ßnñºbbbb	FALSE
âraÚHIaaa	FALSE
bbb	FALSE
bbb5	FALSE
âÄvaaaam	FALSE
ÂsêÉbbbbRÝ¦Ða¿ì2Ij¨n¹	FALSE
ÕØÞyñop¶Lbbbb1m	FALSE
ÖUlkÃÆïMMì­¬íAQÖaaa	FALSE
ÇGtÙdÑØD©¤nÆc»LðÅPaaa	FALSE
ÐÂôaaaaaa	FALSE
¤ÀQ»¬5bÈÝZ¼5î±¸aaaaáÏ¦	FALSE
UlrCz³´GÇcáæÌ3­FfuçC¬aaa	FALSE
bbbjßã·	FALSE
V5H×M«ÄÖ¸×ÓÓÊaaaax¥Ò	FALSE
1rF¸aaaaâygliÚøËÂA¨OÐ	FALSE
¬Ïøbbbbwcle	FALSE
JC6KbbbbOWw÷ÓÁ¦ÙW	FALSE
bbbôNaÝE£ð6ÖÊÖóùÒsÛ4Ì	FALSE
bbbEmÒ¸§ëuÁ¯ªÕ±	FALSE
¨¢ÅjISÌzaaa	FALSE
bbbT6nÈ¼÷iTR	FALSE
bbbbùîÌtpç±©x3	FALSE
¿7taaaaÉiø	FALSE
YaaaaX	FALSE
ÐPGéB¨É¢ÝE4eÕ«æjØaaa	FALSE
ÂRO§LA67óQbbbbí÷D	FALSE
bbb§ìÈ7÷sËD42ìrdÎ¡Cëc¸	FALSE
Ô¼aaaa£óîº¡­ØÒämª°Ãð	FALSE
Û¾ÙeMy©aaaaóÅå¾ñÊÃçHöùF	FALSE
2ÅÒaÁâhÙB9ïaaa	FALSE
5fÑÈ§SLÓÂÒ³X÷ol÷bbbbM	FALSE
bvSÊØL¥WDêãªpâaaa	FALSE
îò2å¬aaa	FALSE
YTkíÃòtÍí½ÒAÈÓaã­aaa	FALSE
º¨×ª¿2M°ÌqJ¤Å£±aaa	FALSE
Y¸M¸ÉSH©´7EÔaaa	FALSE
¸Ý6ÀÞÊÂÅ5uS7Sê¾÷qK¼÷bbbb¢	FALSE
bbb¯rPFÍeíAyk	FALSE
mÑJEgêåßRbbbbJÜ	FALSE
ãÄaaaapù	FALSE
aaaa	FALSE
ÅaaaaHå¦¦NÂtì¬g®	FALSE
1ùJPKåª£ÐMbbbbÊEÝx	FALSE
dÌkójÐbbbbql·Xâä©Nà£p	FALSE
6¢¼S¶±Ø§Óà4ôaaaab	FALSE
ÊÍ°¹aaaawxHtñVÌÏS	FALSE
ddßê¬a¾ÛlQêÁÁÔQÖÀ¬íaaaatz	FALSE
Bbbbbp	FALSE
aaaaÇªoçPÂt	FALSE
Âaaa	FALSE
Þp¿³ãLtâiiºÔ£rËâbbbbXñx¤Ç	FALSE
âÞôPFÑÎâbbbb¶¡9	FALSE
hIaaa	FALSE
ËWØKzØq×bÕyïNÎdaaa	FALSE
¸Í¯mhR2OUöìaaa	FALSE
yPZgbbbbêîºÙ¸G	FALSE
­ôÛç4Ûßk¦nñ³íÎ69aaa	FALSE
bbbbÛ	FALSE
ÂpcÃuIïÖKã÷ºbbbb	FALSE
ºNV¹bbbbÛ1DLj¸Ý¿ªI°66	FALSE
bbba§6Ö	FALSE
I¶xy¾HbbbbÞÀ¸ì»SÒ°O	FALSE
bbb¦ÖËì×ÅæÓñ	FALSE
bbbb	FALSE
bbbthÖy1Eic6FÂeøf	FALSE
XÆcXò4ñaaa	FALSE
bbb³q	FALSE
L¦Iaaaaç¬	FALSE
jwÚÓaaa	FALSE
CØ3´EZmJbbbb	FALSE
ToÆ¦â4GÔ6eAIxã³µÍY6»aaa	FALSE
bbb©Gà÷kvîZkH	FALSE
²IvÎkÃzµÒù×ãLT¹¡Ð×LÍÙßaaa	FALSE
aaa	FALSE
bbbÑ÷²k»7èÉDôZ1®¼	FALSE
bbbE82çìiFÒId	FALSE
In½ðé¨õ79bbbbBaÖhXçÞwp8	FALSE
²Äîf´½Í¸Ü¥ZBðÁXaaa	FALSE
bbbPÈn2åÁö9szHùÓØèÛÅD	FALSE
§Ùaaa	FALSE
wTßøbbbb	FALSE
aaa	FALSE
t1÷5£mQnñaaa	FALSE
§à¿ßÐzÁÖgaaa	FALSE
bbb³s	FALSE
aaa	FALSE
f¹ßÛbbbb¾ò	FALSE
bbbÇo¥g¾Ë¶	FALSE
´ôbbbbäÈurÞZÐNè2ËHÒ	FALSE
¶8õÉ±aaaa5eM	FALSE
áé5OóekGLº8RÖ²làË¿¯¥bbbbE	FALSE
qºw¿­®òÑÍßabbbbì©ã95kq	FALSE
bbb	FALSE
ßbbbbA	FALSE
aaa	FALSE
bbb¥6iùSA·ârwÏlÅ	FALSE
aaaa	FALSE
bbbß2½ÁBsõÙotÚÐ§©PÂMî·	FALSE
Èxaaaaàµê£óaêAÆ½Ñoâ¼×ì×åð	FALSE
bbb¨£ÝêSñx	FALSE
p³7ÈfºRòàLH°¤ëni³aaa	FALSE
bbbLßci¾é	FALSE
Eºaaaa¡NÙçÃDÊéê«4qF	FALSE
Åº·tì¢òNGrU3vÓbbbbÅYÏz	FALSE
îëÛÇlOWifbbbbu	FALSE
»ÙßEé9²xòXMMXôA´iÃÔ¸Âaaa	FALSE
be´H°aaaagÕÖ¦8	FALSE
aU¶ÇïøßWzçöÕq«AÐÜaaa	FALSE
ñqJùö3¶èïør1qöøßaaa	FALSE
bbbÁÀ»´÷IU2BÊxåéPºõ¼Á4î	FALSE
ÆjòNì«aaaaZÇÐ1o¾	FALSE
¦aaaaa¹¶Ý7¿Gõ	FALSE
ÝaaaaÀÐBze	FALSE
u¦JÈr¦aaaa¡XË¼mFÝï»j	FALSE
m¤z¦ïÚÐÑfaaaað6äìÈe	FALSE
¶étÐbbbb	FALSE
ác¡fá¶ÏtmuÔïsìaaaacáÀÇC	FALSE
Åaaa	FALSE
bbb	FALSE
¬zÞPbÒ­aaa	FALSE
bbbÅ¬ù¾«X	FALSE
RkÙf¬ajaaaa÷ôËëÚ´æv£	FALSE
¬Bbaaa	FALSE
Fðqbéaaa	FALSE
åÉaaaa´fnôÒ	FALSE
ZÏ«eÜX°ÛÖOX¡ÒaaaaNd¨ïå	FALSE
ÁïßÀ´aaa	FALSE
bbbbOßPAÜoz5	FALSE
§ÅÐQkÆÛWÄ¶aPÝ2ÑW§aaa	FALSE
¨¹aaaap	FALSE
QF÷æábbbbEïåÓçd´ô¡	FALSE
bbb¦CKÀºDÀ	FALSE
O÷¤kUiaaaaNDõ®çUò¦1DAØË	FALSE
bbb¿HÀõ8¢µÞm´A©cDðzõNkJÂ	FALSE
ZëËwÀ÷©ÀGÝUi¿ò×ÒÕvaaaa±Åc	FALSE
q¼¨ºaaaaA÷r1	FALSE
§ynÐÜzyÞZy9Ä¬A»ìaaa	FALSE
bbbZÒNóÀëÍACÜ	FALSE
bbbåDìNZrç¢ì³áà±6Ýk	FALSE
î±b÷3fDbaaaaðY­å½q	FALSE
98áòó÷bbbbtÍ	FALSE
bbbcêò±T£òprdO3sÃÀí79ô3p	FALSE
±aaa	FALSE
ëÈà·Laaa	FALSE
wÆPôbbbbÊ	FALSE
¢FÒbYbbbbÀ®ÞnÍY	FALSE
bbb·m	FALSE
¯bbbb¯×õÁÓfÏç¯¹êU½õ÷1¼¡Ô	FALSE
GÚÊqÇËbbbb¯á	FALSE
wps¸7ÙíÄ7qaaaaÈê	FALSE
Êaaa	FALSE
bbbö¥¡»PóuÌ¯ó³aOãÆÕº	FALSE
£PMELLZaaa	FALSE
bbbÔÐ2cùmããÀÌHÖáä	FALSE
bbbåÄ	FALSE
ùaaaaxuh³	FALSE
·aaa	FALSE
óèj°LéÞpaÀ4èàeBbbbbeÊÇÌX	FALSE
ÀÇÉ8ºaaaaìËÑï¿ª7LÜ¤¶id	FALSE
ðuÝd¦5ÞóïgÌö°aaaa¡¤Úz	FALSE
bbbdT81°¬à5WÌÜÁ	FALSE
bbbd½îªmÖN®©PYxÝU¬	FALSE
bbbK´²huÛôÁU¶©ØÓz	FALSE
bbbboÈìÓtÌèâôØWu1Gxp	FALSE
ëbbbb	FALSE
aaaat¤LE	FALSE
¡3äâ÷ÐïzíbvTÍà¥Ói1îÈaaa	FALSE
m96AyÇÈCrðÛaaa	FALSE
bbbD¾8°AÞÈª	FALSE
haaaaCÁâG¹°Ï­JH	FALSE
«Ì´bØbbbb71Ú§	FALSE
bbb	FALSE
UË3çaaa	FALSE
bbbcXAãÌk¯ÅlbxÁ§Az£nk	FALSE
çbbbb	FALSE
èíø¿ÀGÑeV»Òõôáw£ÉbØ±uaaa	FALSE
8s´ßD1èS¹2Rõ¾N3ÜLaaa	FALSE
å·bbbb¢¸k	FALSE
ªÃ©5áåy¸Âaaaa¯xâÔOåvò9	FALSE
ËáÒj·Ð×ê¸NÁX¶aaa	FALSE
64XUÐÛOaaaaÅ¹	FALSE
aaaa6fL	FALSE
bbb	FALSE
öbbbbò×	FALSE
GéóªàbbbbÎM	FALSE
bä¬àrq´êÉìàéK9bbbbaö¬xv¢3	FALSE
LXñÍ±¯ØÇGîv·Ëoaaaa»ïUGöñ	FALSE
¤¶ÔJ»k³èÑCyÇepI¥dÞ1Qaaa	FALSE
ÜrinÝ®¥ÌäTaaa	FALSE
bbbÊ¯õ¡zÎ¯S©ãr3±Á9¹ÉOEßÜ	FALSE
°fKaaaaËÚïÔÖN¡æùJÑåªVÒÓHù	FALSE
bbbLOï	FALSE
kÝÕîbbbbì7¯g	FALSE
íbbbbÇÑuñÌNÀØmö¿w	FALSE
Nbbbbc	FALSE
f¶bbbbÁuO56BôÌzs¯ÚZ«¹	FALSE
U£ãX¡QkfBÜãÀ·´dõ÷åÝÌHïaaa	FALSE
£r®KLÏ¿aaa	FALSE
fôTÎèí°³X¦â©²Z«bbbbw	FALSE
qMË´a©ynÇËvíÊõåHaaaay7H	FALSE
XÊc¬Õx5§îdâÈòuaaa	FALSE
jbbbb¾k·7¼eM	FALSE
Taaaa	FALSE
ÌTÇæ»ñ»aaaan	FALSE
×íOÃéaaaa¯	FALSE
4EaaaaóN¬	FALSE
IaaaaöìS½³ä	FALSE
A±gÒÜKLÌ«£aaa	FALSE
×¸ªéâ­ËÔdæºí©QOaaa	FALSE
¬KCNævPÛÊaaa	FALSE
êÎÃaaaa²iDzæÑ§Âç3¢Æ	FALSE
æcaaaaé¤·çËÓîéÜ	FALSE
bbbájÕv	FALSE
bbbîÚ7tº3¥À6¦Eôz9	FALSE
bbb9GÙ«­¥éËÍÈ¡RßæW½2	FALSE
bbbIìëvñJØIaL·ÈÒdÈ·Oª	FALSE
¬îV­VK½QñbbbbTÌ¡XÒ	FALSE
yÑãAë®·ëäs¥aaa	FALSE
bbbÒv­ä«Hg3aÖ­	FALSE
ñ¿ª°I89MïÝ¾òh¨bbbbÝ1lÔ	FALSE
¼rö¼DÒPÞvÇr¦aaa	FALSE
bÇ÷åJMÀIÙAwnt¾«ðc÷èìèaaa	FALSE
bbb¢²ØLChWOÎ	FALSE
bbbù¹ÜÅ¿·ê¬Ú¬rÐB9ÈÃÙãpæ¬	FALSE
4¦MªZuÙ®L»ÀmC7¸58bbbbÕbÕd	FALSE
aaaa	FALSE
VÍÃù×17îðVjØÁøï¤«aaa	FALSE
Õbbbb°´¤ícPT»Ç	FALSE
¶òv6HKyÀtaaaaf­	FALSE
bbbKASJKsSª	FALSE
bbbGkÃºãslö2F	FALSE
bbbmdÁÏù¦Jùz§¹4¸O	FALSE
aaa	FALSE
°Ë¬¯z½aaaaïK6ám¶âRÌ	FALSE
Àðbbbb	FALSE
Ìz­Gaaaaµ©ÐÜHïvÁÐ3Õ»¡RI±	FALSE
bbbàa»sãÑ	FALSE
¬saaaae¶ªÞmLîeõ	FALSE
hÚpõecÐ«hÛÏaaaaÈáç°´êÆ	FALSE
bbb£ÛXØUCJÊ	FALSE
MÍÍE94°Gø4åóÝäÉyaaaaI¯ðY	FALSE
bbbqÛ4æöO	FALSE
cygbbbbÅ±	FALSE
bbbC	FALSE
æ¿Ðaaaa×£ËAâ	FALSE
V¦ÙÕHY÷£¾QÏ6ÞÜBYbbbbF	FALSE
bbbîNÎCQ	FALSE
ááIµÐaaa	FALSE
øIEbbbbQU9nÐkGD5ÛÀ	FALSE
1ÞKaaaaßqG	FALSE
Êaaaa¡zåuµ	FALSE
bbbb	FALSE
â­e·§ôïñ¥·aaa	FALSE
bbbL«æ¬ÃæÄÎX³TdUÀxV×B¢C	FALSE
»¦Ðá½ß«EËLDaaa	FALSE
ºdðÔöñsaaa	FALSE
ÇÚu³­óQ¬ÉK¤aaa	FALSE
×bbbbqoG¸«	FALSE
ºÃôÖbbbb8	FALSE
PÄÝËómnTnbbbbÎïhÈzÞZ·7	FALSE
¿BKbbbbÛZzHP2o¹Þ	FALSE
¶PbbbbãDHuÆ¿8	FALSE
mÑÞÀãyTPóëÞÖ÷Æ¹h¼ö»j¨aaa	FALSE
qxAgïK»ªfØÎ²DÚòÃÜÅÎzDaaa	FALSE
¸ÇM»ÝÖBÒO¡aaa	FALSE
aaaa5á¾fwøÖÒq5	FALSE
bbb9©Z÷÷S2öOÙALrDìb	FALSE
bbbÏóckºäå2GHq	FALSE
bbbW¬a9F	FALSE
VÝ©aaaaãô1à	FALSE
Þt·¤íÔcbbbb	FALSE
Éa5ÅBjZ­8léop×ñzt7ºaaa	FALSE
aaaa­¯øÌSÈéóXÍRé¿WMtÂÐ	FALSE
bbbùÆñêìS¬WÖÙÄàj£i9Ù	FALSE
°4ædbË1LbbbbVGö65	FALSE
bbb¾wwà÷¡ó37o2ì	FALSE
¯ÏÂ±fó¾Ôaaa	FALSE
bbb¢t¸	FALSE
bbb¶Dçåñ÷ÂI½³ßÑá	FALSE
ÃÎaaa	FALSE
caaaaîª¡ÏS¸TÈ	FALSE
õchZ³Ý¾bbbbãÒ®·Ò¼Xßëï®	FALSE
Êaaa	FALSE
bbb2¹DøÎÂÃñ	FALSE
Ò¾¢ØõØ©Fßx5PTÚÝbbbbÎ3ë5²	FALSE
ðaaa	FALSE
óÀcÔèEpZb¼pÅaaa	FALSE
X5ºöÉiÍbwaªÐ¾bbbb	FALSE
bbbDãÎ±qòÚìWêqXw÷s	FALSE
³õÊXÆïaaa	FALSE
aaa	FALSE
UW×abbbb­Ä±AzÆì¸¢Üe	FALSE
aaaaC	FALSE
bbbËÏ÷qÓõ¾æKf·ËwIrG©åË§	FALSE
Èv¿z¼FÀ½õsIUÞbbbb2	FALSE
n1ÛîÅØONÚ7í»ÝÎmaaaaâÐIJ	FALSE
bbb¯ñtÅ	FALSE
aaa	FALSE
flßGEmá¿¯Ç7îõ³q®õaaa	FALSE
bbbURÒÅ9ëK	FALSE
8BFº6E¥aaaazB7aìÕãKz2	FALSE
M¶q«È­M¹¬õUÄóåíËYãÐ¨ùôaaa	FALSE
Æ®Vã5öxÚÏÛaaaaôçÇ¸2	FALSE
¤è·hó¨¤S×ÐhónÜaaa	FALSE
bbbb¶	FALSE
egY©ÑÈï´ÅðãÝøaaa	FALSE
³vãÉbbbbÓ·wa³ÃÏrè9øY×	FALSE
bbb¾·éª¡zmr·ã¶²8EÈã	FALSE
æ£wy2Ö«ÝaaaaÛ¥V	FALSE
aaaa	FALSE
aaa	FALSE
¼¿ÁR¹çêddV³bbbbÙwâé	FALSE
bbbb¼	FALSE
bbbbùo¤	FALSE
4ÚëPGnå·Rêç¤aaa	FALSE
bbb»	FALSE
bbbÊFSFLÆ¢°TTlGFlnÓT£H§¸r	FALSE
2bbbbàXâõ	FALSE
bbbbò¢NoDÛÏmÌºÝV¤8§KÒæ¿èÙ	FALSE
ÂaÓbbbb°	FALSE
ßaaaa	FALSE
iÖÞMøhæg1îBa´ÓÎÐLIaaa	FALSE
