abbbhhj	TRUE
a	TRUE
bicagceigdjgjjeihddgjcji	TRUE
biedaj	TRUE
cebhcfibaacgfhdf	TRUE
ceggfhcihbdaihhehj	TRUE
d	TRUE
hjcbf	TRUE
bedjjfbchiccdgcacg	TRUE
hhdhaeh	TRUE
djafggiacfidbbfg	TRUE
ij	TRUE
dae	TRUE
cabchefegg	TRUE
aafbgcbi	TRUE
dafgjbbfaijea	TRUE
jebccfffgjfe	TRUE
gacfbjagibdib	TRUE
hghgajdfiaif	TRUE
acf	TRUE
jjhciegfejeegagh	TRUE
ijahdedjedidf	TRUE
dgjceh	TRUE
jajgdcccgjcfhih	TRUE
hhechhbhhhbccccc	TRUE
ffded	TRUE
ehgaggbicicgb	TRUE
ghae	TRUE
iddiffedggfjjbhgijfabae	TRUE
gafcdiejdcejfhgjajidgg	TRUE
jhibihgca	TRUE
fedaejghcafjbejdcdijaahif	TRUE
jgbgiffdg	TRUE
jbfaihhggieagjaadaiaa	TRUE
bjgfbcgicbcdfgjdaajehad	TRUE
agaehdhddbgbcgibhfifejhbg	TRUE
cghddc	TRUE
ibhjb	TRUE
bfdjbgbdjciaejiajhdghaii	TRUE
ghihdbicfccddaj	TRUE
dajeihaaaed	TRUE
cjcadbbahhdjh	TRUE
ii	TRUE
cjhdcdbbdhiej	TRUE
eabgjbhh	TRUE
jgdigdbfgbiceefidahicehf	TRUE
cfaghacadhi	TRUE
ihaeejcgejcidaggcf	TRUE
cfjhhjejib	TRUE
fhehiibcj	TRUE
ijafjgagcchhdbifbahdadhb	TRUE
jcacjhfceedghadaccdcijhgh	TRUE
cjheiaiddhccccebb	TRUE
aihfgedfjacbidcdghfjd	TRUE
icjjbeafd	TRUE
eijbfhgjhbjdificgj	TRUE
diefgiceb	TRUE
iecfcfaijjiegcehe	TRUE
cehdgihabjfcgfbigiif	TRUE
bhbjebjjdihegjbfhd	TRUE
iafjge	TRUE
jjdddhdgdahhcfghigcfejjdf	TRUE
jfdbcafedchjfebf	TRUE
hcidh	TRUE
f	TRUE
ajiddibebhi	TRUE
fdcabccchjijficgbjcbji	TRUE
hbdi	TRUE
gffbiegiaiifijiijgi	TRUE
gbhbdihegjigb	TRUE
adbgabdjiggddbejccfiii	TRUE
jiibfhhfjigciiedcijacd	TRUE
icgaaaihdghcacedjafiifdac	TRUE
aa	TRUE
hdgcbihhjcfbggdhd	TRUE
aihjdificbebaddehcha	TRUE
djefcihfejbbhaegddhfecf	TRUE
gcbdj	TRUE
caeidfdhagcecicffbbfjhge	TRUE
ffihifheihaddidjfbc	TRUE
cdhedhb	TRUE
heijji	TRUE
hjbjgcdcebaei	TRUE
fijieahdhfgjdhbd	TRUE
cbjhghbbffje	TRUE
cdejhagaddiaagabgehghgd	TRUE
jiecadbbaddf	TRUE
gjihjfbffdeaeibecabjfgb	TRUE
jjebeifajiafhhe	TRUE
higjjheefahffcideda	TRUE
eijcdfdjhhifibiagjhb	TRUE
jafjffgab	TRUE
hijdi	TRUE
jedbigb	TRUE
ggfjgiedhgdcahhiece	TRUE
bhifhcggbif	TRUE
abgegeghehdcjcgiidbidg	TRUE
bcejjgecdabf	TRUE
fddieehidejiad	TRUE
hagddcjg	TRUE
hjchi	TRUE
a	TRUE
jigfeadhjeidfcjbeegeaai	TRUE
hedbcfefhdgiabieh	TRUE
d	TRUE
eagegghiide	TRUE
ghfhehjcacfighf	TRUE
ibahiehifb	TRUE
ffca	TRUE
jjbighde	TRUE
hbefgca	TRUE
aiagigdaihc	TRUE
bjci	TRUE
acicjibiddjfdihihdc	TRUE
hcacgjach	TRUE
aefigjbcgcceajcddjd	TRUE
ggcaccjjgaidded	TRUE
jebiddbgbafi	TRUE
fgcfjcbdifdageffdgac	TRUE
afghaigefgf	TRUE
cjic	TRUE
dijgjdffhbdcbcec	TRUE
bfehb	TRUE
gfbieb	TRUE
fdfacajaghjeeiaefehdhec	TRUE
fhcfffjafejjhggbedgije	TRUE
dghdjfjeibbjhbjb	TRUE
jh	TRUE
jhg	TRUE
hiacfibdgjdjidcfiidcfcjff	TRUE
dbabbfgddjiibdhacadabjh	TRUE
jiefjiffcj	TRUE
fga	TRUE
jgafbahiiefeadf	TRUE
haifigfacbig	TRUE
gdfijcehehjbhfejj	TRUE
ec	TRUE
idfaijchdf	TRUE
gfgfgjjbjjjjggjjdh	TRUE
ih	TRUE
hhjbigebhbefffdde	TRUE
aabbi	TRUE
baeaafebeefa	TRUE
jedjidaihhahjjbhejbdg	TRUE
fjijdji	TRUE
i	TRUE
jciebhgh	TRUE
jfdgchbcjgidcagbgeed	TRUE
dgebjefdbdbggcdjbcche	TRUE
fdd	TRUE
bdghidfgbgccahccdcghb	TRUE
feacbhiifghfgca	TRUE
ceejjfd	TRUE
cde	TRUE
dgdhcicdffgie	TRUE
gjgebgaigjjedjbae	TRUE
efdjdbbdeidjhjaabheaab	TRUE
biahg	TRUE
cjajdjjb	TRUE
ddhcchjeddjccac	TRUE
abgfedbeafcbhjeahe	TRUE
hdhigbgaefeacffjbebd	TRUE
bbebhddhfeeij	TRUE
gidfffgieihhgjjdjdhbddhg	TRUE
gigjihia	TRUE
hdheee	TRUE
fbdfeaccfcebbdibejajfdbbj	TRUE
ehjijcac	TRUE
ih	TRUE
fdhdejijf	TRUE
jhjbehbefiagehbaeijed	TRUE
bc	TRUE
dbjbcjfedgcifhbidhhgbe	TRUE
eje	TRUE
bfgdajfjgefaafbgaeab	TRUE
fciidjc	TRUE
hjgcfidfcjibhccgfc	TRUE
jgdaigjggbebghiaaaac	TRUE
achbjcddb	TRUE
gcc	TRUE
dhgijdhfgeicdfjgbcgh	TRUE
abdi	TRUE
ibcfecaddaeajgddgbaiejceg	TRUE
diedacagjcifdcc	TRUE
hfdjbcgchfhdbjejbfe	TRUE
jbibhdicehigcegbac	TRUE
dcafegeiceiaaj	TRUE
fdiccgec	TRUE
ebe	TRUE
adbbjfjaadiegihfjdhjcfi	TRUE
hfcfefebbafbacgc	TRUE
ecag	TRUE
jgeegdda	TRUE
g	TRUE
eieafcdaccac	TRUE
eaeaficg	TRUE
aechffjh	TRUE
jieggjbijbhdecgjijbbcf	TRUE
ceddjhcahcgcdjafafhagaff	TRUE
cehdafehc	TRUE
iia	TRUE
eccbbgajiidicj	TRUE
efigdd	TRUE
bgifhhdehhaadbaeehdaci	TRUE
di	TRUE
dj	TRUE
eficafeefhd	TRUE
jih	TRUE
bfejgbeahehbdagjhigcebjd	TRUE
fjcefbgicij	TRUE
hgeegchhj	TRUE
bieg	TRUE
hacaiigjhbefafibijc	TRUE
gidjhgicababcg	TRUE
baieeieihhcdjhijc	TRUE
dgiafcahhcdajbjfeiafgc	TRUE
dbagdeadich	TRUE
bifijedfajdcfjibb	TRUE
aeahegeifbgghc	TRUE
djedgcdcdag	TRUE
chjddecbhhjfdajg	TRUE
dcfgcdhdhdfghifhagjbiah	TRUE
dhbchedffide	TRUE
eacjiejcggdebjhjfjedd	TRUE
aihcbdgddebdahhbahgefb	TRUE
bbgcbdffjfbhbjdbheahj	TRUE
baebegcajghafdcfcahbiiac	TRUE
ejfeidf	TRUE
b	TRUE
dbggcbgbdjc	TRUE
ih	TRUE
hciaahj	TRUE
aggjade	TRUE
bjddjgebcgcef	TRUE
feeaacjbbhbjcjh	TRUE
ddefabhhdaedcjgjafjghb	TRUE
hbcfifccdbgccc	TRUE
hdjgfgdjiaghigjhif	TRUE
eigbehdjc	TRUE
afjjf	TRUE
dhjcibejaigbgeebigd	TRUE
jfibgfhcffeghh	TRUE
fgficfdafbbd	TRUE
iedfjf	TRUE
biaghaebaiedhfgde	TRUE
heiegiceiicbc	TRUE
hbbhhhhgejhbad	TRUE
dfadajhc	TRUE
bjjafcbjgaeffaj	TRUE
efhcfhfjjebdgjiei	TRUE
ggbhcfeceaedffhg	TRUE
cdgcdfhfgee	TRUE
f	TRUE
fbjgjbdhcebfabej	TRUE
abighichbbgiiddecigadbbhe	TRUE
ddfbgjbhhbbeafdjhdfichf	TRUE
iiaeg	TRUE
aehbjdffbheibchhjbi	TRUE
hdefdfgcbjecbcicghighjfi	TRUE
bfjchdebdii	TRUE
heecedfeeeiahgchibdgec	TRUE
h	TRUE
gbcjgee	TRUE
d	TRUE
chbgfjah	TRUE
chfacbbgheheea	TRUE
ajifhejb	TRUE
feiaghgjfgdhgjjiahgeedah	TRUE
abeibddfjbj	TRUE
ce	TRUE
aaeb	TRUE
ibbgbfcehaehfchgbfhe	TRUE
dhgjgfg	TRUE
a	TRUE
cbjifjjcibdgiigbifddahgb	TRUE
dcedfe	TRUE
fcgjjaceadcf	TRUE
gajfgibaaejjbehdhhaijh	TRUE
hfbagcadigfa	TRUE
ehaaeiadidhhfhbh	TRUE
fcgghhaejfdfjdicjdf	TRUE
icfgiafgcbegfbadgg	TRUE
iaedeejhbiie	TRUE
ce	TRUE
fcfccgdiadbcaabcdbibeifeb	TRUE
cihdfghdaceeb	TRUE
giighcbcdfcd	TRUE
gdcj	TRUE
abcea	TRUE
hifaijaaiidhd	TRUE
aaejfgghebdjgcejf	TRUE
ejghacgeeacc	TRUE
gihdg	TRUE
djidfc	TRUE
cacfdajejfjbi	TRUE
hdbaebechbejddegeicag	TRUE
icghahhhifbbbahfchcg	TRUE
abghjggcadfhchcgfhbaaddi	TRUE
hjacjfi	TRUE
ebjacfhcjjhjjdhjjjhaa	TRUE
ahfijdjgbeabdgajb	TRUE
eaj	TRUE
gjia	TRUE
f	TRUE
gifj	TRUE
afchafbaeb	TRUE
bicigahie	TRUE
haefgich	TRUE
hhdbhagdjb	TRUE
ja	TRUE
bdchj	TRUE
jjegjbbhbafaejdh	TRUE
geebecjddgibfbacgdjfai	TRUE
bjejacaccfhgcgiahjjafaic	TRUE
jcfigggcahchfgefdfihfifec	TRUE
dbgjbcdadgijfgfjd	TRUE
dhhbeh	TRUE
ieaafig	TRUE
iigfdbbjhacaee	TRUE
eajcjdjdf	TRUE
fcaifabchb	TRUE
eigi	TRUE
eicfi	TRUE
dce	TRUE
hibjaeageegcihbggegd	TRUE
cfihafgdbhcjbbaaideeb	TRUE
hedfaihbddgfidiejgd	TRUE
jeg	TRUE
hfc	TRUE
idjbgahhafgjegabbjdfi	TRUE
ddjecebaififbejbhfhijeeij	TRUE
higjgcggiidiebbaj	TRUE
gabdhiafgibehafabgji	TRUE
hibghjihgi	TRUE
hicefbjbjffhjhijjiaecd	TRUE
cdbje	TRUE
decfiihbhccbbeebfda	TRUE
fhdijfadaheeahg	TRUE
ffgfaabachigaihccddd	TRUE
ifegdg	TRUE
ehahcachcigdbdgbihecbi	TRUE
e	TRUE
chcjehbhfddfgaigfd	TRUE
gcggcahgf	TRUE
eeabffehgjiaidafh	TRUE
hfjbggbacjaafffehchc	TRUE
cdiiidicgifajfeejdeaccbih	TRUE
j	TRUE
bijhbibhbhhahdfiabhich	TRUE
cajabhbbheafhdhjbbehhjj	TRUE
hdecddefeg	TRUE
fbjbaeehadfeidbiigcabi	TRUE
efaiafdijbefhgbebcahfgah	TRUE
ddiaefgafahjdj	TRUE
agdeijcjig	TRUE
cfhhciafid	TRUE
ebcgdcbicjh	TRUE
hfehdhebeeiajdi	TRUE
iigdfjgaacaeeaigedbffejee	TRUE
hb	TRUE
i	TRUE
ejefjdccei	TRUE
ejegbjjebaigebhfihaaf	TRUE
hgegfjcihcadgagcad	TRUE
gaebbbfiegag	TRUE
ceagcahjgdeaajiiehbiciei	TRUE
hejij	TRUE
ffii	TRUE
fdhjc	TRUE
aegcidgaibecedafehah	TRUE
hgeief	TRUE
hgeacdciajejfbbicijai	TRUE
cajdeheeeaehadcighgi	TRUE
hcfaiiecgdjdgdeaj	TRUE
jedbbgeihhbfffa	TRUE
iaggidiefhfchcbbhbdid	TRUE
dhidaaaigf	TRUE
hejjegfbfaagiheebgaji	TRUE
ciaihiage	TRUE
dhdhfdf	TRUE
ajda	TRUE
chegfhdbbahecehidd	TRUE
gjbehfdehcdd	TRUE
ihgfeaigecfhahabbijedcf	TRUE
aedh	TRUE
gh	TRUE
jhgffdafadciai	TRUE
jhdcdbdjfhficejhefg	TRUE
caegjihjfiibajieg	TRUE
fdafaj	TRUE
abhdjbc	TRUE
eieiefdjid	TRUE
ddegahiefjdacjgibjdfdcb	TRUE
bcgagag	TRUE
bhfdcjijbjffjfiegi	TRUE
gba	TRUE
adf	TRUE
jbedjbddfchcghafgbcbhhc	TRUE
ajed	TRUE
ebgahfccg	TRUE
gajigdffhgbeff	TRUE
jjgdgcjjbdbcbabjgfaabihf	TRUE
ajcjdefahaadgcbjbbbcajj	TRUE
babhedebgehhcgejcgf	TRUE
jjjjefifgbgfidfd	TRUE
djifdfjfidj	TRUE
e	TRUE
gedcehhjbggijde	TRUE
ah	TRUE
agiddhejfifeig	TRUE
cg	TRUE
aifhahb	TRUE
jjigicjjjacig	TRUE
abbahebefdf	TRUE
dbeffefihghic	TRUE
chbefjfgddhbid	TRUE
dadfadhbihbdhcbih	TRUE
ceefjfdhicgagedeaghi	TRUE
jhjg	TRUE
gagjdjggdcgdijdgfd	TRUE
ebafccajieefidff	TRUE
e	TRUE
aggdehaebejjegaaeibegdcg	TRUE
dieigaeiaijdgfjd	TRUE
gefdbedcehhia	TRUE
hfbgggbaic	TRUE
idfgdieideheghcbiaj	TRUE
edacddgebfhifcedjaihdabb	TRUE
cgbjjgfd	TRUE
hcgjdcegg	TRUE
fbfjaeejacagif	TRUE
fbedbhibbbgjfgighgab	TRUE
cdbfgjdbggbjehjdgjh	TRUE
giibib	TRUE
eiegbejfcjbcge	TRUE
bhaebdhjacbffdf	TRUE
bjahhiihfeiejfafecfdcjicd	TRUE
cgfeadgddifdicb	TRUE
ijebagbiafbhaceh	TRUE
bbjbahidghifbdbgiebj	TRUE
ihifbgiggbbijhgfchfbcdg	TRUE
cfaeijidbj	TRUE
cggdiejijfdj	TRUE
cje	TRUE
jibhafabghfja	TRUE
ghgide	TRUE
bbjbechbeccdbifdbhcib	TRUE
fiaaegihgdebhib	TRUE
hgcgjjhjaeheeefiedifhfi	TRUE
jafgba	TRUE
acaceb	TRUE
heceggecfabefcgfaeaiagf	TRUE
didcbceg	TRUE
cjjaeaechciaecdcfighd	TRUE
hgiajjhjbghdgde	TRUE
bdbhjiccdjdfegf	TRUE
jhead	TRUE
eeejaaiadgbghfhcjg	TRUE
dhgiffcffjgg	TRUE
cfcajdbjcaehfcddebi	TRUE
agfi	TRUE
idhdbbcicgcjig	TRUE
gfbfhafgcajfggaj	TRUE
cjeiheabb	TRUE
aaicecghdaifaghdigccehfbi	TRUE
fffbdjcfchdjddfegggdfehgh	TRUE
dhdaafiihi	TRUE
b	TRUE
jcijeiif	TRUE
gjadiaifi	TRUE
hbbbfgedbejebbfgh	TRUE
hffigdbchda	TRUE
fjbg	TRUE
fecgiggbcghfhchcgfc	TRUE
jdbeccfhbddchdbh	TRUE
ahiabgdbhgccfdjjheagaieje	TRUE
fabjhc	TRUE
hdcchhajdjifhhbedbahhdbfb	TRUE
jgi	TRUE
ji	TRUE
bbhhgebehjggb	TRUE
cigddeeced	TRUE
ijbabccagg	TRUE
affejbehefhbhahghe	TRUE
ighhcfiacfehfbfecfidhbdb	TRUE
beffgjchaecfgaeibi	TRUE
cfidjddjaefjhi	TRUE
bidfeaaafiajagigahaii	TRUE
e	TRUE
bdfhiif	TRUE
gdfajfddchcfbfehifb	TRUE
feiebgdb	TRUE
jbfcfhabefdihdidheadh	TRUE
ig	TRUE
ibj	TRUE
fihfhbgbhifgigaeiebffch	TRUE
fajcaehaffbehfacjd	TRUE
dddjaefijciifdehdfjbiiaej	TRUE
bgfieidjhjdbbg	TRUE
hfbcbiggddg	TRUE
ajbbahabbbad	FALSE
agbhacbfaabffjbiadbgjj	FALSE
ahbbaagibbdba	FALSE
iabefdbjaagbbbbcbaa	FALSE
abahbagjfgggabgbeah	FALSE
gadgbgjijdbjaabebhha	FALSE
abbaabba	FALSE
jjbhaiaabjcihbhgafababfda	FALSE
adefffbjbaabfdghhbbcdafg	FALSE
gfadebahfcjeigbaaabba	FALSE
abbaaajbfbha	FALSE
ddaiehbibcgajahebhbabcagb	FALSE
aaihbbedbcdaaafbbae	FALSE
afjabcbcaadfdbjba	FALSE
ceefhagebbdbhiaaiabbaa	FALSE
abgbfaadbbha	FALSE
gcejagbfdbcaacbbfedcgahg	FALSE
aabcbgbbbaciaadbabhbia	FALSE
ddaabbbfdachajafbbbafda	FALSE
bgjfiaebbaajiaibba	FALSE
ebababaahcbbabd	FALSE
hbbahbebbaagjdibbhabaeibj	FALSE
ghdaagbhcfbjiafaeabfbiab	FALSE
abbacabba	FALSE
dacbgbdefceehabbiabdhajba	FALSE
agfbbhjaaheehbba	FALSE
aiijihbbajeahbjbac	FALSE
jjhahbgaaciggbafgadbhba	FALSE
abidjbciaabba	FALSE
abibafiabba	FALSE
abefdagbbdhaaafabhhbcaei	FALSE
aibididabaabbba	FALSE
aedbjbeeaabbcba	FALSE
acbicgbebaabjbaahijjeif	FALSE
jadjbbcafhfibeaajebbaccae	FALSE
daihbdbaedabbaf	FALSE
abebeacjafcbibjebhjbga	FALSE
dabfibaadfidbajfbcdba	FALSE
cagbeabagabbfda	FALSE
abbjijgdahdabiebbibfca	FALSE
habbaaiaibaibcbgbjafif	FALSE
bhabbbfedbgjaeabbabgcc	FALSE
fdiehajjbbiaacbibad	FALSE
afibbaecacbbafcei	FALSE
abbaabba	FALSE
fabadhbcadaebgdhbabfa	FALSE
aghhaidbbfaedacbbac	FALSE
abbajabbabg	FALSE
dabafgabgaajbbea	FALSE
ajfbbdbccbjaiajbbja	FALSE
ababdaabbba	FALSE
abbaabbab	FALSE
iabebigaabbafb	FALSE
afjjcebibfcdaajacbgba	FALSE
bjabbafhaaacebbeeaabha	FALSE
aabifidbaiabgbhbhadac	FALSE
fgaibbhahfabbia	FALSE
ifeaibbhaagebghjba	FALSE
abcagdbeedbabeeabbaj	FALSE
ccabdbdffcgadabdjgbbhac	FALSE
ajiabgbcaaadcbbacd	FALSE
eabbcaabjgbaj	FALSE
chacbbaaieggabbdebjdia	FALSE
abbaabjba	FALSE
egbabbffaabbbadbacc	FALSE
adbacbaahbbai	FALSE
aadhbhbbjaahcbdbjbeabaig	FALSE
abbbiffdidiedadagbiebdba	FALSE
abebbaabfaaaabdebabg	FALSE
fadbbidafabbaihdb	FALSE
bababaabba	FALSE
gajeacbfjbebaiabbaac	FALSE
bababffjhggbjaiaahahbbcaj	FALSE
feadbbiacabbajcjfb	FALSE
babbaaehbbab	FALSE
aabbaabbba	FALSE
daibchjbaabgedbcjfgah	FALSE
abcbaabba	FALSE
iiabadbdacjaghbba	FALSE
abdbaaibba	FALSE
abhcbebadeabba	FALSE
jacbbjaababa	FALSE
ajabbcaajhjbbfjiheai	FALSE
bagbiefbabbiaabbjijaifae	FALSE
ifaagdbbahaebibag	FALSE
hagbbaabbafa	FALSE
agbbbaabbaaia	FALSE
aabbaabbadde	FALSE
babchabbadahdbbjihba	FALSE
babgdbgadcacagdbbac	FALSE
idfabbdibaaaajbabhicbjaj	FALSE
dabbaabjbaa	FALSE
abbgabeabbda	FALSE
iabbahajbbbaa	FALSE
abhbaababaf	FALSE
abcbadaacjbhdbfacifdbgh	FALSE
abjehbbajcbaabbba	FALSE
afbbaabgjcabgbaa	FALSE
abbaabba	FALSE
abbaabdgba	FALSE
abbaabbfaif	FALSE
ajbbhhajcabbafjbcgjiabh	FALSE
dabbaabbaj	FALSE
abdbafabhba	FALSE
eabbagabbbagf	FALSE
eaabbaiajbccba	FALSE
adddbbbageabfhihba	FALSE
aabjdbdiebaahbgjeebdfba	FALSE
ajbbgaadhbecbbeah	FALSE
abbaabbbea	FALSE
adfbbaabbae	FALSE
cbaffhhbabaeajdbifbibba	FALSE
ahbbbgaabbjbab	FALSE
abbaabhba	FALSE
cabbadabhba	FALSE
aehbbaabbah	FALSE
abbbbccaaaibibcja	FALSE
fabbhjaabbeajb	FALSE
aibddcbajabiibga	FALSE
abcbaiadfabdba	FALSE
aaigibbjafbabbaf	FALSE
fagbbaabba	FALSE
aeibcbdjchcbeifdgaabeba	FALSE
gaajihbbacaabdfgbijia	FALSE
abbjbabahbbbjbbbghae	FALSE
gfcdabbibbaaabbea	FALSE
abhjbbdaabbaa	FALSE
gggabjbbbiibhaeaaehbcba	FALSE
ahbdhjbcabcgahcbagaba	FALSE
abbaabihibbha	FALSE
dachbhhbcaciifabdicbhabj	FALSE
abfbajabdbaj	FALSE
cgabbjbjcebgaiheacbbfa	FALSE
abjhbajbcaacdbjaachheabaa	FALSE
abhbaaabba	FALSE
abbgeagabdabaj	FALSE
abbhaabba	FALSE
abbbaabfba	FALSE
adjibbaffigbdabbdbbhaafe	FALSE
abbbgaabbbhda	FALSE
gbabibaicabbecja	FALSE
abbaafbbja	FALSE
abjbaabbibaghigbga	FALSE
biabbbjhahaaeddebba	FALSE
habbgbibbfbhjiafjabba	FALSE
abebajeegeahbjcbia	FALSE
eafffcbbdaiaabbajjj	FALSE
abcbhbaacbbagcf	FALSE
abbaabba	FALSE
abbaabba	FALSE
gcfacbebbaabggbaajgjj	FALSE
fabicbjajabbdifidbhaffad	FALSE
aebdbaabba	FALSE
abbabcacbbea	FALSE
abeeaebdaaccgaaghbibbag	FALSE
jajabbgcgdbaajgbchba	FALSE
aibbbaafibbbfigda	FALSE
aibhbaabba	FALSE
bjadbbjjaeaahbbbfaih	FALSE
fabbaibabbgbfad	FALSE
ababjbgccaidabbcigafc	FALSE
abbaabba	FALSE
fiabgcbaagbdba	FALSE
fbabbidbaaefabdffcbae	FALSE
abjgbaabjcaaebgbda	FALSE
ajaaaeiibjabaeaceigacbbja	FALSE
dabbdaagcbbaa	FALSE
gigjccgiajibbbaeacfbba	FALSE
abbaabba	FALSE
abbaabba	FALSE
aigbabadaabbffa	FALSE
abbaabbha	FALSE
babibcadabecibag	FALSE
abedjjbadiabgbag	FALSE
abdiebaabeebba	FALSE
haibfbiiaajhjgbbgbhjabai	FALSE
afhbgbdbaehiababad	FALSE
eabjhbaabfba	FALSE
ajbgbgaabfba	FALSE
abbaaebgba	FALSE
abbaabba	FALSE
bcgaciabcjbhfabaaibgjbfha	FALSE
chjaebbaiggaaafbffcaabada	FALSE
iabbhdhaabbaejhfj	FALSE
jfabbfgcaaddbhba	FALSE
ahbbjhaafibdgijajiba	FALSE
abbgiacjdagbabca	FALSE
haibhbhbahaebbaaha	FALSE
abbaabbaf	FALSE
dhbahichbbacacbbbjbacac	FALSE
abebaabba	FALSE
abcbbbbaciabba	FALSE
bcfabbcaaabgbhfajba	FALSE
ifgacbhdibaajbba	FALSE
abcfbabaaebaiabbafa	FALSE
eeabbdaefabbah	FALSE
babbajjabba	FALSE
abdbaabba	FALSE
chabjajbafeabbba	FALSE
aejbbaabibafa	FALSE
abejbaababagda	FALSE
fagbfbigfgbaajabbhhbahgj	FALSE
afbcbgbcaiacibcbhhace	FALSE
abebaabdbiajhba	FALSE
ajjdbabbaecabbba	FALSE
aibgbbaajfajdbdbdieag	FALSE
babbaaibebab	FALSE
aijbibgdhdacjbbegchabbac	FALSE
abbbdagabbbebah	FALSE
babcbhaiacbbjafg	FALSE
habbbageicfdaebbbadj	FALSE
bhacbbhceaabba	FALSE
abbaabbja	FALSE
babbadafabbejfbia	FALSE
bgababhhghiaacbhhbhacef	FALSE
dajjbibjaaahgcababbajgb	FALSE
aebbaaabba	FALSE
habbbaajbbbfbha	FALSE
abbdaabbea	FALSE
abbaafbfbgaaa	FALSE
abbaabbba	FALSE
abdbaffabba	FALSE
ageabbjibfccaaebibaiei	FALSE
abbfhaabbbhah	FALSE
eabbaabbga	FALSE
jaceebbehaeafcjabacbbaa	FALSE
efecaijibfbaabbbefac	FALSE
aiebbabaiebbfeaga	FALSE
aafghabchgffbafajggddbba	FALSE
bacbbicaaabjhbjahcgfbeg	FALSE
agbgbfbedadicaaaabdhbbahi	FALSE
cbgfabccbbaaadhbbadbha	FALSE
agcabebhfajfcciabbecajc	FALSE
abbaabba	FALSE
aagbjchbghahfjabjjbfad	FALSE
abbcdaahbibhabbeea	FALSE
abbaaebba	FALSE
gabbagdhehaaabbagiie	FALSE
dfgabbiaacbba	FALSE
jfabgafcbaabbbgae	FALSE
acibbaahbbai	FALSE
aiaibchjdibbaabbah	FALSE
djfaicbbjgcafgbadeebciba	FALSE
abbjaafbbha	FALSE
jaccabbaabibja	FALSE
babdbbaabbac	FALSE
fiabdgiibgdhaeaddjibbhfac	FALSE
dabjfdabaafbhgba	FALSE
cahbcfadbaijcacbbaagd	FALSE
iejgabcbaagggbbeaahd	FALSE
abebaabdhbejhbhaee	FALSE
aabibddajaggjbedbfdbeja	FALSE
abbfeaagaacbbba	FALSE
abhdbchdeaabbhga	FALSE
jafhfdbbeaaabbfhca	FALSE
hdjfjabbaaabibah	FALSE
abgbfaaafbba	FALSE
aibbbjaaibbdaa	FALSE
abbaabba	FALSE
abbaiagbbadjbbahhdjd	FALSE
efgaebbcaaebagbagjh	FALSE
acbbhjagagbfeabggcaai	FALSE
eajbgbbaaabbaah	FALSE
fjbafebcbbcfaaahbcbae	FALSE
abbaebaabbad	FALSE
agbbbdaajbgbba	FALSE
ajabjdgbafabgcbba	FALSE
abbaafbba	FALSE
abbaabba	FALSE
fiabbdcaeaabgbaijh	FALSE
abjjibahbibabdaba	FALSE
ahcbbafcafjbbjahhdadijjf	FALSE
abbaabba	FALSE
addaagbecbjgjaabiebfa	FALSE
bdaibadbafgabcdgibab	FALSE
abbaafbba	FALSE
abebeahcccabbaibbhec	FALSE
fabebibajcjabcbbaf	FALSE
babaiahbaabbaia	FALSE
abbaabba	FALSE
abcbacabbba	FALSE
abbaabba	FALSE
abahbcdbddaaibfeadbgebhac	FALSE
abdbbaabbjgea	FALSE
aabdjbgiahabbdba	FALSE
aabbbgahfhacaaifdbddbbcga	FALSE
cfagbcggbbabadbfibgahfd	FALSE
hddahbbgeaabbja	FALSE
abbaabeba	FALSE
ahcbdbahbaehbhgcfbaad	FALSE
abbaabdjba	FALSE
edabbhebgagabcgahdfaabba	FALSE
acbbaabbaf	FALSE
bfabbahabbad	FALSE
abjbaabba	FALSE
abdhccbhgaahbjbda	FALSE
baeehbbahbhbfacjacgbaba	FALSE
agibdbdajcheabbfahbah	FALSE
abbdaabba	FALSE
abbhaagabba	FALSE
habbaabba	FALSE
aghafbfebbbecefaifabijeba	FALSE
abbaabba	FALSE
eacbibiaafbbafdcjea	FALSE
abfbaaaiebbgaeh	FALSE
jabbaaebbbca	FALSE
aebffbeggfagabbacabf	FALSE
fafaeebjibiaddjcabbaha	FALSE
abbadabcbab	FALSE
ajbbhadigdeabdjbafbfdi	FALSE
ajbbjjeibaabba	FALSE
aibbajgiebabjbhba	FALSE
ejaeabbfcaabba	FALSE
abbaabbacahic	FALSE
iabbcfibgaabajiba	FALSE
ehabfhbjfdaajebhhiabad	FALSE
afgfeebiejdfbajafdabfjjba	FALSE
abbaafbcbaeidi	FALSE
gabbfeaaiibbafg	FALSE
adibbaabba	FALSE
acbjeebadaghfiidhaabfegba	FALSE
abbaabba	FALSE
abbaaibbbca	FALSE
eihhabdbcjabaabjegdbcafg	FALSE
fiabdbbadacbbbaf	FALSE
dabgahibaahjgdbafjba	FALSE
ijihajbfbgaabba	FALSE
abgbacbaibdjehjbaij	FALSE
edafbbeaihaebcbgbghhbhada	FALSE
habbjcacdabjbbcbaa	FALSE
abbaabba	FALSE
fabbaabhbag	FALSE
fjabbaabba	FALSE
jhiacbhebaacbbafehc	FALSE
abadbaebadgacgjbbah	FALSE
hgabdbeaacgbgceebca	FALSE
iabbgaeabadbafcj	FALSE
hjdgbaeabdgbaaieabbaegacd	FALSE
abcbaabba	FALSE
abbfaabceba	FALSE
abhibeaabgbah	FALSE
abbhadciaadbcbbbab	FALSE
iabhfibadiafabbagi	FALSE
jfaghfbbcabiabbja	FALSE
ahahbbaaebba	FALSE
fdacbbabahbbaa	FALSE
abbaabba	FALSE
acdbfbbaijaajbbicafafi	FALSE
eaadebbaidaagdjbcba	FALSE
abbijaaicbgbfdhahjh	FALSE
jabhbagabba	FALSE
afcbhdehbiibabihjabcba	FALSE
aeigbhbaabbab	FALSE
abbaabba	FALSE
iadcbbdaabbbaec	FALSE
fcjabibaabbha	FALSE
abbbgagagfgaiccabbdabghb	FALSE
agbigijbcjdaaaibgcjebhach	FALSE
afajbhbeaahaacbbdifjga	FALSE
ajjgfgbfbaahbbbcciac	FALSE
