WCsGZDz	TRUE
pr2gKyC3azKNSuStvYwBjCMbz	TRUE
fOsvNjXKkWfmTyIk	TRUE
K3YNuEU1YQMx34iwWiYhK	TRUE
ApdrkCBMPznSftRX	TRUE
O	TRUE
syabswDNpLDdtuwv4	TRUE
AcnFpARU	TRUE
dkDYfVsgX	TRUE
vMOcOoKin2QJoI	TRUE
uuXnkpUs3ZbD1jj2	TRUE
BKDGiVAR	TRUE
mBFY1	TRUE
leIjosjSb	TRUE
QWp	TRUE
YcgYcW	TRUE
pkvr	TRUE
snDXXG	TRUE
1BPaopPDdit	TRUE
n	TRUE
jGBkOZQ1Lrcq1K22ba	TRUE
MTd1gD4OYZcLGEU1VqoMU1uz	TRUE
NZhialvJyQpThUcPxVma	TRUE
XeBeue1drEkvUAIZvtCN	TRUE
tiENGlahXt3a2wKZH	TRUE
g3aNkkWBCpFMJOlRnwqaE	TRUE
dWbAHB	TRUE
mP	TRUE
YjCOCQr3c3CJ	TRUE
CgNngepU	TRUE
BUVMDcdy2HcLMocwFDf	TRUE
DJccfsVMTg3uftPCvkJz	TRUE
slnDfft1cBmqKoBLq	TRUE
zbCuAJpx2krCGFo	TRUE
UTMTjDBvQiNrAMdu	TRUE
iM2vEhhFLeDZPlD	TRUE
S33MM	TRUE
bMduwUuBDLo	TRUE
DWNZGPmGCQgSNiUYVv	TRUE
tsRknaxBmMYVDPCb4duTk	TRUE
IU	TRUE
JgfHg1zn	TRUE
P	TRUE
XXEUtbpJyWUbrG	TRUE
osCHQediZk1xEOoMdwPp	TRUE
HsAa	TRUE
11KSmqgbqnxAiQkBM	TRUE
hkZTqnVWVnHMmB	TRUE
4Nz	TRUE
HGqkydr2ggEWWbXu	TRUE
2GM	TRUE
QDDcqlPmUwhXTbmicmnfajxJ	TRUE
mxyS32kAxSZEKxkdQmQUfMrcx	TRUE
kkju	TRUE
EHXdTYlnPD	TRUE
BGtpm3HsXiPpDwojH	TRUE
n	TRUE
TlZwGBIMgRV4LMTM	TRUE
zbnCtwsFtTVEJaTu	TRUE
nTlDws	TRUE
VmGuPDrGTX	TRUE
PvfBAOoLVVyQLPoMlftCX	TRUE
4rRUqzz2pFPba	TRUE
aoxk	TRUE
tBlEyVnsNT4aBpJ	TRUE
4aOlM4hg2UJPpjwMV3YA	TRUE
yP	TRUE
hhcOi4VwImAHZK3gErsNPZ	TRUE
MBAKk2ZzZWh	TRUE
gAVtwP2vJOqzjQsfQSKoR3g	TRUE
sbYQ	TRUE
nqkMoXo3zcGysB4	TRUE
L	TRUE
ktHFwWLdV2	TRUE
PmzhOEVKJfnlXoKBjr	TRUE
idHTYjBFdm2owztkTuUVokU	TRUE
1IFNfqP1bTUIZcUs3obH1hbd	TRUE
exJIJpm	TRUE
IDxX	TRUE
4UkeMWmqBEEJN	TRUE
p1NKtSgqJbmlSem2Mwiugpd	TRUE
z	TRUE
SNVBahrXGjc1docOTVwzVCO	TRUE
V1szKKNdFrNf1MwB	TRUE
lRZ4FRucm4evmK	TRUE
NZ	TRUE
eAwQTgkzB	TRUE
vqaZP3zCg	TRUE
OEXTEyxYGfxXMp3	TRUE
X	TRUE
WT	TRUE
cCzN3idZPPH1XmTdXpSykRxF	TRUE
z	TRUE
R2GKkxfQKk	TRUE
1y	TRUE
CdSqMPhpbYzQIXXA44xMDXK	TRUE
S	TRUE
L3OqcliGioJC3BnzCg2t	TRUE
4rf	TRUE
ctLboUhed2PdPU	TRUE
FJpWYtzzKmenyjBuXA	TRUE
CaqHt4P	TRUE
xqUXwvMJakzEe44irgYEFWse	TRUE
cRcOZoB3W3yzMdzRg	TRUE
SlMKyBGgqnNZn	TRUE
SaHlU	TRUE
sdbsgHPX2piu1	TRUE
HIKYupkbdOCahlt	TRUE
SGoCUFBGDRtjKQPWhjtysGO	TRUE
JIp	TRUE
LXdLvQqWRxoUAV2d2yTa	TRUE
Yu23huRsFlNiFdcX	TRUE
bjTwWYZUJvMoFsijUCEgC	TRUE
BPkhSnOx2TA2L2jklzSTwMqbI	TRUE
OtHSuIwfahUA4OGXV	TRUE
BgIHbzx	TRUE
CvlTPOEvjGTMFPZ1YgqYS	TRUE
dMEWwhLLd3Cb	TRUE
uZmQQ	TRUE
WqKJ4	TRUE
doZxwNeTY	TRUE
COYhG	TRUE
qEiUbvkRwgwHy	TRUE
Y	TRUE
P2IqYhH	TRUE
N	TRUE
iSJA	TRUE
v	TRUE
zfTU1fkFstQSUfnD	TRUE
iP1M1mFV2CF4moHFeYfi	TRUE
hrPWFunt	TRUE
EwJCpE	TRUE
iFULevdf	TRUE
Sgp	TRUE
Kk3nr1HkbSec	TRUE
4Wv	TRUE
nrDBqSoApXKpgi	TRUE
VB1bBkAtKAVyqlYQRFp	TRUE
VUSzDSuxTIJBZeln1MiMnt	TRUE
e	TRUE
wxXBRZrfBGtSjCYyrn	TRUE
rM	TRUE
Uh	TRUE
SX3	TRUE
BxJbxtVMnAsAlPPWEUD	TRUE
inqvR	TRUE
TpQ3u4QAGkhCHlbuPk2Xpabmo	TRUE
NY4L	TRUE
rgbdORmXLRXdaBPrdwVNec	TRUE
2KETZsl12NwSG1E	TRUE
yRduFeHmuGHXZep2	TRUE
wiLJ	TRUE
NkPwL	TRUE
sP3cJpSSBKrtZquIOO	TRUE
kez1o3vBhNkeuGJfuwInZ	TRUE
cagYb2elTThUCP4lEFWHNB	TRUE
TdpLsY	TRUE
EwM3F	TRUE
juNN34FJgNbWmKY	TRUE
yFDGtUlFDPVhCAugsPrBi	TRUE
YDQOCx4BKym	TRUE
3HXmyNOhAQsDQuvsgWe4XuS	TRUE
J2kJZdhvACwon1zL2AS	TRUE
Koz1CofQyV	TRUE
rV1AZpRtcNl	TRUE
LrkVZoRWh	TRUE
aQhdqEPwwtFicC	TRUE
hZekTcQJpZDpBBHauNHkUzdGA	TRUE
YzSrxVvLQsYkUs1mOhjqUz	TRUE
gHQYeeBgAXRf	TRUE
gWszlsOUFlcsij	TRUE
EmujzGmVhddlMvwP	TRUE
lZo1G	TRUE
iLyGmOOwczzJWzCtXvlRum	TRUE
i	TRUE
ofKLxOx3dkyhtIzVF3L	TRUE
cX1UJ2HTrASHMqrcoqv	TRUE
OTf11fcjNljAHE4XqBzhuQ	TRUE
c3Nca	TRUE
YuONFOiCmBdpl4VBJl1ZDRq	TRUE
yr	TRUE
nh	TRUE
Wq	TRUE
fWkQoiUUiPi	TRUE
11JabM	TRUE
e	TRUE
vMl3WM4qb4CefMeqqH	TRUE
ulhDelWPVjyhLJ	TRUE
2jFSmOA4pmiRrX	TRUE
HbzUIixoqRJVrRI	TRUE
PMzC	TRUE
wxGwHhrzHRPHQebTub	TRUE
DMlbvHOVCOJJhW	TRUE
gSO3TxFo4YzqF	TRUE
VJuoBwOn1otTQhf	TRUE
y2Fza2mk3	TRUE
T3EpauSc3qtBlR	TRUE
okdaJKqdgbZFHbMP	TRUE
jfiIeNfZCW3VkvsKUQ	TRUE
vOxK	TRUE
nJoTC2Ochy4UvYQOoaAe	TRUE
v1giCHLzMauQqQJahuzQXaNE	TRUE
jqlAqYZU	TRUE
EVHmswUAKS	TRUE
mO1bgLWkvZo	TRUE
giwux	TRUE
uUehA22	TRUE
bnBsJduluUKX	TRUE
G	TRUE
g3sdjNMkBdp3v3qGZ	TRUE
dZWJ	TRUE
NOHxVGb	TRUE
epw1b	TRUE
zqfNniChIdHW4j4BK3lvkP4	TRUE
XmgIOeKYwc	TRUE
ZIbJ1Nde3weGVuotbMweIjfV	TRUE
TVAnLdkjUxruNdMqCT	TRUE
2xWC3HHAW4Le	TRUE
KLoYX4uFZDZsD2oJdbyAY	TRUE
hilgvUjreJ	TRUE
zlIPktjdUS	TRUE
TgxgbR	TRUE
iVNqFxkEI1AIemSABu	TRUE
bs3eeGk	TRUE
BlMVdvZyLMi	TRUE
ufUTCErsh	TRUE
SabKmK2kqcA1H	TRUE
pncvVU	TRUE
1XZFhxCsCOmBpxUPCrAfQHH	TRUE
4ksFjsr	TRUE
2KlIURgGlKhGbQH	TRUE
pRrCdAGtC1UatlVOod	TRUE
eFGzjtLVkmYeGQkcaOio3T	TRUE
NSQQ3BKNOGhZYv3	TRUE
2UOLsNfjwyyIdyG	TRUE
vcXKbvsAnXSI4WmwIx	TRUE
ZO	TRUE
zXQtSAMdtyrlqG	TRUE
vPuqLNbSsM	TRUE
OqTXtXjaKMFYfNCVe4vzme	TRUE
lh3OlreFRpUkkbcrpg	TRUE
Ub	TRUE
LuVHpFYDL	TRUE
AVaseGuXCd	TRUE
kgtOswdxmQ	TRUE
pfoTkGgILcWKH	TRUE
DMtYV4OwmDqlPal3hqS3ajL	TRUE
wgfy43vmHZUB	TRUE
MXevjUWQIULAHQ3mxJMthCLPo	TRUE
O	TRUE
fpiYCB	TRUE
guVml2LGVFLcQY	TRUE
EmJkbqR3mLr2	TRUE
UwyOaD	TRUE
jGvGihCtjYEyspI2K2RjfoLg	TRUE
FUCccKW	TRUE
EvxziEhhJv3aVU1aUBfHv2	TRUE
mokDbOXa2YKiB	TRUE
GwsPrMg3	TRUE
wBDnrfbQn4mIZhGzmma3pZqSa	TRUE
wY2SR1gHlZIevmVRy	TRUE
DKGEc3mGyVy	TRUE
oQzEC	TRUE
l31loOHxjgSpDjnVAQGVmp	TRUE
equDtlLD	TRUE
F33BXSSaNhC4iLs	TRUE
srN3cZILRZK	TRUE
TJLjpLKs	TRUE
SqONmI2jC1xbXVK	TRUE
Tabz14tX	TRUE
TSsoNNPwbYO	TRUE
YJ2sevX1k2zUDfcf	TRUE
FvvW	TRUE
m3jPtjJxjjgY2Af4tlFQ	TRUE
hZoKWboqXas2aZwxMx	TRUE
zgbBDPcrtVmpPftgHfOyHPMC2	TRUE
JIb2bCuQkZRtjgcRRtW	TRUE
ZQukEpue	TRUE
w1qZxrXn3Y3nnRQ4JURqdwvB	TRUE
F3mgQGUmT	TRUE
AUqOQvhz3BI1MhWk	TRUE
ADL1qMHZaNLNocfJlOMh	TRUE
HXWzdkZlpHyKHBRKSzkFeVxGS	TRUE
SlyATjovgUVjfPVtFFwe4yQ	TRUE
clRytKpb	TRUE
CyxnxaCw3	TRUE
mDrJs2cTo4nYesFrJzCJDLGp	TRUE
k	TRUE
iShlVRTWL	TRUE
P4MXcZ1YxlQrHqxKAlHsWngvb	TRUE
Ihr4eOgbpxQmKIFlgwSNE	TRUE
FstqcEqrdSQErko	TRUE
knmW3lflA3erXbzv1MBH	TRUE
HGFEnTswIpnjXzURtHm	TRUE
WBw	TRUE
UK4CFbdSaizG	TRUE
FzeZFuMqBRj	TRUE
JUDeMe4RwyEtN	TRUE
yuOyTJIc3mnRHVvuLrUZG2nEW	TRUE
hsiK4vZs1gnTlXDIKaWXcI	TRUE
cMQ3mOx2R1hurI	TRUE
iJEo	TRUE
fi	TRUE
m2Y1azIfpo1ElMKzb	TRUE
GlJ	TRUE
dyDFzkVNug	TRUE
koYnhRxqN422cRzFJUd1	TRUE
2BttP43M	TRUE
VZMjBFapxEaQ	TRUE
jEQMY	TRUE
noajUwJWLNGR2nKV32dul4jl	TRUE
jpmbO1QTtZ3cdSkfIoTGOYaz	TRUE
DyrHgLrlbuCnM	TRUE
omaRaC4liDDzHBqDASpua	TRUE
x2DSB2hNKeuUKAtglgylc	TRUE
o2MGfNw	TRUE
CfV3TlqIFPqw	TRUE
FusFWGfYiVWSpe	TRUE
qjDnRDh3ytXsWwt	TRUE
Yk1s2oi	TRUE
3bTBA4DfLenaRfYGYMPf	TRUE
mAC3LhcHnGuDtwClR	TRUE
rNXg4QRicwtKhOqFND	TRUE
UuwUfFDyXOXjV	TRUE
ZhviHOfI1Ff1drKZ	TRUE
EnHgwUEbYU	TRUE
wyMu2DZC2xKabFT4xhWa	TRUE
OPvFxVyVlijTT3WqhJFHBPOGd	TRUE
wzca3u4Fgr	TRUE
SUFtBl	TRUE
yGFbHuHr3Gs2InZVHz	TRUE
itLmDmN4fVQArehJtXd1kU	TRUE
3O1YEF4xT4	TRUE
CgzyD	TRUE
MvHkOmdH	TRUE
4ihmSpBCDUm4jBmVjHkHI2z	TRUE
CzldKEhJrzCGR	TRUE
xSKK	TRUE
VSyRIpxbRvRHlPE2dfBMp	TRUE
ojCvhjG	TRUE
mKsJjTjAGTq1nKGIGeHjIhUk4	TRUE
gz	TRUE
FeBSecmJ2t3iA	TRUE
WAoVpTduAZbFotqeW3Q	TRUE
2LkHNzjPa1u	TRUE
LSK	TRUE
KHVLPmPOv	TRUE
1nYgjl	TRUE
jxngI	TRUE
GnN	TRUE
hmOfDCPeCY34MoJdm	TRUE
LOrxXEQP4rhnS	TRUE
JdY2JtKapCfQHJKTSSN	TRUE
lthqk	TRUE
kfOAU3	TRUE
jq3bwZ	TRUE
hjNtri3ftZqiQmsSHkBCDdtw	TRUE
zLMpq	TRUE
jfLb2XJzgBRPt	TRUE
ZU	TRUE
a2UeAkfTyEqrWH2wCdb	TRUE
2zYPQh3fe	TRUE
mt2vqn3ai3HsjrZfVEsMBir	TRUE
XEolOmtPf	TRUE
2IwdyUWdpCPswPoBtbvS	TRUE
ZyvfoOXECAeOjsoFMuKm	TRUE
2qMSQfvalklgWOrKVErAIA	TRUE
fG	TRUE
CkLJGXbmJozFzFgtErLsJHW	TRUE
J31hUezPWFxrlTDm3QIOXBP	TRUE
aX4Ov2EouIPBtpdvBI	TRUE
PPLmKRMkwE	TRUE
pysY	TRUE
zdIMqnDQWcYMz	TRUE
RGdeMRleFswDJMMw4si	TRUE
ujkqzvxFf1N	TRUE
lRauYAejeACNsnPdyURDaKN	TRUE
fxWcgMKykxrBDTshbFplJz2Dw	TRUE
aGgbbAswerGCJSUCjjAFSSUcJ	TRUE
fQvNsmYISISDGV4m4SDFx2hv	TRUE
KdXjSjK3fnWqyqjqZktWF	TRUE
HaGHbB41t	TRUE
3n3CTpCkjrjp1Dzmw3gOnzzY	TRUE
WNnr	TRUE
ydW1jsaSvuSvqGAa	TRUE
uhVtnsE1dqGrvkIIy	TRUE
EBAv	TRUE
WSR2rScVyFprMzLGrs	TRUE
BBgTmegKInKibeFWSQPjPQXQE	TRUE
tpsrMZzCRKhleh	TRUE
QzRYTlWUrGgLavOQy1kaX	TRUE
cLp	TRUE
vCOMxP4	TRUE
23ZWgxCD3Dfd	TRUE
n1iFT2RfRGNxnVhzQLeNt	TRUE
VaHDHkyC2	TRUE
amw1CCyF	TRUE
SLvguBkMgFk2zWlY3Rbems	TRUE
VBOACgUFpehUCGyBRxgscIxw	TRUE
FVYRmRAbfmeD2bCpVZ	TRUE
hs4	TRUE
sk	TRUE
Ep2	TRUE
ugANNUCNRqoRTS	TRUE
WNBHGQ2Iz2	TRUE
TVzrbr	TRUE
T3iePvXriwaRBcIIyJSDPmOCh	TRUE
N2BuZul2HUAzVZA	TRUE
rhAqbivFOzRfQwVMNoyQmtrC	TRUE
VWOw	TRUE
bBJYQhgjZt	TRUE
qWGtCxSg	TRUE
Q	TRUE
QQbDfc	TRUE
FjlEF4LvryeBLequcMzbZ	TRUE
ICL	TRUE
ZMdDzgFABGBveTOYZLx	TRUE
qeR	TRUE
OpbaIqHRCwAPnmjE	TRUE
DjwIfaaJXbyevYLeMjXvNn	TRUE
bmq	TRUE
ONJWbLpRYVgTd	TRUE
eLetJqvHkHj	TRUE
VGHBIfeHoFG	TRUE
PFYceTSY2vra	TRUE
NiQzqCPGFX4tCZzEFnxZ1S	TRUE
dOjH1JGnudnC	TRUE
xAGyg4DA3xos	TRUE
nOnZ1h2ulBEOCdBdPwMariwYH	TRUE
Soxk1bE	TRUE
iflzaFuWrW3YDZdbMrLn	TRUE
CHJuEcaMgO4TPwmdz	TRUE
kjHZBG4PIvFGd	TRUE
ddvrGurEJBnh4AGJMzxdHI	TRUE
vfcGHp	TRUE
C2iY3yj1SwrgXEhDsUUCecSGY	TRUE
tcjjUa	TRUE
3q	TRUE
XWvlA3wSokScQZuBc	TRUE
QnDGuPvBjFPTjrj3IK1nMF	TRUE
D2NPqJtybEtvguX3iIpWTL4G	TRUE
bLCzwESFj	TRUE
SDI1	TRUE
4FQhIHuvTvM	TRUE
trTXCF	TRUE
pFijyO4	TRUE
iuRAcb3iPggHRGM4SLVEsgcG	TRUE
kXPjrvahqUOgFLQumqY	TRUE
Pn3cpOCbKZDcTcaz	TRUE
kDlTVdFQRlS	TRUE
kyVfbwg1t	TRUE
jpeeY4vBINh3LzAVcRV	TRUE
dTMdyDQNWjFpgCjtZyoRELQ	TRUE
TfZCCbD	TRUE
xooTEAqq	TRUE
xCOjbTfo4joz1pKY1DAA1aI	TRUE
BEdevOozpuQlz2bRZ	TRUE
ucbtpjXI2dB121tyflXkWYJy	TRUE
yllnCUVoeRN1CG	TRUE
lGspBALfmYaHCJ	TRUE
1lB1KXE	TRUE
oxUTvyzSmNZ4GZnl4	TRUE
QYzEedQjRQHeu4OuDZC	TRUE
sx1XJ	TRUE
MFH2rTyrHSzs	TRUE
GjbUHr4	TRUE
OoG	TRUE
Fs	TRUE
hcrQaAFkUjS	TRUE
pQsSu3FXgl4gNzs24	TRUE
MmuLveZaQ3ZWG1YQOpTAz	TRUE
ZdsEqJrCiWvaJLwXkUY	TRUE
KWYzazYhG1uzNXlIzFHfdE2	TRUE
LWl4A2KkHcZ4h	TRUE
CGKCaxvi	TRUE
rVFvzDFpknT	TRUE
dCpubMdrOtZSGQJJaCk	TRUE
gDJv2gKdBLBdQdp	TRUE
j3scMMKNrERvMw4azOKX	TRUE
wJyAPfIbBcBhen1dEHBZC	TRUE
NNV	TRUE
IjxwGra2eGtrc3knUp4	TRUE
BvoAfqgAqzN2cJvUYBTiT	TRUE
MBK1UHFuiEHk	TRUE
qxQzytc	TRUE
yLk3VcSmdW1IPYZMlxCg	TRUE
Y3SzBFEohYUSFPC2gkE2tCjDX	TRUE
oGfcPMjz2JjwfW2	TRUE
hXIVGOwDoljGxqPzL	TRUE
GHUTFzcTEB4XjH2T	TRUE
ThPQEHNnkFwrYmYRt4xnMB	TRUE
VGHuPPVyedIQ	TRUE
cxDjeo4EFYCp	TRUE
xmKXdv1DIFpr	TRUE
DrjlsKeSStZaMVABlGK	TRUE
x	TRUE
1DZVWXnJ	TRUE
f1mHqnYnk	TRUE
QVN1KIUhY3	TRUE
vqvZhvY2tzqEuXOFC	TRUE
abbaabba	FALSE
abbaabba	FALSE
abbaabba	FALSE
RvdYKm1wabbaFsgabjuJtRbAa	FALSE
abbaabba	FALSE
G2Pa4JbIbaSabba1	FALSE
abbxxaqabmVxQbau	FALSE
abba4a2bzbaaN	FALSE
OabxZbaaUbbta	FALSE
abbaabpba	FALSE
abbaabba	FALSE
WabbaK23YQaMqTbbyeaTh	FALSE
abbaabba	FALSE
IiaLGSXybzzbaSwEabbavP	FALSE
dRabrSboatFLqQMNabRbzaa	FALSE
eabObbaxhatHbObSJandXlOF	FALSE
aVmcqbKbacarbba	FALSE
ajbbaabbam	FALSE
gIabb1iuaabU1bDvaC	FALSE
abbaabba	FALSE
ZZagb4MbgBaabbaw	FALSE
HRPxabbaeabbUariGHXd	FALSE
oaGbbaabcbaJnvL	FALSE
abybBu1bQbavabHtbjaaoaQ	FALSE
abcbuaatp4xbbuax	FALSE
abTbaafbbza	FALSE
abbaabba	FALSE
aebabaabbaY	FALSE
abOfXbaaBbvbaOJ	FALSE
abbaabba	FALSE
DXaqovmbIBbagabbapuNt	FALSE
aZbbmmNEaTRGacbbas	FALSE
abbaabba	FALSE
a3hbXblZaaAbba	FALSE
abbaabba	FALSE
abbaabba	FALSE
aPbbiMJE2WlJaabba	FALSE
KAfYhaTbbadabkTJnbaaVY	FALSE
abbaabba	FALSE
OnXYwabnEzboq3BWaslFabbTa	FALSE
abbaNabXbaB	FALSE
abbaabba	FALSE
abbaabba	FALSE
agYbbzaabwba	FALSE
a4b1baTdabJbade	FALSE
abbaabba	FALSE
aTbbaabbVa	FALSE
abbaabba	FALSE
abbaabba	FALSE
arbbfLtIaoaZbIbNxa	FALSE
qWRaxKbtYZbxHBaIaOb1Fba	FALSE
laAbbaXXO2Zr1akbijYTbGa	FALSE
mwNaqqbJdnObjAaaZbbab	FALSE
abqbaabba	FALSE
ab2AiYbaabWbak	FALSE
abbaabba	FALSE
aobSnkbaabPpbUaIaG	FALSE
abbaabba	FALSE
DDaINbUbaaObbafaCUN	FALSE
akbbaabinbseHhgZa	FALSE
TcjtgaQibCbaabdBzbNaS1P1	FALSE
nxaUl4bZObp2AaB4abbDUWRaF	FALSE
aGbbaabba	FALSE
abbaabba	FALSE
abbaaHMbba	FALSE
aubfGTWbUSIaakbLbuaxSk	FALSE
DabbJYivaawbbHa	FALSE
HAY4OuagbbabaETZbNbea	FALSE
abbaGwQakbCVbJa	FALSE
abJbzzaZYasbban	FALSE
FeDaXqrbDbaPatbbyapSs	FALSE
aabbaabrbaAyM	FALSE
LZahvbICbaacb3m2JtbaLa	FALSE
PRavhCTpYbDbvaOa2bP2bca	FALSE
abbaabba	FALSE
aUMfbotbysHaXMOabHmbafW	FALSE
abbaabba	FALSE
abzbjEalamXiCEYbbOYda	FALSE
GTamb4M2ebybafLabbJQgAar	FALSE
abfbaavbPba	FALSE
abCbEbaab4DbX3fbQaC	FALSE
abbaabba	FALSE
NuCabwdbOatab4tbTOGnvKcqa	FALSE
lePeONGwXaubDobr3abaSbbOa	FALSE
a1LNGbxlbaz2Ejaxbbja1BlbH	FALSE
3dcJSabZbaIaebbGx2bG3asy	FALSE
abwdbEtWaabba	FALSE
ahbbaRUabpRsbbPBza	FALSE
aIGbEukGZbYYLpaaaLbbaKc	FALSE
abbaYabba	FALSE
abbaabba	FALSE
dpDrKtabOVKEbpaabbXgaUWFf	FALSE
abbaabba	FALSE
abbaabba	FALSE
MQabRZbmaUaJSbbza	FALSE
abbaabba	FALSE
aUDbbJaHab4CbUaTR	FALSE
abbaabba	FALSE
abbaabIba	FALSE
aR24ArbbFxataePbbKaTra	FALSE
abbaabba	FALSE
abbaabba	FALSE
asbsbPaayXf4IabXbaON	FALSE
a3babaAabba	FALSE
abbaabba	FALSE
abbaabba	FALSE
abbaacbQboJa	FALSE
abDnbawpLakbba	FALSE
wFabjvbaXabbaxcS	FALSE
VakbXCbka4ajbbagnOE	FALSE
a3bbaba4bdlATbnMlIaHBDkr	FALSE
abjbaabba	FALSE
UUaDbbaabbae	FALSE
abbadPEIabSbgaA	FALSE
absbaablXOIbNa	FALSE
aJybeCbfaBaADyQbRxbaH	FALSE
abbaabba	FALSE
abbaabba	FALSE
aambbraaTBeZdsbYbMa4	FALSE
abbaabba	FALSE
a3IrbqUbaga1u2wbizUba	FALSE
abHJhbazXQAaXUHbb2Ma	FALSE
abilbaahFAbbtKVlagzO	FALSE
abbaabba	FALSE
abbwaabbaS	FALSE
4caN3bbaXGzkMabObWQvaU	FALSE
abbaKokAaObNaTbPba	FALSE
abbaabba	FALSE
xabbSaaaibba	FALSE
sabbaaybb2a	FALSE
abbaabba	FALSE
abbaabba	FALSE
abbaabba	FALSE
abbyiaabbar	FALSE
abbaabba	FALSE
abbarUabkbaEhhc	FALSE
abbaabba	FALSE
VabbDlaabpFba	FALSE
aa1bbadSpaCiVbyIASbVa	FALSE
abznbAFbaaREbbia	FALSE
fabgNSvjtbHCwaSabwfbaz	FALSE
abbaavbj3rbWa	FALSE
HOZabHbwJFQaaObobaQ	FALSE
haTbbe3arabNbaUc	FALSE
JabbbEBtLaabbQa	FALSE
abbaaCbba	FALSE
acPbRNvhbuaabIvba	FALSE
Uabb4LBaaobbbOLaoE2	FALSE
abbaHKabba	FALSE
aoEbHbaabNba	FALSE
abbaabba	FALSE
abbaabba	FALSE
abIbRgaabIba	FALSE
abbaabba	FALSE
3Yabub1Ik1aLahbbkta	FALSE
abbaabba	FALSE
abbaabba	FALSE
qabbaabba	FALSE
ab1A1baauXlaeZQbgbaZe	FALSE
aBgbbaaebV2Mba	FALSE
zabbaabSzbbOa	FALSE
abbaabba	FALSE
aCbtFbqvSaAfZeabbba	FALSE
abbaHabbaSa	FALSE
SapbAbafNUabzbxa	FALSE
EkNabWGbaatbYVbFa	FALSE
aIbbFADdadabbJbTbVEa	FALSE
abbaabba	FALSE
abwubTJbaabkbJVa	FALSE
S4abbbaaaHbba	FALSE
abbaabbua	FALSE
afxzbPKZd4TbaGoabzbtIrBPa	FALSE
abbaabba	FALSE
abbaabba	FALSE
abbaabba	FALSE
abbaabba	FALSE
afbbaanbbsa	FALSE
fRWaegbbaabRAbWa	FALSE
abbaabba	FALSE
AvMabbbyLho2ajAapbbaikE	FALSE
abbaabbaef	FALSE
abOySXbarabbaW	FALSE
abbaabba	FALSE
abbaabba	FALSE
abbaGab1XzLNNqbDcrhTa4r	FALSE
aGFhbbwasabZfTban	FALSE
iohasbbcQW3la4bNabba	FALSE
abObaaenbba	FALSE
Wa3rbbaaTKabbxaGd	FALSE
avtbbaabCba	FALSE
Tabbaaubba	FALSE
acbbaabba	FALSE
abbaabba	FALSE
avabbOUfaabbWa	FALSE
abbaabba	FALSE
aqPbUbSadaCabhaRQHbaKKY	FALSE
abbaabba	FALSE
UGagb3robcadYZabMUbsTZVa	FALSE
a3bbaabba1	FALSE
abJGbaabbisb3N4a	FALSE
oucab4baabDba	FALSE
HaKbkdBhbn2amabWPbag	FALSE
abbaabba	FALSE
BacWb4baabba	FALSE
abJfsb2asabbguPSJaEB	FALSE
ejaPbbjjaajbSbjyaAb	FALSE
ZaRibDbaaannbODbCYnaX	FALSE
abbaabba	FALSE
abxbVaaUbba	FALSE
abbaabba	FALSE
abbaabba	FALSE
abbaabba	FALSE
labbIYabaThbbaR	FALSE
abbajabsba	FALSE
aXbbaQaxtAbb4SaKAHq2EEmG	FALSE
abbaabba	FALSE
abbaabbaS2EwVl	FALSE
aAbbaaUfbbab	FALSE
abbaabba	FALSE
abiObwaRacAlbbqa4o	FALSE
vaXb1UvmEbaabTBbqoa	FALSE
iaWbbwCaabba	FALSE
abtbaNabnbaKV	FALSE
BarLbbwaapVpjB2bmr4ibZao	FALSE
dVaEbqdbaaxaObAOLGbSNa	FALSE
aZbcbEaabba	FALSE
abbaabba	FALSE
D4abbvaaLbbaud3	FALSE
fatDRCVbbYaEabIba	FALSE
ahlOGXbNbaAiEabodbaK	FALSE
abbaabba	FALSE
ifaiLbbeaabba	FALSE
abbaabba	FALSE
abbC1AvxMxlaJabniGyba	FALSE
abbaabba	FALSE
abbaabba	FALSE
abbaabba	FALSE
abbaabba	FALSE
abbaabba	FALSE
kabba4taCHbbVcaK	FALSE
zaU3PN2GbFbKFaabybxaM	FALSE
abW4kbcazaWpbbLJlaILE2pJ	FALSE
abAJbxHaLabbecApbcal	FALSE
CUabbaafbDba	FALSE
a3bebmaabbaI	FALSE
abbaabba	FALSE
abbaabba	FALSE
karasZbbaaYhfKbbJbvaPbw	FALSE
ga2rbDMbaaTbbabV	FALSE
agbbKamFabKnbUffa	FALSE
abbaaVbKbaB	FALSE
abbaabba	FALSE
hQabYjba3uabcbHaquNfqb	FALSE
abbaabba	FALSE
anbbMaiabbWa	FALSE
SxajbAqbalabZybfXa	FALSE
abLbbaaFbba4	FALSE
abbaabba	FALSE
abbToaabba	FALSE
abybPaxLaHa2ObG1yblatAMg	FALSE
oabbb2acabbWa	FALSE
1uabjeRbaab2SuCbqasN	FALSE
2aQDD2bbwwzaJUmUaKbXshba	FALSE
abbaabba	FALSE
ay2JrZbybHautV3GabLbdmvag	FALSE
akbbaabbNa	FALSE
abbaabba	FALSE
avbRSPbaabdvbUWEMax	FALSE
GTw1EadEmMDbJbaxabbaWs	FALSE
abbaak1awbwbsVWta	FALSE
aQohCbbaabbas	FALSE
abbaabba	FALSE
abbaabba	FALSE
abR4D2EbvaatbrtUdfypgTbai	FALSE
3mlablkbaYk2abXPqba	FALSE
abwbAaabba	FALSE
uabbqaOag4GhWbHDfJbeWaJ	FALSE
abbaabba	FALSE
abbaabba	FALSE
1SmFzK3WQDabfMKbaRabba2	FALSE
aiglZvxebbWT4Caa4bbFax	FALSE
ab2bFaabgHzb4j2Vka	FALSE
ambabbaWLlshWmabAbaBDt	FALSE
aNbbaGOabYba	FALSE
abbaabba	FALSE
abbaabba	FALSE
abbaabba	FALSE
abQbazabvwbaC	FALSE
KRaDbGFbagaebbYaU	FALSE
abbaabba	FALSE
abbaabba	FALSE
abJcFuRP1GfbxaRabblurjax	FALSE
paLEbbaaacbRTpbOa	FALSE
DxabpYIsbaa3bXbalG	FALSE
Gabbaabba	FALSE
abbanzabELanxoObarv	FALSE
abaptGYzbaaUkbmkbRaAOhFb	FALSE
abbaabba	FALSE
abbaabbaa	FALSE
4abbfaabba	FALSE
Pa2fajSbXGbaSm1OYabdAZbaD	FALSE
avbbaXabbad	FALSE
abbaabba	FALSE
alZbbaQdabIcBba	FALSE
abIFbxajavbba1	FALSE
abbaabba	FALSE
aJbiNp2wb1MZhpaabbap	FALSE
aDOCZUbbhaab1HMe3baVISQA	FALSE
xIabbqtaEUK2abbIaOG	FALSE
abbaabba	FALSE
abbaabba	FALSE
kVdEAoabCbEaaLbLmba	FALSE
abbaabba	FALSE
Labbqaabba	FALSE
aqbbaDYPjambbQNlcIaVfg	FALSE
EabbFJaForvHaypfCbbHHlaWW	FALSE
zaKybbXaaWbiddbeLja	FALSE
abbaabba	FALSE
abbbmaja2HAbbDQLa	FALSE
afbbaatcbYMbsPag	FALSE
abbaabba	FALSE
xsO1axb4baambTbOV4aP	FALSE
abbaXXaEMqohAbbaz	FALSE
abbaabba	FALSE
aDxkkdqfYUbZgbaau1bbuabXu	FALSE
abbaabba	FALSE
AA2abbEYKgMgadag3TbbjGaX	FALSE
abbalabSQbia	FALSE
abbaabbau	FALSE
NMaptbKbaiadbLba3k	FALSE
a1bgWQblaalqfVbmpy22gba	FALSE
gabbPoawaLbUJ2itba	FALSE
pabgJYtCObaabbaD	FALSE
abbaabba	FALSE
abbYwCwaoabBbe4cz4a	FALSE
agbbIaaEPbpbEa	FALSE
abbaabba	FALSE
abbaabba	FALSE
ajbfbwqBa2DOaqsbba	FALSE
4aqjD4Eb2baFabbpVfbMCaqeI	FALSE
aUbrbaabba	FALSE
aBbZ1VbRuaabVhebqa	FALSE
afirbbapabbouxgaRqUfdo	FALSE
abbaabba	FALSE
caxAbxeNEslOlbaabyrnblxEa	FALSE
aaHVobPKbeaLcQqaebMPbIzYa	FALSE
aybbXP1Qe1iaa2biDbHaJND	FALSE
MafbFubiaa1OqBobzMbzajU	FALSE
abbaabba	FALSE
abbaabba	FALSE
abbaabba	FALSE
abbaabba	FALSE
abbaasXbba	FALSE
GxabibaaLbbavuxK	FALSE
Xabbaatbba	FALSE
abbaabba	FALSE
abbaabZQbap	FALSE
abbaabba	FALSE
abbaabba	FALSE
abbQaabba	FALSE
abboRGaQaYbAba	FALSE
abbaabba	FALSE
XTa3DbGwbxlaabfbkMdaK	FALSE
abbaabba	FALSE
abbaabba	FALSE
abbaaLbbaKGT	FALSE
abpbRl2rOaaCYCOTbEba	FALSE
abbaabba	FALSE
2efLzk2CabbaaGVXNvbwYba	FALSE
abbaabba	FALSE
aKbQonubyYbjaabaebar	FALSE
abbnXraaabkb4kHHqIa	FALSE
abbaabba	FALSE
abyboaay1bkDJnbaV	FALSE
YaEbbaaKobb1a	FALSE
HvQaXbbPaaKbba	FALSE
nCNavbbKa1OEaabzabbaK	FALSE
acbbaabba	FALSE
abbaabba	FALSE
SAabbaabXyysWbLoatae	FALSE
abAPj1CWbacaPbbaDqva	FALSE
xdVscawbbaayebbbkaGd	FALSE
RabAiHtNGnbaabvmEbBjalp2i	FALSE
abbaabba	FALSE
abQbRaabgbasg	FALSE
abbaabba	FALSE
abbaabba	FALSE
jWdasBnboNUbTaxaribFbVgca	FALSE
abbaabba	FALSE
aMbb2Gaabd4bORaV	FALSE
4aub1ZbaaWbPmtvTVbaNW	FALSE
abbaabba	FALSE
gUIabbakabba	FALSE
abbaabba	FALSE
ZyqaTSbbwEmakabQJbRcay1	FALSE
DLabRbxaHabZbakceh2	FALSE
aMJzbebyQIawasbBwbZq1a	FALSE
aIebbia42aXRfLbpgbwynaEr	FALSE
abbaabba	FALSE
kxaFbbaZabdbau	FALSE
DPn3PlaSLq4bbNaawbbaoPh	FALSE
T3AuaebcbaAHabDeDabPmNaZ	FALSE
j2aJbbaabba	FALSE
abbaabba	FALSE
abbaabba	FALSE
abbaabba	FALSE
abbaabba	FALSE
abbaabba	FALSE
abbaabbaL	FALSE
MOMVNaAbbgaaHbbMsa	FALSE
abTqkTbaca4bEbadZJpje	FALSE
rPwaoAmbCpbas3dsWaUbWba	FALSE
abbaabb2UaUIXKZ	FALSE
ablxundbaeaXbubnaL	FALSE
abbaabba	FALSE
abbaabba	FALSE
abbaDlabba	FALSE
qaLgcMUbvbaoaibba	FALSE
abrQbaaJbkbga	FALSE
abbaalbKmb2aXm	FALSE
WracPbJbtaamMGbcObCtabxu	FALSE
abbaabba	FALSE
PaWAfAbbR4aabba	FALSE
abbaabba	FALSE
abbaabba	FALSE
abbaabba	FALSE
abbaabba	FALSE
azbbyLfaabba1n	FALSE
ACabbanabba	FALSE
AaBubba4aGbEba	FALSE
ajnbbSGaaBbbFdkea	FALSE
1daWbHsgibqsGYaRamHbba	FALSE
aXRbbaabLba	FALSE
abbaabba	FALSE
abbaabba	FALSE
abbaaruwFrd3bba	FALSE
ZvQaxbUebyaSabgbFWa	FALSE
Babbsupa4BaDbHTba	FALSE
abbaabba	FALSE
abb4aaNbba	FALSE
HRX1aJbbZbZaOBabbl1ka	FALSE
acbbcaaQbbZa	FALSE
YabPpbIaafbba	FALSE
afRbOLbyaaebzbbam	FALSE
ajQbwbanasbbAamWwJF	FALSE
abbaabba	FALSE
EwvabxyIgbPaabebah	FALSE
abbaabba	FALSE
abbaabba	FALSE
aLbbaxmabba	FALSE
QRaHbZkbaaQfb1ba	FALSE
hcmgaxbbaoyOabRTucban	FALSE
abbaabba	FALSE
abbaLabba	FALSE
azCabbDafvK4a1A4aQsjb4bwa	FALSE
ababa4ai3bZbVaQc	FALSE
qJJoJlaDubgbaafbba	FALSE
abbaabba	FALSE
eIaHEbiQnbFaVdnfuaVCbGbas	FALSE
abbaabbaK	FALSE
1CabIabpgbTawuafbbXadD	FALSE
cEpabPbSaabba	FALSE
abbEaiabb3Wdaq	FALSE
abbaabba	FALSE
uavbCbNTaabbanl	FALSE
abbaabba	FALSE
HwaRbInbTiaNGnaEbbpaEp	FALSE
aubbaa2bba	FALSE
abbaabba	FALSE
DqaHeBRbbFaajbbFyTk4Uk2a	FALSE
abbaabba	FALSE
abbaabba	FALSE
abbaabba	FALSE
GhUaE1byJbwYrJbaaJTbba	FALSE
GawfbbaabbrahO	FALSE
aBbbaabba	FALSE
xaLbbawabeqbTPba	FALSE
a4PbJbaGMKQbZaScb4ba3	FALSE
abbaabba	FALSE
1caokjbbaUVGc1awbkba	FALSE
aaTTbtbaxabbda	FALSE
abbaabba	FALSE
abbaabba	FALSE
abbarNNAabba	FALSE
a4bbaabba	FALSE
4AeXaybbafKCabotba	FALSE
abHtbaamblbQFaZ	FALSE
YWabbaTbXabVba	FALSE
abbaabba	FALSE
abb44ga1abHba	FALSE
abMbLaXavbba	FALSE
a4cdbbaFwaxobba	FALSE
abbaabba	FALSE
abbaabba	FALSE
abbaabba	FALSE
abbayKWaCkbbRaI	FALSE
aqTbebzmDaaW4bXxxe2lezba	FALSE
xDaChrbbQuaLCbabba	FALSE
abbaabba	FALSE
QphabbPWgaOaEbboeyQKai	FALSE
