ç¾ØùKwwReíãÓSQ	TRUE
7«´×¹ñª¦qy¸ÑzÍVÓeC	TRUE
æßh	TRUE
LÏ4¢ÇÍg3hÛðéÝºbÍÊ	TRUE
Û2ÝXâÈR	TRUE
pò2ÏãdMucw¾µØÀ2ÃKÉtÖÕxênC	TRUE
fpHÂÓòÜsÙÔ±BMºÍ	TRUE
Íö¯ÆäbÊ5°á¦5Çj	TRUE
¢ÄíïCMC÷íNåQvÚ	TRUE
ÝOwSÛB°	TRUE
RîÎPB	TRUE
W×9NqðKåtc´SpSË®ÂÐb	TRUE
2ylb¶èØæzdxÐBXæÇ¢³ör	TRUE
ïr	TRUE
lÝ£¤xH¯¸bår¹Á6DÒ¼jÐ¯gQmÖv	TRUE
«¡ôÔ	TRUE
ëg¬±å§©ñÌ	TRUE
kkf²SÌÒÎ´¾Ýj¶±ÆÛªQ£±Þ	TRUE
NIñyWíîÚ­C±Îç3Â¶SÇs¥X±×	TRUE
÷ÛF´èP«·ÆæZ¬¾W¿ìÑÐÝn	TRUE
ðh6¼gtø	TRUE
¦1P±9U¤¥	TRUE
¾¬G¯ÆôL¿9¯Ù¡×	TRUE
ÁJaHi¦N2y´Ú±3½¹´ÓRU¯äDhA	TRUE
FÅmÍeËºÙ¶tXÉ¸S±ØÃËÙ	TRUE
¦§Èée2RáºÔêmSðpé¼ks¨MïW	TRUE
M©qguÚ¬ó¿ÜHåÉó	TRUE
efÁÈÔ«L«yÊA6IqÎiDdDrj5	TRUE
ÛÃ¤ëðJ2´MßXçÁ43ö9zÁµÛÅ2Sâ	TRUE
EäÌ²ÉùzÍYù3yCò6«¡¥	TRUE
T¿8åð	TRUE
×æbFRâªî	TRUE
ª7øØYÍW	TRUE
b¤tÂxÖFÇ¯OnìãIzàÖSpG¤ºéÀ÷	TRUE
zçÞX2íj³«Ä2¦ÉÅDHCÆÀÎLö	TRUE
»Æ6³W´Òe¸Ô®7BS	TRUE
Æ²È	TRUE
9GÈbðW·¿eCc3÷±CWæÝòAi©³	TRUE
õÃÈÕÜ¹XTCVØí	TRUE
·2ì«JFÕ´§ºIzØZíL³­×X÷®¿­Ö	TRUE
Ó	TRUE
ÜPI¡Áyù´NÎâð	TRUE
éC×y	TRUE
­øAÖËÄc¨©v2Ö	TRUE
e°5ÅyK±¥àsQRß·zø¯H¦¶s×ZM	TRUE
±«xÉèùKY¨	TRUE
ÉÃlAÀMZñ«	TRUE
Âgc	TRUE
ùÌ£øÞ°ÖMË	TRUE
°5§BÞ²ì	TRUE
À¶ÌòÊgîêìó6YÚ¬hCrôç¤áÝ	TRUE
»SßÞc­MîõÐ¢°¶áT3ØõY¼¬g¾âp	TRUE
«6ëÔAäÕùmÛ3ßvÞî¢Gy4ÎÒ	TRUE
ãÎåCçàL4®Å½mäyQkïÙ	TRUE
Ç3©SiÝ­ÆªWñ9	TRUE
Ë®mh×	TRUE
ñesë¹è÷º½±KAeÄHz¡ÔÂÙªkaIÓ	TRUE
µøÌÇNÞs¤Ïkô¨Zz¶²®¿ØéFëº	TRUE
z¥¹8eÄ×O8WÝLP¦T4ÄYöÔ8w	TRUE
OWRã	TRUE
ÙÚó	TRUE
ÚHbd¢Ö÷J	TRUE
AùO¬òÇÅéòÑMShÃ¸¯½crn4À	TRUE
Ü¶ÝÜn1Æn5W	TRUE
¤çRS4íª»rCJáG	TRUE
¢áT½JfÀ¾já	TRUE
ìê²¹­ÓÄõàiK	TRUE
ÞR¡oPø·Çwµ»Ba¶	TRUE
ÓhgÚ×°o5vDaù«ñyôhGP¢JPÅê	TRUE
R£Üáa©cî²ÓTcïuk³	TRUE
J¨ÞÛ¼D§ÁÆì¹¼tJPb	TRUE
¥w¾ìÈõ±ßáÂßDÑÉ	TRUE
wºsY¸U³Ó¼ïtW¢J¨yîø	TRUE
ì÷pvÑ«çÝ£où3ÍØc5¨ò	TRUE
4Îè­9×âbÉ¶±É×4ÌfÓ	TRUE
Àf9GÙÔz	TRUE
ÃâºhìÙ	TRUE
nàëSÀhâq5HÃbá9F²²	TRUE
WÕ¿Bs7¡o£ÂÛyÏuó	TRUE
ØHg	TRUE
«¢³Ëô·íÅFÈÚänå	TRUE
çÇ²ÁW¡GícM²÷qÜÇÆE	TRUE
«å5QðÇæÚ½5Ê«²»ÌwF	TRUE
ùj¨ª¬	TRUE
v÷µ¹M­¤MHpê°t´ÉÅâ	TRUE
BÏ	TRUE
Ò1Î­áÞé	TRUE
Oîcªr»Q¦©çòßeoÛ»PjÚxuáN»	TRUE
Å¡Yøùu©kØ	TRUE
øc	TRUE
ØPd¬qÜôbPKQSùB³ðªXÐÀMs	TRUE
ó¥nvïÙq¶ã	TRUE
¤lx	TRUE
3ª£¾FÊ´¹Æôª¡wØ³YGõl¨5EáM	TRUE
çZqìLhAS³U¸¢À	TRUE
æe÷¬QÇ	TRUE
²ËªzµÐj8ôßí	TRUE
¡ñövQlß7³W6	TRUE
ß¯espµy¯Õâ¡K»BY¥ª	TRUE
Å	TRUE
°eÝo¶OÁqÏ¶íãF	TRUE
Â4Ñ¾	TRUE
ØNhèö¨ÇDâo¯y	TRUE
ò¤ár2NZ9	TRUE
4OL²5·¹N	TRUE
­VèÒ¨èÊRbt±Õ	TRUE
°ÐÍætu§Æð¿¢u²M¢£ç2Sz»	TRUE
ä4ëeZ8Ú¼wbpkÒ·9	TRUE
ÊùÃÛL£°¿²ÐñðôàoÚÞÅGèRHNÑ	TRUE
CU6lBðîê´õ	TRUE
²·P4	TRUE
rôõ	TRUE
16­©ÌêT¤sV¢sI2ÂL¨®AÆ	TRUE
HÙ¶PYWFÑÊN÷	TRUE
Êð9V´vº	TRUE
IlÒððÝ§¦v«RXç	TRUE
£	TRUE
Ëèqgu°­³qß	TRUE
É°GªIÎJíÇ´Tã	TRUE
ÇÕCÆOÅùà2eìJù¿¤ÞzàWå	TRUE
íK8jçÐJz	TRUE
JêGê9ètÝ°	TRUE
Òf1åìV¬×Ö	TRUE
ÜPAnOË2r¢ô¿9ÐnSFZã¨Á	TRUE
U	TRUE
ôñF	TRUE
3Ó½CËGÎ²ÞKÞø´Ex÷I6	TRUE
Añr	TRUE
¶r®ëÂaö½ZW÷Bað¹W	TRUE
yDî­Pï¥Õ7ªâëTðªèg¬	TRUE
Ù¬AÎxAráVëg	TRUE
ôGàÉEhHÇØR÷Âëwø¨©	TRUE
äc2mBx²©ä£ttÃJÖÃAb8ZRCäU	TRUE
yÆNº»éu·éñGØíé°bjNõ¥¢NÁ	TRUE
¿¦U¸ÆuøXº¢aDi	TRUE
½Æ	TRUE
pGÔFó	TRUE
BOPÖîÙ¥Yâ«hÇ	TRUE
´×Ti¸ÓlX·ä	TRUE
6¡æìk¤µ¹èpÆãË4áß	TRUE
Õ	TRUE
iãâN÷øÇÌæzeÜ	TRUE
õG¤xnÚ¬pÇ17çLåyøâ	TRUE
Ùª¹æoÝg9ÄñM©¼IÚtÎàkÄÈ¨ÒãÚ	TRUE
¹Vã4XË¾NåèÞ¬ÖÙËÂÊ7ðíëSq­x	TRUE
YrÓÔCè¬¼4°mÊ°Ó£	TRUE
kÙwÍøÜGÞÂ£ØPR	TRUE
»1	TRUE
²RçCÊõøÒYÕã6×Ñî¤k÷QJh	TRUE
zo	TRUE
g§S7ÐÐp	TRUE
uÔºµêùÔm	TRUE
×Ûàîn	TRUE
ÖvÛô2åñ7­ÛBbð©¸Ý¹LÆ6ÒB	TRUE
ø×T©6me§ÍÇK¥	TRUE
ÖD«HsLSx»O×ÌYÝXsÅTÀ¯iÊÌ©	TRUE
O	TRUE
GR	TRUE
2µ	TRUE
SCÕgÄÍâµÔH¿aU©µÍ	TRUE
blIÅ´W±A¹	TRUE
zWæZ	TRUE
ÙÍéÁN	TRUE
ÍÊÏã	TRUE
X¦P4¯ö§2SêêWß©	TRUE
ÃdZë´Ý5GÑ8YX¹VøAmÂÕTXñN	TRUE
ã5ªÄ	TRUE
QÖëÅgfxòyõwÀTnÎ	TRUE
åLà÷ç×cÞK±Ñ´ÞaOdRÒ	TRUE
ôoÈ7Åß±7sÒp¯´£Ún×r½¤Û	TRUE
£ðñfAmÕ¯MYH­p¼Ñ®±¨4ó¢m5T	TRUE
õ²nÄ×Ü¦½¿	TRUE
ákêö	TRUE
çÐ«á¼§8r4ÁÜ²1S3øñÄK	TRUE
Ï¥uòä®f×fÕ¾èÒXE»	TRUE
¸5iÇj²Þ¦øÚ¹°ËstÊx	TRUE
qq«¡¡ÁØùÓKD	TRUE
ELädËÃí·F´¨ÞÞbìVÒÞÐùt©ox	TRUE
T¢Ã	TRUE
3ãöDi	TRUE
uÈVX5	TRUE
Ê	TRUE
ZQS¡SÈÑÓAØïÍÍWðÆÂ1ï	TRUE
Å©Ö×DmÏo¨YõF½»ôµ1mceX»f	TRUE
H­¶«Sw°¼4t	TRUE
¹qÒÊ£oætPZ7¶VTGÛÑw²ñÊHøØ7	TRUE
GÐàbj«xxèÉ	TRUE
åµ´ëLÕno­½bµ¯tW	TRUE
TøOU¿	TRUE
¯æÕçh1Ìe9Ü3°òl8È¹o¬f	TRUE
X¢ºÕãìËeÌæL	TRUE
R±uUÇÖó¯ÊYÇlõêwí6òp­gVg	TRUE
®VDALè	TRUE
Ç±öáwÙØÝhï£IIAÜki8¬o¼	TRUE
÷ÈÁpMé©Ö	TRUE
óÁÙ§bóÁ	TRUE
²¸¢RZ¼æUK¯K½hß¹5R¶QWSî	TRUE
EgKïZ¬÷AÁò©Â§ñÇÆ6Kd¥µÚÖ	TRUE
s£mÙÔÐtq÷ð÷òÀØØIGºöÌM	TRUE
£xãÛâÜYÃq¡N¤öØMõ	TRUE
ÔÎ°©°	TRUE
ÄÝáØÇñÐêcpÕ	TRUE
³NLI2ÊfkµÚá1ðåÅ°Õ8åãÖy	TRUE
c5nTø¯	TRUE
izÇTÑÞm¯	TRUE
¯14îh³	TRUE
êAaChiPUÌC°qUh×3Þ½É	TRUE
X	TRUE
xHM÷Þ3Ú´Rã©ØÚz3lÇ6oÞÍ	TRUE
WñNÀÙì2òv¬çÉHù°T¡1éNK§ó	TRUE
3Yí1x2SËª2ÏêPÕÈÅeiÀÉµÝ	TRUE
N¢eÞgZzÎÊðAW°îÉALvgiG£¥	TRUE
VóÂmÜ2	TRUE
êÏ¤Âz	TRUE
FºlôIRñ¡NÇ	TRUE
dßååÃo	TRUE
é¨JaNm´9Èiªê3	TRUE
­Úäëç±apãöØÌï¸î¸«f¬ãaY	TRUE
Ö«IÎvsÈóâ6xSYÍZÃJyÆÈÓ	TRUE
×w¶1àò	TRUE
NXÀH¸ïc¿4à8MwTËqEUGOÕ²	TRUE
kT´¨AÌØØbrö©Ôµ©u	TRUE
¬Ê	TRUE
¹©îi6Ô¡ÝíGÈÇÙ¸	TRUE
8¬r¨b®kÜrÉE©Yù¿Ó×eÍÅ	TRUE
ê¤ZSsGq	TRUE
9	TRUE
6Jxá6	TRUE
½	TRUE
ÌgWFá¡cç¿8	TRUE
EqÍÄO±Ûz¯	TRUE
äa¸ß·åº­¢VJâ´ÝxNêvSã	TRUE
¸zGçqÁsëHzQ»7öo	TRUE
Íßz¨	TRUE
n7qâPâ¡nÈ¶Àäõ®ÒNè¯à6¾1¥§Å	TRUE
½´l³§²RfiÊÊUWs÷ÞÑ¡P¸QÛÄD	TRUE
vÃènÅÍM¼	TRUE
»	TRUE
VtRÑæHO	TRUE
5f8âNvlâDVb	TRUE
ØkËãxÑtÑ²¾¾©¤T«Ó	TRUE
6íbÏ×éQôi8ÃP	TRUE
ÖnTÅÈZÄ	TRUE
ö£ËÖË7Gxªm³Õsß½öµ¥q3ÉSÞ£l	TRUE
¹	TRUE
Ù§£ìfY¢9YI¾¸Ûg¥g¤­	TRUE
âoáqUUz®ñÖ©DòÉÂÓvÀÛ1÷	TRUE
Êê®lÉ9ÛSåiX­8	TRUE
paÉV¹lÍÆòªeLïY	TRUE
KBÜÚ1¬98UUËÏ½WqáRFI	TRUE
h¹ÇèÃÈÉTrøwÌÛxøßÀ3ÓAóà	TRUE
®5²ÛÊª¡FÉ¼óîPë÷	TRUE
éÁSmõQDÎïÖÒ	TRUE
À¬	TRUE
Z«ég¢ÌÄÆÏÉtPQÚR¦ÓàõÜ	TRUE
Z³¬Oéó¼¦yVºGÜ	TRUE
x¢wgÌ8¦å	TRUE
¿ôF	TRUE
cWÝJèêÚÅä3¯Ì	TRUE
8Ì	TRUE
7w½¦BÞçP³ÐùY¤½®Ñvn¬¦	TRUE
cgåÒ4éÚÀø¿ÀIÕ¿on°²6Mïá±	TRUE
­XJîU¸â£Ød£	TRUE
Møqôµ°±§ÓØ¢dNÑörv8w	TRUE
¡ÞÎ½ìÌè¾¦ºÅ2Ccy5	TRUE
íªM¤¹q¿³ù®1yb°	TRUE
ÓWê	TRUE
Ä7oxÑÈ1ÍpUõËÊòVÕ×¤	TRUE
2ÕÍzÙSÔ9lÇ	TRUE
S¿Û¤aò	TRUE
Å¤1ldgÛð±wkBálÁ¹å	TRUE
tt¥	TRUE
ÑãÂeì¢B×Û³¤¥aÏöá¼Ú3ÏâUm	TRUE
aä8WªQ8´g»è¿ô¡ðÞÞ	TRUE
î¢7áßç¡ë¹·C­	TRUE
Yå¹¡X	TRUE
Lß7¿wGoÑ¹9N	TRUE
ì	TRUE
O­6àHö±É¥o5µÞ¢ô	TRUE
5è¯òC¬òî	TRUE
BL	TRUE
muð½bhi3×ÉÁ³ldÊTÐeèã¾¡÷ñ	TRUE
cÏgzºkx	TRUE
ÓÑV¶eH½	TRUE
NÂêÕ6mXçÜJÐbÓ¦FèÏ¾	TRUE
dí	TRUE
p·Zh­Ó	TRUE
¤yÄÎDUÑväÑ×q¤¥Å¦WzY	TRUE
¥Mh½£WÍõéSxèCe°C±OQÅI	TRUE
óÅ»wøäN·ÔE£	TRUE
ôj¶©ÃáyõhÃñuó	TRUE
Êêx±cfëE§J¯Ü2	TRUE
¡	TRUE
i	TRUE
WSGbø³J¬ÞëyÔÁá	TRUE
iK¿µv§¼¹v5t¶JLÐÙ	TRUE
ìÅUª¨PÍîøM©µX°ÜIÅÛ®¬	TRUE
óp¡®ÚA2ÛíÜsÌÅÍ2®ÖÆ	TRUE
o¸	TRUE
Rè4ÍutzÔ´bîïA	TRUE
UTë÷m7NËÆê÷XMÍòæN	TRUE
¢uºwÂß	TRUE
ÅÎH¤VgU6jÍáÍ§xOÚiÅïÌ½	TRUE
òOdóAæm´	TRUE
§jÆmFä÷×¡4ãËyA	TRUE
z÷I7	TRUE
OõwfìwHE±KÍÎÑéº¤pN§£rÜ	TRUE
éu	TRUE
µ3È¸Å½¾Êò³9fæJåÓ¯¹e³änîU	TRUE
ä½¯ëdoL	TRUE
nkT6Jt¦°Àî«HGò¸E¤Ã¨çæÁI	TRUE
âÇ­9P¥SJ5APJzïØ×Ø½I°t	TRUE
ÛÜ°¤UÓºy9Ì	TRUE
¤hBGLe	TRUE
VhD4AYgñåÕ2VUI»ÈXL±R	TRUE
ÍT¸º÷ÏV¯22N¯ïm¤Î¨wÉ6	TRUE
l5lrÃ66±U	TRUE
jª¼ÌõA­yÆÚvzñõç­în	TRUE
9î²øW³lRQøbãàrx	TRUE
ÅsÓ´ÙV¹ó3iö	TRUE
´µ43»¹	TRUE
Ô6FH²Á1ºteëyõnô¶ßËÄÁ¡¦å	TRUE
®toSJ²­í	TRUE
¯ºärÝÀGÒ¦4tz¹¿ÚáQtR	TRUE
´AÓÌé7Ât2J	TRUE
æøÖPyS÷¸nPìT°æìd	TRUE
ßªWCËÜ¡Eqºs¸Ç¬J2ÍkRïe4	TRUE
wg°¶YÖòL©NÛªÝ³	TRUE
Òp§fvöÎWwrHä±÷ªó¿9fÎP¬ØE	TRUE
ÖHæÍ5âÔi§Ûï«î2EÐ3	TRUE
S¸CÐÒÏyDi¸¬¦pÌÊn·TÊë7	TRUE
gïÂ¡îOÒÏ½Ü¢	TRUE
õnÀËõPdùïêBrà	TRUE
SÚ7yãìØÉé¥¦°¥ÄäÖ	TRUE
àLæj	TRUE
ªË9ËÒ¡ç·à¿óãÉU	TRUE
MKÇ©qÝªÈV®vP¿pÖÁÉªð³	TRUE
ÔËjM­YÈòåbyvÚÝ©ÕÐIeÅãTNÀ	TRUE
ætÍsñÞèÖñÀcöWïÈÐMZ6O	TRUE
ÖY8Ñ¥Aô1ìuø4N2	TRUE
ÓÒ¹¿¶Ùs1çAD´F	TRUE
¡âÃ	TRUE
Û1Ëf¡j¬H¿fæ¿«	TRUE
µØ¸	TRUE
ëõË4Tìôwó÷C»cø¦®Á9xPµìð¦w	TRUE
åSö1ÏÊ8ÙjE¤ÅA¼RSæNÓ	TRUE
1sz°DN¥vàyÇx©dyË	TRUE
eôÍÃêWAöÁõÁ²¨«ÝÖâI9VS	TRUE
q¸D½äBJÉÝÅèÀÌ§ÞYÇ©Ukö´´Ñ	TRUE
OiÎQ¼pÅ®·	TRUE
wZìä	TRUE
·á	TRUE
uHávôSBAÈÏÂUølÌ	TRUE
¼¸r®±kµPÛZ	TRUE
¿óººÔ9AõpÓéYeðN¡	TRUE
½HÑxÛêÆÍ«w¹µmMòäpäÃéV	TRUE
½ãì¥ùQÊÇ1ÇoÂ»W	TRUE
EqßÚG·	TRUE
1ì7ÏìQ	TRUE
çè¯MÆ»¸»CÝ÷½ÚßVni	TRUE
ñe­±»Û«jÎÚåÖø»ùA½¦å	TRUE
sNDòÖw°n¤Ä´«	TRUE
«ÖqÜwºÊ	TRUE
AéÐø¯MlSÍ®òLíZàB5ø¢	TRUE
bºâÈ«Ôä×¤ÔÀÉÃöâ	TRUE
¼ÂæB2rdvIàðÉ2w¤OµM÷g	TRUE
wÄvE3ÈJÄ	TRUE
ÆoG©NÕyJ7©k¿ÖWé®sî	TRUE
å±MæeÐËÜ»«	TRUE
wâ	TRUE
j±LrîÍØÈ¥iÅ·uì·	TRUE
ëÊBðÌâÌ	TRUE
Íc8h2Ê²S¸ª¡ItwÕáÇ6Éù¼¼ïV±	TRUE
FºC¸o£°îOÞÄy1	TRUE
øv®èÓGâObj¬U6öÒ	TRUE
dYÀ×çaÜ7´ðí±6gì¸g×U8f®Éª­	TRUE
â¨îuùòM°sAy	TRUE
T8îJ±ö6tCÑÄ	TRUE
àX¬Ôm1ÑÏ£ö	TRUE
fag	TRUE
ö¡áhYt¨¶e¿ØÍ	TRUE
RoB÷	TRUE
¬SÏ	TRUE
xÁr¼ÈÕËÑp¶XpÕÈw½ë¶z	TRUE
yïÉFÝeà¦õ¥£Óg¸	TRUE
fÚáÏòQuJöSëAÀÃk2	TRUE
ßmÏ¼e2Ñ÷ÂºéÝZNwíqÖé	TRUE
¨ºRhVBzãH»ÜæqSê	TRUE
ïxv°r®®õBu	TRUE
5ÓÓb§B5ÀìÊWÕ½oC½è9ã	TRUE
Y5¼æf¶S4¨ÃÔ£Ý·CÓ	TRUE
ØèËåãoãõxñQ»hGâÃáoIW¼º	TRUE
¤¿ÙõÎ§N·ñT»MßÞakrñÎËÐyxk£	TRUE
NWAbj¹Ëñbª1ÔÃ¼¸æf	TRUE
·	TRUE
R¹¨ßw¡XªóÔÚêª3å¿éÚÉ8hÉ©MX	TRUE
A¢ÄW¨x­I¾	TRUE
G	TRUE
®ìVâVØJFHEuÎÃîã²æÊïnÈè	TRUE
JA¯æ½WÚçïìqù´ßÐ7t¨âÅîD	TRUE
¯SÓD²÷xSÌÛOîÓ´ÁÎ¨8°OÂ÷	TRUE
t¿Wæ±6HïÝZön¬Áh	TRUE
¾jyBlÙùvN	TRUE
ZkÕVç¢Ò¨cÕwÓ	TRUE
C÷bÎhvVµìÝå°e	TRUE
I÷mÁ	TRUE
ÍâÄK´	TRUE
qáÆq¦ê	TRUE
8	TRUE
ìC½ë8ñ³oß²E	TRUE
5eÎBmõ¶ÎqYöïÅºosTl	TRUE
déqPÇßß¡ïQ³ªsâF2	TRUE
bQdùvigòÔêR¨ALVÍ¤¹ëÂvÝ£×p	TRUE
M³°¨HØ	TRUE
xÈädíÜ©Ø3·c¼¢	TRUE
ðwË±7¡À¸n£Ñ¤	TRUE
âÂ§áÔLv²ÕºÑ­nïeùN5Ù	TRUE
1Ô9øîÝ¬	TRUE
ó«ëàNßGmÅìN5÷çaYWµË°o	TRUE
X½ØKfÒæïÛærÁÚjHG¢6	TRUE
®ÍDì3ÌÕìÀ¬Gv¶ñäãÂAÛAÈïâ	TRUE
ªÖ¢ª	TRUE
pìB7kÊTÑ8hvÚGÇHPÎ«Ø	TRUE
ñ«ÅÝíé¶abðTUfØÖ	TRUE
g÷é8v³66gYÉ½ZßÕsÙ	TRUE
V¡ãkîª°ÝôÕXÃÃÈ	TRUE
TXÛC5ÊéÙ	TRUE
ºkP¨Å37Ì±ïB²êut	TRUE
GXÓyèÇ7ÖéRëÄ·BdR£	TRUE
qe­øºDmÙ±°ér±³½hvÙãBÅ	TRUE
k»kb	TRUE
bóVN©RaoÛÁÑU±H£×BZZj3ìL	TRUE
ÞöØ²ÞÚx«iÍ°åMCéaaF	TRUE
ZìÑÁÂÎiàV	TRUE
ã¬ÈAº	TRUE
ÊqÑJßé¡½Ô	TRUE
ôgÐM¸h¨A¥	TRUE
»mµ	TRUE
oø¿uÜ	TRUE
4Kj4YÈmàÎù6¾ZUÚôVÒwõ	TRUE
×g	TRUE
Ø¥O§¦FØ195J¥´ÇÇæHMñ5UÈH	TRUE
zXWÃº¤	TRUE
§ßöfÓ·åÑ	TRUE
«wçqõê	TRUE
èËlæÓ2bå3¶´EÂE¯iØ×çU	TRUE
Gx»KË²ÙÙ¼fÊ¸SHÎ´LáÖ	TRUE
·ÜÚ½ïÎ	TRUE
Rõ÷	TRUE
¼ãf£ÌßxK§Ê°Fé¸JÖ×fÏºÝ9ç	TRUE
Ìôi¸	TRUE
VXáI×âærãÕ¢µ¡	TRUE
TQÞÓ¾	TRUE
Ýrí9øôø7ø5Üøô©QñË	TRUE
VÎ¦rLq¯×DÝl¿	TRUE
p¡dKÈÂµ¥Ç¾çÞRÌBÐ¡ÄMÃ¬5é¬H	TRUE
í¹Ñ÷E¯bZÏJµzïqº¨lÍ	TRUE
Àèá	TRUE
HyÄÍtÝÐ¾ôÌLoÌø§W­TWUTù	TRUE
ÑÚséoÀH11Ò¾ßæÀ¶çFpáìKÄë	TRUE
p§gAãLd¦	TRUE
²	TRUE
RGï¹YX¯Æ·ÝäE±ÐÆæò®wj	TRUE
píÓ¾	TRUE
îOAâCº4êÆ2³n	TRUE
¤ÈN¬ðÎa	TRUE
ÑtiÙôG5B	TRUE
IÊªÎLÎØniÝQoHðGáÔÚ	TRUE
·8Ä¢ëzÕð±í±Ûsë«Q	TRUE
eÜ¤IÂVáÜh¼ôÉçÀY	TRUE
r¾¡Ñ²ÍÚñµR6	TRUE
J¯Ym	TRUE
¥oOÇkEòoryôÏE5cmIøo	TRUE
Â	TRUE
2®¢¨E	TRUE
­í¯½m6ùñÊ	TRUE
ÓYIßFÀ¯âQÊQU8Qîhà¶ÑVÕ	TRUE
xËMÕmàUL	TRUE
5íÏÚH°NÕhi9FBäAÃ©ù2êíï´´	TRUE
pf	TRUE
ÃéÆt«Y¢nòñãB¥¥DÈõê	TRUE
ÓCÜYÉîù¤ïù	TRUE
U¦íÙØS¥kÈy	TRUE
ríFgî8Ño½Ç6mæëh¾­FÞÄ	TRUE
7¬rÆÏÀ2HccÑ«VyJ¡UQïñkðô§	TRUE
ßH£ÉX¦Qo°c®k3ÓÌbE3Ï2X	TRUE
3äïµ1öÒ±n8ðcg¾y1÷m4ïÝtñn	TRUE
HîÍÜÙÔKæ£Õ5hA5QAÄ	TRUE
ßªlÍóÜág»à	TRUE
MÐÏ1IUE§p¯h¦aßïÝ2¬m	TRUE
v½ËÍíCYÄ1¶6	TRUE
Â4âuâ	TRUE
ñmô­ÞEAÄÀC¨DZ7¶	TRUE
®eªÐîØí»Ä¾éO¾g¿ßòàäÔÁ«aoz	TRUE
U¥c4ÙÎó¹êt	TRUE
WcebõsÏYGG·µ	TRUE
¿¸ÃPÁ¯·Døæ¸½²ø½Ë	TRUE
ÛZöÕ¥ÐðF4ÃÚÂÕ¼ôÔêÄÄÓZÉOq	TRUE
cbù»8có9î	TRUE
ÝÒ	TRUE
8yPQÜjã¢Kß¸aaaaaaa	FALSE
UaaaaaaaaÇUG§Ó×M¸¡²íÅ2O	FALSE
naaaaaaaargJÑõ¥ï	FALSE
12ùrS¸Èd2¸Eì½WvKNGaaaaaaa	FALSE
bbbbbbb	FALSE
bbbbbbbëEÜ¥9Ú­q¦Ñp6	FALSE
OëÍ«bbbbbbbbø3h	FALSE
bbbbbbbs½áL§ÌÓ£Å»d	FALSE
Yw¥aaaaaaaaµfyºÁ­ÅátP©õ®	FALSE
ÑÞbbbbbbbbµ	FALSE
WÞÑººóÊ³æbbbbbbbbÑÈ¦ÍCðÙ©	FALSE
2aaaaaaa	FALSE
bbbbbbb98ßTRøèÐg¬ÃCË	FALSE
bbbbbbbçâ	FALSE
Ôaaaaaaa	FALSE
aaaaaaaaRS	FALSE
AÝ4ÐTGj¯Ciaaaaaaa	FALSE
Àwaaaaaaa	FALSE
¨öµHLdÌ4aaaaaaaa	FALSE
YÍÐpaaaaaaaaZMÍÃuÙì²l	FALSE
áTBo®Aaaaaaaa	FALSE
TObEñM9Haaaaaaa	FALSE
bbbbbbbU¡Oó4¦QÝ	FALSE
OGHbbbbbbbbøÚ	FALSE
bbbbbbbQTë¯Ä¡Ï¤ÝBÍÓ	FALSE
SdZ¯¦au§3÷ïhaaaaaaaamY­ó÷	FALSE
ckaaaaaaaaÌ²ËèåSs¿½Tø	FALSE
ÍN¤qTY¸vÐsI§á5aaaaaaa	FALSE
æZ¢¶¼2aaaaaaa	FALSE
bbbbbbbDU·fy¨©ÇÖÎU·r	FALSE
ÐÑbbbbbbbbøÃ£Ó¼¦	FALSE
¸bbbbbbbbÄïÕ­¼cV§2Îv	FALSE
zaaaaaaa	FALSE
¡9çEËl4q×£ºªbbbbbbbbÒÜz	FALSE
8ì°ÕÓbbbbbbbb	FALSE
kÍÙ·S»aaaaaaaaægX¤gpEO¼	FALSE
aaaaaaaaIê¹ö¾eLBåðjê	FALSE
YÓaaaaaaaa	FALSE
bbbbbbbUµÈ¢Wosõ©«WÙ	FALSE
wÅíøáaåìÃÎ¦pqbbbbbbbbÎÌË2	FALSE
¨ò¡GaaaaaaaaÝ¶	FALSE
8d·aaaaaaaaØ	FALSE
éÝG¦±Ê¶3Zaaaaaaa	FALSE
bbbbbbbqdöê8R7ÐµoÒbÜÂ	FALSE
bbbbbbbÅmòlKªïÖÈ¥©4	FALSE
ßÉÁ1ÑóXÞaaaaaaaazÃ¶	FALSE
ðªøyd3aaaaaaa	FALSE
bbbbbbbb7UVNUËrr	FALSE
bbbbbbbÇ²ÕÜÈ	FALSE
Òb5aaaaaaaaç7	FALSE
áAD¢÷V8bbbbbbbbZXìà	FALSE
ð9aaaaaaaaÜM	FALSE
bbbbbbbb¦3¯ÑªiHsã¼Æ	FALSE
uuØ³ìío2¢Z²¶Ñq³aaaaaaaa	FALSE
åïë9èÇËaaaaaaaaÊLCÙã£²	FALSE
bbbbbbb¸ñåÒæVøb¯Û¼Ù»²º¢Ñ	FALSE
²WöMè¼aaaaaaaa	FALSE
§¸©bbbbbbbb¢·®mÙï¬5Vª	FALSE
BÆxqn©ïª¯ë¿xaaaaaaaaÎA	FALSE
Ù¾ÍíïÁóÛaaaaaaa	FALSE
£ÜMÄ³À7EÞaaaaaaaai²1LógQ	FALSE
bbbbbbbÈlö¤ÅñS¼O¡ë	FALSE
¤Ó¸¹s¤»AdKfbbbbbbbbÍñÏ©cL	FALSE
ÇNèVo½ÁÆº©åaaaaaaaa	FALSE
bbbbbbb÷¡ZÇ­M­eJ	FALSE
bbbbbbbÕ¬È£â­ÝÙò8¯¡ÛvñÞ	FALSE
Yaaaaaaa	FALSE
bbbbbbb­V8mÁá8ÓÉê	FALSE
bbbbbbbeÔñby¢e2	FALSE
½¹¦MjfàøÄºÃtaaaaaaa	FALSE
ðàty5bbbbbbbb®®õtðñmÃBÂì	FALSE
õÕaaaaaaaaFjÓíB	FALSE
¨¡ðaÐhÛ¼zp§£ùÔÌaaaaaaa	FALSE
6UÛÖãá×±ÃM8ÌaaaaaaaaôV	FALSE
»DzöZÝøgùM«EÂMaaaaaaa	FALSE
LT½bbbbbbbbÍgìI¢EÕlsxÛTP	FALSE
¸bbbbbbbb¸Ã	FALSE
bbbbbbb4ÆáYàR2FÔ	FALSE
aaaaaaa	FALSE
Rì¼aaaaaaaaR3Ù×å¤dËîÔf§xÖ	FALSE
bbbbbbbf	FALSE
aaaaaaaa¬fÙÎnH¢ªÚ	FALSE
L¬hnaaaaaaa	FALSE
ôUYCáhoj¨ôaaaaaaa	FALSE
D£3PGéaaaaaaaam	FALSE
bbbbbbbbLñk¾Ì£WÂñæêöòÌ	FALSE
êaaaaaaaa	FALSE
r¼¸Ã½S¹¶aaaaaaa	FALSE
ißBÓF2Ö4gÝñöµMbbbbbbbbã	FALSE
Ä¦aaaaaaaa	FALSE
té¶Õ£ªã÷bbbbbbbb2ÌìtÉ¡	FALSE
kaaaaaaaa°uJÛ	FALSE
lÂVÃxNªLÔÝ±Ëù°¡aaaaaaa	FALSE
á³cyµ¾ÝyEaaaaaaaaQXËsßËÙ	FALSE
Ûòbbbbbbbb	FALSE
bbbbbbbÐ4O±°v2E6®	FALSE
bbbbbbbwËãiC®2Äïz	FALSE
bbbbbbbO¹ÚaÍyïÓ³1	FALSE
w¶ÛÙÄdÓÍÂ¨qËí¤Æaaaaaaa	FALSE
aaaaaaa	FALSE
ÆLSÃ¼nãJÊkðÂp¨Îßïaaaaaaa	FALSE
bbbbbbbêëîmG	FALSE
bbbbbbbQ	FALSE
Äjdñ¤¡Óà¸aaaaaaaa	FALSE
PuU2ÂÉm¹­ªFjaaaaaaa	FALSE
ªbbbbbbbbxªEåF	FALSE
Ä²ÉðÙaaaaaaaaÄQXÎ	FALSE
ïÀÙGkItïÜÊÛÐãpµÑWÁaaaaaaa	FALSE
òuªÕyÚCp¶bÆ6ïxaaaaaaa	FALSE
aaaaaaaa	FALSE
aaaaaaa	FALSE
bbbbbbb	FALSE
ÇH¡Æåø©ãX¶zaaaaaaa	FALSE
aaaaaaa	FALSE
¬Y¦n©9Ã¥­H¼B3qaaaaaaa	FALSE
³vJbbbbbbbbD÷B	FALSE
bbbbbbbud2U´Ås	FALSE
FÃ2l²bbbbbbbb¾62	FALSE
Zaaaaaaaaå	FALSE
§7£SÀ¨aaaaaaa	FALSE
bbbbbbbG÷¬rÛaÞ	FALSE
bbbbbbbAÂÈâ¢¸	FALSE
âÎÚÀbbbbbbbbÀÚ	FALSE
èCÐÐÁçô4´3®ØÙbbbbbbbbÔ­Lv	FALSE
bbbbbbb¬ÂÉéÍÔ	FALSE
aaaaaaaaK©O×OlÁx±nQ25l³¥	FALSE
aaaaaaaaÛ7¾	FALSE
ã·ifQCôTdfÀ±¯¦Daaaaaaa	FALSE
Yfaaaaaaaa¯ÈÍ4RWj8	FALSE
bbbbbbb9	FALSE
ìöìèÚaaaaaaa	FALSE
ïòTBfU9¢Nm°aaaaaaaa5øT	FALSE
bbbbbbbb	FALSE
Qaaaaaaa	FALSE
B÷øk×íÞÖ8E÷Tmaaaaaaa	FALSE
bbbbbbb1Ô©Ð	FALSE
aaaaaaaa	FALSE
bbbbbbbH«£RÓ¸©ô	FALSE
jFÏ¯åÉvñ©îaaaaaaa	FALSE
Ág·vaaaaaaa	FALSE
Äîä½ÁHäaaaaaaa	FALSE
bbbbbbbrð­	FALSE
¹LbbbbbbbbØ±	FALSE
EzÉ»jyQaaaaaaaaaza	FALSE
8ÀØ6¯z³aaaaaaa	FALSE
§¸Øiky´aÃÉöaaaaaaaa	FALSE
bbbbbbbbÝÉµÕâZãóÑàZÊDØùµ	FALSE
bbbbbbbÕÏo³Â÷	FALSE
bbbbbbbr²	FALSE
bbbbbbbæöKÐ¬·§Vë¬ÐÅÕe	FALSE
bbbbbbboâíh©ñSi¬	FALSE
EaaaaaaaafwBÆöEÉUmøP	FALSE
bbbbbbbäJé½9÷Ãcc¤èÆ7Á5	FALSE
ùaaaaaaa	FALSE
bbbbbbbdÅcÄ9zÎ	FALSE
Ëîð±uå¡»¶ÐÖ6aaaaaaa	FALSE
iÛØRbbbbbbbb1Éø´U	FALSE
ìxÖ6¢V¡N¶4aaaaaaaaÙè6	FALSE
æbexvC¸3±Dbbbbbbbb£ß¨¬Æô	FALSE
bydsaaaaaaaaHAº´E¿37w9	FALSE
aaaaaaaa4»ã×ìÌâè§÷	FALSE
ÉÀ¼wdÎbbbbbbbbSÂWøÚfgtÎÖ	FALSE
wÚ½Zôq§aaaaaaa	FALSE
MGaaaaaaaa®¿DlÚµìàÑÃGôx	FALSE
EêÈö³½sæy¶RøÌ6DëCaaaaaaa	FALSE
ôbbbbbbbbè	FALSE
bbbbbbb9sß«ÕaÆJnâ	FALSE
õH¥Ûõ´ø¬ô²¡Øydb4ÌKaaaaaaa	FALSE
ÆÞÅ°ÖµbbbbbbbbÙ¯d	FALSE
ôbbbbbbbb	FALSE
Àòit¥Øaaaaaaa	FALSE
bbbbbbb	FALSE
bbbbbbbÀç¸öÐd÷	FALSE
brbbbbbbbb	FALSE
aaaaaaaapRE	FALSE
aaaaaaaa	FALSE
Ùbbbbbbbb¡CÜn¿¼	FALSE
bbbbbbbß°¢ãh	FALSE
Øbbbbbbbbá£	FALSE
ÆÛ¥aaaaaaaa	FALSE
pÊTö§Å¡kL»uõâáaaaaaaa	FALSE
bbbbbbbbENWï	FALSE
wÊeaaaaaaaanÊíxZÙGôöqñÂðd	FALSE
bbbbbbb	FALSE
wb×g¦¢Svm¶ô´bbbbbbbb¡®±«À	FALSE
bbbbbbb	FALSE
É2ÅÖ2aaaaaaa	FALSE
Tw­a3k°fcNZ¹ñËaaaaaaa	FALSE
»6Û°§Ùêk°ÂbAYaaaaaaa	FALSE
ubbbbbbbbØq	FALSE
ÌÝaaaaaaaa	FALSE
©ÈÖmgÄÙBg¿»­aaaaaaa	FALSE
çµä9ð­¨æcFEaaaaaaa	FALSE
ËIÎim·©q¥eùàðòNEaaaaaaa	FALSE
bbbbbbb	FALSE
ãSaaaaaaaaéNëßÖëÁu	FALSE
bbbbbbbXÑzZ6oºjg¸ëJ÷oÊó	FALSE
bbbbbbbÝ¡àå¼S§Ü4ÓDOÜëÖ«àº	FALSE
bbbbbbbb1	FALSE
aaaaaaaaÂ£åÄöÜnîF	FALSE
sè´L7aaaaaaa	FALSE
bbbbbbbÅzñQ·	FALSE
jÃÛp¯«9nÜ¹ÒÅ2e6aaaaaaa	FALSE
bbbbbbb°Vk¢èTÔ¨1CêÚ­FÚ	FALSE
È·aaaaaaa	FALSE
R³1aaaaaaaa°ðøùÝ×±¯­kD×	FALSE
åã¢Sµ»ØsÎöø­àd¯¼aaaaaaa	FALSE
2ÑâeÓ¤k±SPµZ³ÎÏaaaaaaaa2W	FALSE
¨QaùÖoKcªp½AÐåaaaaaaa	FALSE
FgªybbbbbbbbJ°ø	FALSE
bbbbbbbb»À	FALSE
aaaaaaaa3¿	FALSE
aaaaaaa	FALSE
òFçEñªaaaaaaaaiù	FALSE
¦ÜÙÁö¦òqobbbbbbbbéæÁ	FALSE
WËìlbbbbbbbbä¦ºiÉönÜ´	FALSE
haaaaaaaaDó	FALSE
aaaaaaaaïE	FALSE
bbbbbbbPÉaw¡k¯ÜÝÂD2Ë	FALSE
º¤RbbbbbbbbÎÄvßOAv¢5kæt	FALSE
èuöÐÀgÕx±N±Ûo2Üºaaaaaaa	FALSE
bbbbbbbbvÀé¬BPkóÃEBÔ	FALSE
ÇtCbbbbbbbbÓÔi÷ïrjË´íÌ	FALSE
aaaaaaa	FALSE
bbbbbbbMÆÖ¸°ITÉs	FALSE
eQbbbbbbbbx¼¥ïÇVØOKßEGò	FALSE
åbbbbbbbbÌBºs	FALSE
æaÌÆÎÖ÷ô1öôùõ¹·aaaaaaa	FALSE
soaaaaaaa	FALSE
zVjk¶Q²èaaaaaaa	FALSE
bbbbbbb¼zÃÐåÐ³RfÃ×	FALSE
bbbbbbb	FALSE
xL¦ßx8aaaaaaaa¨ÌìmÖÄkBòä	FALSE
©éÉ9®¬µBjbbbbbbbbæÌXÀjùJ	FALSE
bbbbbbb	FALSE
bbbbbbb5ØLQÓ­·¦5t8	FALSE
Ø§Öaaaaaaaaäc¬ku2Ë	FALSE
bbbbbbb½5Q¥Êîdôs÷Þ®èÄ	FALSE
bbbbbbbbNdíÍõzÆgÒqÁõîdÄ¬í	FALSE
éMiêvÌÍº6ßÙØaaaaaaa	FALSE
l¯öbaaaaaaaaÇjEÃwùK¦ßkbQÏ	FALSE
aaaaaaaa¼¶	FALSE
aaaaaaaaI	FALSE
yQµcMDÉîB¯Àòß2£6ºaaaaaaa	FALSE
bbbbbbb	FALSE
7öbbbbbbbbNé©Çò¤ÑõS	FALSE
ìepï8¼BÊÉ3¿aaaaaaa	FALSE
bbbbbbbô3¯TõåÍy²	FALSE
bbbbbbbV¥o½ÒUUf9÷ïá	FALSE
Òøaaaaaaaaw	FALSE
Rbbbbbbbb2ä÷u°	FALSE
aaaaaaa	FALSE
V°ãSèmóaaaaaaaaÈ©	FALSE
Ú«Ükø¸aaaaaaaaJtE	FALSE
bbbbbbbReÆz¾´ÊÁé¿¸yÞ¯	FALSE
hØÐAZS¸r4ß¶aaaaaaaaÄ	FALSE
aaaaaaaagáâró2¬UzuÙÕ	FALSE
mPê8rðÍÓm©ÔÙbbbbbbbb	FALSE
AÌbbbbbbbb¶	FALSE
B9bbbbbbbbÅ5	FALSE
bbbbbbblãtÀ	FALSE
meOraaaaaaaa	FALSE
bbbbbbbb	FALSE
´ôaaaaaaaaÛ¸Î	FALSE
ñGÎ¬aaaaaaaa­âÑ9¶GÐW	FALSE
×ñÓ¦ÉòÂd¼äØÏÕðd¿Å²aaaaaaa	FALSE
qãhwÒÂéÚcAÓ9Ã»Ø¥aaaaaaa	FALSE
ÏåØ¡ÂfºÍ¾¶TÀaaaaaaa	FALSE
p×¼ºbbbbbbbbgQÃZzîj	FALSE
Àê7GÍyãáH¤Eaaaaaaa	FALSE
Ì¿¢éT¢§aaaaaaa	FALSE
BÍeÌäbbbbbbbbÉ	FALSE
ÙyG¯É¢ME«½«kòÎèÎ¢aaaaaaa	FALSE
Qw¶aïaaaaaaa	FALSE
ébbbbbbbb¬o	FALSE
ï¤aaaaaaaaÁéÂk3Zºk	FALSE
®aaaaaaa	FALSE
bbbbbbb¸¹öÓÒæIºmpÃÁfFÆ¦F¸	FALSE
ëÊw5aaaaaaa	FALSE
6°aaaaaaa	FALSE
aaaaaaaa·ð4c¡B	FALSE
bbbbbbbiDè¹½Bazi	FALSE
r®¼lWbbbbbbbb	FALSE
bbbbbbb§4	FALSE
bbbbbbbÌs	FALSE
os¾ø®tj3aaaaaaa	FALSE
ñWEp­eÝ÷Ã¬OÖè±ìÉ¼Áaaaaaaa	FALSE
aaaaaaaa­¬¡¶	FALSE
bbbbbbbëtQZ¤öÈ©±ZùÒf	FALSE
êèW­Kaaaaaaa	FALSE
£bbbbbbbbÞ	FALSE
LW´bbbbbbbbTòáò	FALSE
RbbbbbbbbÛÒpÁ7G	FALSE
ÊK±ÀÔÒkÆaaaaaaaa1ãÝò¬	FALSE
bbbbbbb	FALSE
Pßbbbbbbbb	FALSE
HEbbbbbbbb	FALSE
OªËp×¼Ìaaaaaaaa	FALSE
SJ2°vª¾V®aaaaaaaa®Çá	FALSE
öóxÔ¥ÒÕaaaaaaaa2¾	FALSE
bbbbbbb6öª¸Ä¤Û	FALSE
bbbbbbbb	FALSE
bbbbbbbÑÑ4êÎ	FALSE
bbbbbbbOãYEËøWÆQO¡Ö1XÂ¨éÚ	FALSE
2kÚbbbbbbbb	FALSE
ÔÊÔøaaaaaaa	FALSE
Nd«5qðQëCL²×4ðaaaaaaaa	FALSE
bbbbbbb®	FALSE
µB­§TÌl±42ÎÑó6sh¯aaaaaaa	FALSE
bbbbbbbIìÖJÝéFâå	FALSE
Taaaaaaaa	FALSE
lQfPã5ù¬ã¢1nÕaaaaaaaaÆ	FALSE
bbbbbbbÙHáGÃºLîÜMA«bÑf¿	FALSE
Å¤­UgÑÎÊbbbbbbbbd6oÜ§°ç	FALSE
bbbbbbbböXh³°häÃ	FALSE
nÂé§hD÷÷íXxÔø¯dæaaaaaaa	FALSE
bbbbbbbQÃ¿E	FALSE
bbbbbbbÈNYW¢óßxHå÷Ã	FALSE
aaaaaaa	FALSE
¿ãaaaaaaaa	FALSE
aaaaaaaa	FALSE
ÙßbbbbbbbbÜöàøð	FALSE
f×¨yfQ¾ÀÀbbbbbbbbÙÅy»§ÍG	FALSE
bbbbbbb§÷¼àLÝ·È	FALSE
å¸F£ørðWoËAîbbbbbbbbB	FALSE
bbbbbbbUÔÞ´¹øÅà	FALSE
¨Jaaaaaaa	FALSE
ÛBJvAËaaaaaaa	FALSE
bbbbbbb÷¸·¢Mez¿E	FALSE
îOX9bbbbbbbb	FALSE
°l8®J¬ÝÕ¥kufçÂaaaaaaa	FALSE
aaaaaaaa¶ÃBeÝÀË	FALSE
aaaaaaa	FALSE
ÊK§bbbbbbbb²r4ïìgìÛµw¿ù£Ý	FALSE
ÞBÔñZ°Haaaaaaaa¤«MS	FALSE
bbbbbbb·âwNQN3	FALSE
bbbbbbbô¯£tse	FALSE
º´ôÙ4màaaaaaaa	FALSE
æÙBºgFNãèÎbbbbbbbb	FALSE
¾ªJ66bbbbbbbbcZí	FALSE
bbbbbbbéÚ	FALSE
Ç´Kbbbbbbbb¦ÑWÛÍO3êà¾ê	FALSE
ï±ÊuLaaaaaaa	FALSE
oWç3ìÈWæÕeáaaaaaaa	FALSE
bbbbbbbK1	FALSE
bbbbbbbb³ÆKvÇÕÎX»ÝÍ¬	FALSE
bbbbbbb¬©UtÄtëâ¯s	FALSE
Ðµeaaaaaaa	FALSE
bbbbbbbp¼¦¹«·wÉDÇðh²h×h²	FALSE
Qbbbbbbbb÷uy¨ÈÁhA»	FALSE
Çk½8±°C¡bbbbbbbb	FALSE
­AéobWgÐ2P©L3ØöaaaaaaaaÊ	FALSE
Cæº¥Nµaaaaaaaa	FALSE
bbbbbbbçêB¬¼ñ	FALSE
¦¶¦GÇçÙNe¤AéôÙP¤aaaaaaa	FALSE
bbbbbbbÐ»	FALSE
¤böaaaaaaaaTµá·¹Q	FALSE
ºÊÍ¶aaaaaaa	FALSE
aaaaaaaa¥ÉÈP1ñØÎ	FALSE
bbbbbbbHC	FALSE
øÎaaaaaaaa	FALSE
aaaaaaaa¸	FALSE
bbbbbbbë5gCZ	FALSE
nuÜaaaaaaa	FALSE
bbbbbbbCh	FALSE
aaaaaaaaê»öOoÁõk¡¬Ã¢	FALSE
WÐIWébbbbbbbb	FALSE
Z9hbbbbbbbbàáºxSróI¸	FALSE
bbbbbbb	FALSE
PkF9j¿4ä4YÚbbbbbbbbh¦Ð¡	FALSE
Ô¹J7¥Ùðµ÷í±aaaaaaa	FALSE
aaaaaaaa	FALSE
odw¬õºÐzÛBaaaaaaa	FALSE
ö8xîîIÛccØÉ÷÷kaaaaaaaa	FALSE
bbbbbbbÅ	FALSE
ÒÖßìWÅÍj®yn»éaaaaaaa	FALSE
bbbbbbb°2ÑàTpøVh	FALSE
aaaaaaaaÊïØ¯A	FALSE
ØÜjr£KßÓÄK£dchaaaaaaa	FALSE
qõÒÍ©ÍNO¥ö¡aaaaaaa	FALSE
