j	TRUE
fbcbciigjegdgbdcadfafdj	TRUE
jgejehffahabjjccieh	TRUE
fdgfijb	TRUE
b	TRUE
jigaffbgdabdede	TRUE
jdicchbeea	TRUE
dighcfcigchbjcdcgdhajcid	TRUE
eaid	TRUE
ghihijedef	TRUE
ebcbgfjjdheeajaccjidhedha	TRUE
gdfbhadcjhggj	TRUE
iifeebijjdhfb	TRUE
ifaefbffgijbjajjdh	TRUE
gj	TRUE
dbhc	TRUE
hajafbhjeeihgicfaeceega	TRUE
ajcacegajfjdeb	TRUE
abhaic	TRUE
gifibijjigefj	TRUE
iggjcbjfehhgbgeie	TRUE
cbeibafebjehhjabbecd	TRUE
bfjdehecbhadebadfjchg	TRUE
ia	TRUE
eeccigddcfdhjcd	TRUE
aeaafjbejhbjbffciecai	TRUE
aagcfefdaabfgd	TRUE
dfeeecei	TRUE
beggfgefadjcjed	TRUE
jcaffhageidcajiicbj	TRUE
hhdjgiiabbh	TRUE
bffibcfibhdadffghba	TRUE
gjhighhgcd	TRUE
hddeaciaghjgjbjabcbfefe	TRUE
gghagiidideiafbfd	TRUE
hjhdeh	TRUE
dhiacabfhcdjeefbeg	TRUE
dcbaiideagbigcei	TRUE
bhfdjbefehajbhehhhhbh	TRUE
fjahdjccfhbhcfhjdgiggi	TRUE
gjeha	TRUE
gehggfdb	TRUE
bie	TRUE
iecjeiheaejihabjfecgcgb	TRUE
hbgjcjcfbbadcghheggeec	TRUE
gfihfghgbfhe	TRUE
baf	TRUE
cfjfhh	TRUE
efeeidgcefegaigdgdafa	TRUE
abijgaffehchdahc	TRUE
dgifgciehicgdfbgiefh	TRUE
ghgdg	TRUE
d	TRUE
jcbdbefgdhejaghhehccg	TRUE
bccbade	TRUE
hgfeajjaabgacga	TRUE
eghjgbjciggfaedhidbiajehd	TRUE
fj	TRUE
cj	TRUE
ffjficddggfdaeaiejigjha	TRUE
jaefjgacje	TRUE
bebfhhgafcjjaggbjbjdbffd	TRUE
jhfdd	TRUE
hgjbe	TRUE
dbbffabdbifhdjgfgffegff	TRUE
gehjebfiacjgbcd	TRUE
idhjifdbbadb	TRUE
fgiahigdcbjhacacaejjbibca	TRUE
gigfhhbf	TRUE
jhbhgcagfbacfdca	TRUE
gjfgbjfgbbjcfddababieiiab	TRUE
gfcceegbgafdigjebciihghhe	TRUE
aaif	TRUE
gbdcjjaeghcjbbhejajjffeh	TRUE
jcgbfgbahcji	TRUE
gfcaia	TRUE
ciegjhcfjffdccficaciejgf	TRUE
jeadghacbchcdjgggi	TRUE
edacec	TRUE
edccffceijejfiffdacbccj	TRUE
idgeeiihde	TRUE
dgdijef	TRUE
afjiedi	TRUE
ibfcadecfgigheeh	TRUE
jehfgifjijighhiacf	TRUE
hbjiebfiidaiiccgcce	TRUE
gca	TRUE
afagghjade	TRUE
ifedddieghchiceccbgejd	TRUE
jdiadfigabddbdcbhffdabfbd	TRUE
hgdjejchgeahhcffebbccifa	TRUE
ejegdbcaebdccbhhjdidc	TRUE
e	TRUE
chgaifjhfeg	TRUE
jb	TRUE
jgde	TRUE
fdaaicgcehiebghfhb	TRUE
fcbcf	TRUE
iddjh	TRUE
ihfid	TRUE
fdhbbjfgdgggjgfjbcd	TRUE
hehcaibjcef	TRUE
igbcai	TRUE
ddicaefgcebcgjd	TRUE
cjcjj	TRUE
ciabiedgadahfgchgbbebj	TRUE
eg	TRUE
fcgbfa	TRUE
ifhgafghajafehjibjj	TRUE
baiadjib	TRUE
bcagcfjih	TRUE
dbeghacdjebigeb	TRUE
eigchagdddjega	TRUE
cjjcje	TRUE
bjiebdgbjjgahjigdhcechfh	TRUE
ffbbhdbecadeddhaig	TRUE
g	TRUE
gbif	TRUE
aibahfgjhjjeghbjhaaccg	TRUE
dchdfiiaajecfb	TRUE
iafchc	TRUE
fihgcchaddgcc	TRUE
fdbhgfceaifidgfcjbjhaifg	TRUE
hdjefhfjh	TRUE
iah	TRUE
hebhbbe	TRUE
bidcgcaidbbejjjjjgdebh	TRUE
ijabhcacjcggbgafcgbebdai	TRUE
edhice	TRUE
gdfdcdichhigjjidhfgdbg	TRUE
fgedcg	TRUE
f	TRUE
hgbajab	TRUE
jgcefajbcgbejjcjbghg	TRUE
cjgefchbccechcdhf	TRUE
bjdh	TRUE
jbacdidadadagf	TRUE
jeajfhjaffcjfif	TRUE
hiacfdefaihb	TRUE
abfedgbecaiidhgceeji	TRUE
efiiacgdgfdeec	TRUE
bjajgaiadcdecfif	TRUE
acgdhehcbhbhedjf	TRUE
fjfg	TRUE
gfcdiafddddiadcjgbdah	TRUE
jajfgeagajf	TRUE
bagghdehefchiidcibig	TRUE
ccbh	TRUE
gcghifbfbjb	TRUE
egadbcecaf	TRUE
jejidbjcjcafjghahjeb	TRUE
hjahefje	TRUE
gdhd	TRUE
gceeejb	TRUE
eedicfhdacgb	TRUE
aidcgbghfgfaajhbdg	TRUE
dbabejd	TRUE
efibbhaejieb	TRUE
ebe	TRUE
ad	TRUE
dgjbbhih	TRUE
efghhfidegfdfdaahbcadhe	TRUE
hjjbdhcdhhaecdgafgcgef	TRUE
fbchabifg	TRUE
jdcbdajdcjffafdfdeajd	TRUE
fideihiefeahgghd	TRUE
fcchbefabb	TRUE
dhbbdccbbeighehhg	TRUE
faebhjcbbhihebfg	TRUE
ddgjiahabbhbhi	TRUE
jgjaeabgffdebjg	TRUE
edcbigghidiahibdc	TRUE
hccidhfbigegibigbcejhjdai	TRUE
bieabfbbgh	TRUE
ahijjidhhjcbeeegcfi	TRUE
jcjfaadadadbdabjjhg	TRUE
jfdejbggddejfj	TRUE
jgefjh	TRUE
addhbfheidfgdh	TRUE
fiabaaj	TRUE
fgjgfahgddc	TRUE
bfgadajbcbceahicfe	TRUE
djcebiaacehdbbegb	TRUE
fbijbgfbagcfdjcjdefg	TRUE
chde	TRUE
ha	TRUE
hdjhcfehgbbeddhhibajj	TRUE
ca	TRUE
fhg	TRUE
ciefadijjhhgggdgde	TRUE
hiifj	TRUE
ddejaiijg	TRUE
gbhacicfdfdacfjdfh	TRUE
fhbbgacjfaigceadgj	TRUE
bcabgabibgd	TRUE
i	TRUE
ejhcje	TRUE
eddbejiebhfcecgajaceihh	TRUE
ci	TRUE
h	TRUE
fibhdai	TRUE
aehigjiae	TRUE
ggdiaccebf	TRUE
bebidhh	TRUE
g	TRUE
ebcaajdiacjafbed	TRUE
gbgcaeeib	TRUE
aihcceibjggi	TRUE
eijcebfhiadgbfafegje	TRUE
fifheheaca	TRUE
bdicdfffb	TRUE
biiafaedbijjbgdhgi	TRUE
gahbjadcahaheedaaii	TRUE
hcifjeiifgf	TRUE
cf	TRUE
afbeaehgfh	TRUE
j	TRUE
efjefbbc	TRUE
gjabibcagbiigeiachja	TRUE
iebfajgihifjhhhfbijfdje	TRUE
bagbbcbdacabg	TRUE
dbcfef	TRUE
jbhiegafejhbed	TRUE
achgejebfjhdbhbaag	TRUE
fccideeifhejjgbfdehc	TRUE
aid	TRUE
ibb	TRUE
jcedecbffceejgijabceghce	TRUE
fe	TRUE
hejgggcde	TRUE
gag	TRUE
jeiafaageidgafie	TRUE
idgb	TRUE
dhgbcaicb	TRUE
j	TRUE
cfiijfjfgd	TRUE
gdgdibgghdbacdaae	TRUE
eeabjjhbdhfcjedghb	TRUE
fhijcdhegag	TRUE
ihabaajd	TRUE
hccfjfabhbjfagebggfgjddfe	TRUE
gdachbeacdace	TRUE
fba	TRUE
gjhbifgj	TRUE
eecje	TRUE
gcdaidiabhhacfdgc	TRUE
gaebajhbadefbjbcidjcfjf	TRUE
eg	TRUE
chbf	TRUE
ijaedbhdaigfghbgdgccda	TRUE
cffjebidjbfccbfjd	TRUE
cdjibje	TRUE
gjgfefdebdjceh	TRUE
e	TRUE
agehacefjefbche	TRUE
jdieceag	TRUE
gaegiacdbhf	TRUE
iejajieghfec	TRUE
fjbgiijciadcjdccef	TRUE
ijbfjefgjadeiheaidaebj	TRUE
gehjaabfaddc	TRUE
jjidhibgi	TRUE
efjjgdcbdbcehheheicbb	TRUE
heijahdf	TRUE
gab	TRUE
gehcgjcgahieagbajegjbgehg	TRUE
iigcfjfcihbhiiahgc	TRUE
jiaifdbegabbjfaighegfcafe	TRUE
ifb	TRUE
hhjidccejhbaehgghdeecd	TRUE
jha	TRUE
heaediaadfjafjajdgjdaig	TRUE
hdiacgbbdffggfdhicbc	TRUE
gdhghiejh	TRUE
aaiihgiihecdgicgai	TRUE
gfjffhbjchdadfgidafdhigec	TRUE
ffhfhfcfbgidgdfcgagbgdc	TRUE
d	TRUE
d	TRUE
efbahfgejed	TRUE
bdddefaeacdb	TRUE
ejjabfehjjgigcdeaabchi	TRUE
iddh	TRUE
gfgcadcdicdcdehjeicade	TRUE
bgjea	TRUE
hbbiagfbihbbh	TRUE
icdddjfceibbdiafijfc	TRUE
bjifjaecicaih	TRUE
ajgbeaaacjgjfgaiedgef	TRUE
hdgjhabgfgiaaefag	TRUE
gdc	TRUE
fefhghhfchjhjhgadeebabeji	TRUE
ccdijfabf	TRUE
eheahicbccefebjfecgefhg	TRUE
acagfdi	TRUE
ebichdgjdcadfh	TRUE
afggbaiheeedecfh	TRUE
b	TRUE
gbcfajbeeficf	TRUE
bidhecdajeghfbbefabfdf	TRUE
cgacdccb	TRUE
bgeghheaf	TRUE
daie	TRUE
agbcjhjdhfjfcfcgi	TRUE
cbgdiheahagcdg	TRUE
d	TRUE
dfhfc	TRUE
dhacbfgbff	TRUE
fabgiegf	TRUE
cgbbcaje	TRUE
jbjeajjhb	TRUE
hgjdajdh	TRUE
hehfjdajaifha	TRUE
edagcbefdfd	TRUE
baehbjifaficdjfcggfb	TRUE
bdfieheehgifcdaffdjhbfe	TRUE
deaahcafdbej	TRUE
hhjgiadeeghfgagiidcjff	TRUE
jfdhegdchahhhagjcjfhebheg	TRUE
dbdefgjjcdc	TRUE
eabbddbgegehiacidccd	TRUE
habjhdeej	TRUE
gegcagefacdjbjjfagjibf	TRUE
bbigadcfjaihajdcebdcjd	TRUE
hehbbg	TRUE
biffegdcihcchehdhga	TRUE
aaaefegabjbiahj	TRUE
bebhiiedd	TRUE
dbeidaggaf	TRUE
heafhjee	TRUE
g	TRUE
eaehgdafijdejjjffijiciag	TRUE
dedfeijfcba	TRUE
cjhgifibejjffgcgghbe	TRUE
hdeihjiififjbif	TRUE
ejhjbccdibcaidj	TRUE
ggefeehdebcgcchjd	TRUE
hhaeaegdjaifcc	TRUE
iaeifgg	TRUE
ebijdcihid	TRUE
hcffaihfihcfccfcafdahhh	TRUE
jagfhjcdiaddjehfedeacbfe	TRUE
dfcfh	TRUE
ihgigai	TRUE
aabibchbcjgifcjbcfb	TRUE
hdidc	TRUE
ddeghghdjjaeaegjbji	TRUE
dcbcjdjjaiih	TRUE
daafchachedia	TRUE
hhffhafaiefg	TRUE
fgcijcjjecfiabddabca	TRUE
hcbjddjhdhaeffffjjaeeb	TRUE
ihggecjei	TRUE
feebfcgcgbbecagiggihjfa	TRUE
cbfabdjcddiij	TRUE
caaifhbijgeccgdc	TRUE
jjeegicee	TRUE
cdicjjbedjacicjidfafga	TRUE
fibei	TRUE
adbhehdafgdddhiafghjbfic	TRUE
hbfhjdbbdaaifedfhghjgggg	TRUE
iecjjf	TRUE
ijgefhigeahiadechdifbijjg	TRUE
cbaeabfgcijhgb	TRUE
ahighieiiagbejhdd	TRUE
cihbhefdajidg	TRUE
hijbfafddabbcice	TRUE
iddejjijiiieaaej	TRUE
gibfdebdjdehccigfebjcbjj	TRUE
jadeijfdjhiadji	TRUE
jhbeiefa	TRUE
bdagdhhgghfhhbf	TRUE
adidfbjcjfhaifaejdba	TRUE
b	TRUE
jddhbfbhjbbjgaaccbeeh	TRUE
fed	TRUE
bcdfdfcfiachfddjggifi	TRUE
ahae	TRUE
ibebfhhd	TRUE
baaeidhicjdgje	TRUE
dhdheeiei	TRUE
ajeicihhfjjbdedeeaagfaeb	TRUE
ecdaejcfejii	TRUE
ihejefchabhide	TRUE
dfbedbcdbi	TRUE
ijc	TRUE
cgfjbafiafafb	TRUE
jfhhhhehdgbdadaaifeci	TRUE
bccgbcccbgaacbcfif	TRUE
cbchiibdcfafgicfgbeajeaa	TRUE
jgb	TRUE
iaci	TRUE
hheihefbbiichfcgc	TRUE
hjabijebadiedcdgigeijf	TRUE
ahccddh	TRUE
ia	TRUE
f	TRUE
ficjaiediiacgifihihid	TRUE
gcgfhbhihibjjfbdf	TRUE
ggbjdjeabicbiecafhhc	TRUE
jaabjieghefhiij	TRUE
cbeggcjbdecb	TRUE
fbbcfigbadjeabfdhjc	TRUE
fggjijijafj	TRUE
cbgifjihjcdab	TRUE
ghdhfeecefiaajicffed	TRUE
cfdeggeghhcfhah	TRUE
hehhbdebfeeigbjccdgdaagid	TRUE
fadbjdhdhbfede	TRUE
iaedgb	TRUE
fdceadfehjjcibbf	TRUE
dhjiihfgcghejcgcaja	TRUE
fadcffgcabbieecaj	TRUE
degfbddcbchfchajfgbd	TRUE
ibhaih	TRUE
ahacddjgeccjhjfgg	TRUE
gjgfhbcidedff	TRUE
db	TRUE
ha	TRUE
ebaeaafjjihaghdieibbidiai	TRUE
hiabb	TRUE
ceb	TRUE
aeaccbjffahhfcdeicg	TRUE
jeicaaigaajbeeebebdbadeha	TRUE
fggec	TRUE
jghhebiidijb	TRUE
i	TRUE
jdddhdacefdehfahb	TRUE
fbbdjdcaheb	TRUE
bgdecbifjedddbbc	TRUE
bda	TRUE
bfijjbjhddejfdig	TRUE
dhfbjaffffbgh	TRUE
ghheijaajbbceghd	TRUE
fdcfcfabai	TRUE
df	TRUE
fbjigij	TRUE
degehaebhabeeeebbeegjgj	TRUE
aedeiheedgbbejhij	TRUE
ffbb	TRUE
fhfedbbafdf	TRUE
jjfeeigicfjighbe	TRUE
fihhbeeidjiccfhggcccjdii	TRUE
gdjgceabihi	TRUE
jjbabhjhaefhaea	TRUE
fhdggacbe	TRUE
hijhgcchijjh	TRUE
jbiijfhbcadcbfg	TRUE
fddbd	TRUE
dijbjhjdejjdji	TRUE
aggjbaicebhici	TRUE
efabiiahaggfjfhdeffhe	TRUE
acbjcaiifacjcbcaihjchifgg	TRUE
ehdajfd	TRUE
iiebcdgjgabiajhafbijedcg	TRUE
hiehidcbcfbijbhcgf	TRUE
eegc	TRUE
eebcifgcfhfeibecadjdj	TRUE
gjidgg	TRUE
eaeagfdegbhbbcfdjae	TRUE
cadbachghjacc	TRUE
ghfdeddgah	TRUE
ihibfjgghhicbihefjdajcife	TRUE
ieigjbjcdhgcd	TRUE
bhaidicheffieafeaijijfcj	TRUE
jbchdae	TRUE
ega	TRUE
dgcchjcbfjfcjihcigbbhhbf	TRUE
cjgji	TRUE
jegddhhicchidief	TRUE
be	TRUE
fccagehcgggegjajgijcehc	TRUE
deedhebijffbbjeaidc	TRUE
ihahe	TRUE
jbfedjbihjdjfcgbdejdj	TRUE
jjigdefeefijgdccjhc	TRUE
iebfif	TRUE
afjj	TRUE
cffjahgfeba	TRUE
diaa	TRUE
bdhfjejfgcedeadgehfhchhhi	TRUE
bcgaedjb	TRUE
hdjbfgb	TRUE
ffdhhbedhdcgheghf	TRUE
idjbfbjbebdd	TRUE
bj	TRUE
ibcgjhiadeeiceecjiggb	TRUE
hfajegdhggggccgagad	TRUE
cbeficfagjhfgjhgiiggibj	TRUE
jahdabfhhbfbeac	TRUE
dgfhjhbacb	TRUE
bagiiggdddjggiiehge	TRUE
igjeajhbccbgg	TRUE
gigjhfiagechgaafchega	TRUE
ac	TRUE
fejdeghf	TRUE
ahbcbajjfid	TRUE
gebhigfcchhe	TRUE
fighdhfafcic	TRUE
afhifibaegahdffehi	TRUE
ddihjhajihiejibbbbbjaa	FALSE
chiaaa	FALSE
gbeiadhdhbbbbbf	FALSE
bbbci	FALSE
bbbbiiajc	FALSE
aaa	FALSE
bbbjjaie	FALSE
cdbgifgebbbbijhabdfjacdej	FALSE
bbbb	FALSE
ficaiaaahcdjagjfadbafaaa	FALSE
bbbbifcccabicajjjaadfdjhf	FALSE
faaaabadfjgf	FALSE
aciecbbciaaaadfgajj	FALSE
fgaaa	FALSE
bbbab	FALSE
dfdbbbbb	FALSE
bbbecaddbjfdbcdfbfjggggd	FALSE
bahfgeaaaaabacicbd	FALSE
bbbjfhadjdaah	FALSE
igjdbgcfgdfaaaabd	FALSE
aaaacd	FALSE
baaaa	FALSE
dadiaebbbbcdhjcd	FALSE
bbbbfceeieadaefcihhfdjbj	FALSE
faaa	FALSE
bcdgfehabiaaa	FALSE
efihdheaaaa	FALSE
ffbgafjeediegiijaaa	FALSE
bbbf	FALSE
dgfeeaaaaeeegjjjjbddd	FALSE
fbbdicdjbceaaa	FALSE
dcgabiiaaa	FALSE
chhhaibbbb	FALSE
gaaa	FALSE
bbbgghjgachefgfga	FALSE
bbbdiehfce	FALSE
abbabaabbbbg	FALSE
bbbbbjhaggda	FALSE
bbbicdefabfhfi	FALSE
ibbjbejgahbajaaa	FALSE
jhgaaaa	FALSE
bcdihcjdahjdgiiaaaa	FALSE
bbbfgaghidegjjichid	FALSE
fdacbbbbddaaihicehigi	FALSE
gjhceagagjeciiafajdeaaa	FALSE
hjddccijahbfjcaaa	FALSE
fcfihhaaaajifdejhi	FALSE
bbbbb	FALSE
hibcdachcgbjahefaaaaehfdh	FALSE
bbbcdbcgcd	FALSE
bbbijgjidajbdcabfb	FALSE
bbbhceiah	FALSE
idbffjheafaeiecaaa	FALSE
ihaibbbbagj	FALSE
jgaigjeefjabbbbgibh	FALSE
jfadhfbaaaaaaheedjae	FALSE
bbbjdicjfahdhge	FALSE
jcfijgfeeiefeebbbb	FALSE
bbbajbh	FALSE
bbbbdh	FALSE
bbbicbidgjfhhge	FALSE
bbbbfdhafbbcehdii	FALSE
efjeggabbfagghhjgiaaa	FALSE
bbb	FALSE
ijabiaaaaaj	FALSE
egaaddgfgichaaa	FALSE
ceedjcdaaaajae	FALSE
heicfgajafhefgigfchjjhaaa	FALSE
ccfhbbbbhcfhiahjjhfgbage	FALSE
dgbigaaa	FALSE
gaaa	FALSE
accdhiafaaaa	FALSE
bbbaaac	FALSE
ejbaejfigbbbbfcic	FALSE
ecjgahieeccfibdfdhaaa	FALSE
jbbbbijidihjiaabagcfa	FALSE
fcbbbbdhcj	FALSE
aaa	FALSE
bbb	FALSE
bbbbhfajcbhjjff	FALSE
jgcdaaaaaijid	FALSE
aaa	FALSE
biebdjeeaijbdcgfhfbbebaaa	FALSE
eijgfjbbhaaa	FALSE
bbbjfigiciggfacbcibgc	FALSE
daieiaaa	FALSE
fhcibbbbb	FALSE
effdabbbbjaaaggbgggh	FALSE
aajbhdigchbbbbhdfcgei	FALSE
ebbjdbjhhiedcjcijhiaebbbb	FALSE
aaa	FALSE
hbdjafibcaaaaejeeajae	FALSE
bbbjjheh	FALSE
gbgciebcjbhbiejibfjaaa	FALSE
bbbaifdiagabedacffadabib	FALSE
ahbedigjbihaaaaahahfi	FALSE
aaaa	FALSE
aaa	FALSE
aaa	FALSE
eaaa	FALSE
bbbb	FALSE
hfegiechaaa	FALSE
bbbcc	FALSE
jggheicjgjbcbhcffaaaa	FALSE
febbbb	FALSE
aaa	FALSE
eaeaejieeebdaaaage	FALSE
bbbfbbaejhbdfjbffed	FALSE
bbbbdafabf	FALSE
iejcgfjcagcjfjadaciaaaagf	FALSE
bbbgfceagjjajhf	FALSE
gajhidhhdiaaccgghdfcaaa	FALSE
jedfefbgdijcfaaaacadeeh	FALSE
bbbejjjfeji	FALSE
bbbbeifdfd	FALSE
gefaaa	FALSE
ecfbcdhedbcaaa	FALSE
bbbbc	FALSE
bbbfaihfiebd	FALSE
hjccbghejhdeigbfcjfcaaaag	FALSE
aaaaecahaicbfedcghfgefgcf	FALSE
aaaa	FALSE
aaa	FALSE
gcheggagehaaedhaaa	FALSE
didcbbhjhbgbaaa	FALSE
cgbghaabaaa	FALSE
dgfcfdghajjaaa	FALSE
bbbgdgiibiafeffhcieie	FALSE
ahegbbbbbjhebeahjb	FALSE
gdfeaaaaeafb	FALSE
bbbbigcigbgi	FALSE
djjhhbagjfbbbbei	FALSE
ceajhhbghhbbbbb	FALSE
bbbjaajgjcbghajjee	FALSE
jhjdbbeadaaaaecfb	FALSE
aaa	FALSE
fcdhjaaaagcghccifdfcgb	FALSE
bbbaccajefdhjcdjfbedajc	FALSE
eaihhhbbbbaba	FALSE
dajbbbbcijca	FALSE
aaa	FALSE
eehbbbbbhiggcgeiebf	FALSE
ibjaaaahajcgcfbbdc	FALSE
abhaaaaejbbjfeijbdj	FALSE
bdcfdajhjjdjcceghaaa	FALSE
gjibbcebbbbhghabgjjec	FALSE
djjjcfgaaa	FALSE
bbbbfh	FALSE
dbbbb	FALSE
aaaaaaeei	FALSE
bbbicehfccdecdgcd	FALSE
iibbbbdbdeah	FALSE
eiibfaaaaagchacfdjb	FALSE
bbbhiegbgiddhjci	FALSE
deaaa	FALSE
bbbfacafdgjiadijaa	FALSE
dedaccdbcjifbbbbhjj	FALSE
fgigcdacahaaa	FALSE
hijdaaaacgg	FALSE
ebaaaahd	FALSE
aaa	FALSE
hjhigacaaaa	FALSE
jcbdfdigdifafaccjbehaaa	FALSE
dbfjhbdhffhfjijdhhgaaa	FALSE
aaa	FALSE
cfgjdbghbabbbb	FALSE
ababbbba	FALSE
jhggaaa	FALSE
jcijecaiebaaaacf	FALSE
gaciajaaaafifaggejefdbgd	FALSE
bbbdidgg	FALSE
bbbeihciahidjgjaefd	FALSE
aaaa	FALSE
ggbdffjghbccjcfcbbaaa	FALSE
gfeechaaa	FALSE
biaaaahege	FALSE
aaa	FALSE
aaa	FALSE
bbbcjdegjaccceaabjdfac	FALSE
ajbbbbehaaaefgc	FALSE
bbbiefabiejch	FALSE
aaa	FALSE
ahbgcfgaaaafafid	FALSE
ghaafefccacfbdcfjfjaeaaa	FALSE
bbbeiffggc	FALSE
chegfjejjjbbbbachjagacche	FALSE
bbbbi	FALSE
bbbbcd	FALSE
gaadaaaah	FALSE
aghjbdfgdjcgcdabbbbfh	FALSE
bbbhbffbhceeffaibhdefabf	FALSE
bbb	FALSE
dbdbcdahgccjfjfaaa	FALSE
chbbbefjcciahaaa	FALSE
cbegedhchaaaa	FALSE
bbbjbaddfhbadb	FALSE
jdfdedgdbaaa	FALSE
jhgcaaa	FALSE
bbb	FALSE
hbhfaaa	FALSE
bbbedfiafdgjcdcahhhh	FALSE
fhjfegccebbaaaajfhadfhd	FALSE
badbbbbhegca	FALSE
efdaijabiaaaadjafbee	FALSE
bbbaccccccgbddgffcgb	FALSE
dgaaaaafcdgb	FALSE
faaaaf	FALSE
bbb	FALSE
fgaaaa	FALSE
bgaaaaaddja	FALSE
bbbbjed	FALSE
bbbbe	FALSE
aaaaeihie	FALSE
dabbbb	FALSE
aaifhgibfbbbbhfif	FALSE
dahibgiedaaa	FALSE
bbbeg	FALSE
ehcgibbbbg	FALSE
aaaa	FALSE
aaaae	FALSE
dbbbbbcaafagjeiddc	FALSE
eaegdjcjfbbbbjice	FALSE
bbb	FALSE
jijdfaaaaif	FALSE
bbbbgeaddjd	FALSE
aaa	FALSE
daaaaceaabdgbb	FALSE
bbbhbjaaahggjfafcadjif	FALSE
hccdajbbdbdbbbbghfdedcif	FALSE
fagcaaaa	FALSE
bbbb	FALSE
bbbgccdbcceihjjfddgig	FALSE
hfhfjhbbfaaaaijajbaabjacd	FALSE
bbb	FALSE
jfjeaaaaffgigebaee	FALSE
bbbbfgehichjhichieg	FALSE
eddbggeadjgbhaaaahijcc	FALSE
gebdebbbbefdacccidbd	FALSE
efegjiedhbhahjheaaa	FALSE
jhacgdjjdccdfghihbbbbfjc	FALSE
bbbicgdejbdaiig	FALSE
chhdgfdichcbjhjhaaaaa	FALSE
bbb	FALSE
ahdedaaaaiihddij	FALSE
aaaajagfhgifaeaffaghdgh	FALSE
bfdedfbfacjhbaaaa	FALSE
bbb	FALSE
aaa	FALSE
bbbhcfgfagdaafhhjjhgdefje	FALSE
idbgaaaafbe	FALSE
bbbghaihdaiahgigeeiichce	FALSE
afhbhbhidhbbbbbjefjgg	FALSE
aaa	FALSE
bbbafaadejhjfcbgbigehha	FALSE
bbb	FALSE
hdeicbbbb	FALSE
bbbhg	FALSE
dehgicdhjahgbfggaaa	FALSE
bbb	FALSE
agfbgjgebbbbfgah	FALSE
bbb	FALSE
bbbaabbd	FALSE
gidhiccigggaaaaabjgd	FALSE
hdcidcfdajcgaefcheijaaa	FALSE
efcbbbb	FALSE
bbbiahhgchdcjfffhchigb	FALSE
bbbhedijdbaefghdbefhbcafh	FALSE
bbbbbif	FALSE
chiaegafgbbbbbhcgdj	FALSE
bbbijgbbacjbjjeggfccb	FALSE
aaa	FALSE
abehaajeadffcgcehabbbbdd	FALSE
ihajcaaa	FALSE
jhbjfdahhgaaa	FALSE
bfgjfgiedaaa	FALSE
aaaa	FALSE
bffdfjfbbbbaebccjfeghgj	FALSE
bbbeifegg	FALSE
bbbbjh	FALSE
haaaabdge	FALSE
ajbaedgcggaaaa	FALSE
gighbbbbfjeege	FALSE
fhfchgebfddbceigedejfaaa	FALSE
hiejhgbdgaaa	FALSE
aaaaahfbdcibgabjffbehb	FALSE
bbbafehie	FALSE
bbbgffafdfbchcc	FALSE
bbb	FALSE
dbejbgidbbbba	FALSE
gaaaa	FALSE
fhhaigbjcghceciheaaa	FALSE
bbbijdgiai	FALSE
bbbigeigjjjdaj	FALSE
ccefjehcaaa	FALSE
bbbeajgbcjhigaeficiecbea	FALSE
bbbbhdf	FALSE
bbb	FALSE
hgaihhfaaa	FALSE
eghcccbheaiagbgaaa	FALSE
bbbcbab	FALSE
ifggifebcigjaaaa	FALSE
bffgchbgfdaagafjdaaa	FALSE
ebiecdceghdiaaa	FALSE
hegdiaaaaaedeeg	FALSE
bhcfaaaabfhcfciifdib	FALSE
ehcbdcebbbbfbafiebii	FALSE
aaaac	FALSE
adfbbajfbhadbbaaa	FALSE
hhiehaaaacebici	FALSE
iaaa	FALSE
hbbbbh	FALSE
igbechjcabfheiahijfbfdaaa	FALSE
bbbcdgaegahbggcbhegggjb	FALSE
bbb	FALSE
dciaaa	FALSE
bbbde	FALSE
hbiahgbcffdaiiebjaaaafb	FALSE
giceaeegjacdefdhabbbbc	FALSE
aaaafbbg	FALSE
biejaaa	FALSE
aaa	FALSE
ahabbbbcii	FALSE
bbb	FALSE
dichhhfcdbbbbfeihi	FALSE
cdjdddcedbbbbc	FALSE
aaa	FALSE
ajhajfajijbaaa	FALSE
bbb	FALSE
afgjahdgchbjbbeijgbhaaaa	FALSE
bbbchhcjdagjejaebfhbdji	FALSE
jcfigdbbbbfci	FALSE
ccdjiiddaiiaefaaa	FALSE
bbbifihdiaiacjhb	FALSE
bbbbbfbafdgcgbggighigbbc	FALSE
gbahhfhihfgdbibaijaaa	FALSE
bbb	FALSE
djiahhfiabbbbaji	FALSE
beicajgbdiajeaaa	FALSE
ghfgaedhgcdaegaaa	FALSE
abaaaa	FALSE
cidgahdbafecieadddchacaaa	FALSE
aaaajjjbec	FALSE
fgccfgbcaeccgbeibbbbga	FALSE
bbbadcbhhgghecjacahedce	FALSE
cbbbbd	FALSE
jaaaa	FALSE
bbbbbdibhgac	FALSE
bbbchgea	FALSE
eiehgdjjhibaaa	FALSE
ccidgdaaa	FALSE
gchjagggdgebeaaa	FALSE
hdjhaaa	FALSE
bbbjeiacfgd	FALSE
dhfaaaajdjccjhfga	FALSE
bbbfcdhgihejh	FALSE
bbbfhdeddfiege	FALSE
bhhbbbbbfbaiebdiba	FALSE
hahfaaa	FALSE
icacbhaeigbaaa	FALSE
jjehbigfjjjceagbbbbadj	FALSE
ihhdgiehgjfagecdhfdcjaaa	FALSE
hfhbjdhjibbbbgegi	FALSE
ejigjaihibjihihiaiebaaaae	FALSE
haaaaccibjahj	FALSE
aaafejbdcbcbaddgaaa	FALSE
bbbicffhabachfbhd	FALSE
bbbefied	FALSE
jeidebbbbbidafdi	FALSE
ijgaacegaaaaddbcbfcfbj	FALSE
jffddgajaaaa	FALSE
chijbdcgdffbbhjhaffaaa	FALSE
bbbg	FALSE
bbbdijgcigajefhcegaabfad	FALSE
bbbj	FALSE
giheeaaeaaa	FALSE
ejfdjbacdbbbbbeigbbjbbc	FALSE
bbbffe	FALSE
cbbbbia	FALSE
bbb	FALSE
bbbjahifjefiabgbgdbei	FALSE
diijaaaab	FALSE
aaa	FALSE
bhhhbaaa	FALSE
gfhdbiegdehehiaaa	FALSE
bbb	FALSE
bbbibehbcafdadf	FALSE
bbbddabaedibiefbigia	FALSE
iihijbbbbgaceaiadbf	FALSE
eaaa	FALSE
dddieccbfcagdaaa	FALSE
idcbijeaaaaehiijgeccfbaa	FALSE
bbbicadghdjafacce	FALSE
bbbddddgaf	FALSE
bbbecchicjcd	FALSE
ffcbehjdijicaaa	FALSE
cbaihaaa	FALSE
jeehbbbbjh	FALSE
fjfabbbb	FALSE
bbbggfifh	FALSE
aaa	FALSE
bbbceijfehgddcigeejcjij	FALSE
bbbhfjjabdfdajfegbhaggd	FALSE
bbbafdafjccbjcddgf	FALSE
egdbbbbbfc	FALSE
bebbbbe	FALSE
gaaa	FALSE
bbbejhfafdgdgejg	FALSE
bbbajcbhb	FALSE
bbbajhebcgjb	FALSE
aaa	FALSE
fdhdhibjghbbbbhjfgbb	FALSE
bbbcahgbgjhhbdh	FALSE
dicaaa	FALSE
aaaaj	FALSE
dcagihbbbbi	FALSE
ggbbbbiihgjbigbhbijiefc	FALSE
bbbifhbbibdafaeahebjahhe	FALSE
bbjeajbedhihjgaaaahegdigj	FALSE
bbbjdiijgdd	FALSE
agfaiaaa	FALSE
bhhjicbadcadbbefchidaaa	FALSE
bbb	FALSE
cegfbacbaaaai	FALSE
aaa	FALSE
affchahceaaaagifjdafjhddb	FALSE
acdeiebbbbdhccgaiedfjg	FALSE
jbcdjhgeeidiehhgjaaa	FALSE
bbbbbfc	FALSE
bbb	FALSE
gihcecaaa	FALSE
bbbahbafefeda	FALSE
bbbggehbeabgfciihjg	FALSE
cbbbbde	FALSE
aaaa	FALSE
jfbddficjcbbbbi	FALSE
fjedeigcdiaedbiicieejaaaa	FALSE
bfgicbdjdjbdfddaaa	FALSE
bbbjadbh	FALSE
aaa	FALSE
bbb	FALSE
bbbbbae	FALSE
ifjiihdibhhajjabjihaaa	FALSE
bbbfec	FALSE
ccfhificihehghbbbbfhdh	FALSE
gaaahdccbhigaaa	FALSE
bbbhjaajjjc	FALSE
bbbheiejbcfbcajajaei	FALSE
bbbadgiahghjii	FALSE
hbgfcdaaaahfgfihbiheac	FALSE
hbgdiaaaaa	FALSE
bbbffaaecgc	FALSE
jfdgeeebbbbje	FALSE
dgaaaah	FALSE
bbb	FALSE
bbb	FALSE
deaiaaaaicajeab	FALSE
decibbbbhejbceidbhgheb	FALSE
aaa	FALSE
dbifheaaaaadd	FALSE
hfdgjbbfaaaaj	FALSE
cdcgiijhddgcbagbdaaa	FALSE
bbb	FALSE
bbbaidgaacafjiefeca	FALSE
fgihchibjfaaaahffj	FALSE
gggchcjajefdagccbhciaaa	FALSE
aaa	FALSE
bbbfecihedcjbhedacde	FALSE
aaa	FALSE
bbbighffjcbfggbghbebgjfce	FALSE
aaaadfjae	FALSE
bbb	FALSE
baaaaahfjabff	FALSE
geaaaadbjg	FALSE
iiejggbcheifhjaaa	FALSE
bbb	FALSE
baaa	FALSE
cjbaaa	FALSE
eajbbbbijdigdh	FALSE
bbbbj	FALSE
bbbbbgiefihig	FALSE
ffdaaa	FALSE
dcgiehejdhaaa	FALSE
bfcbabbbbfjbfgaf	FALSE
bghfejejbacfeaaa	FALSE
aaaadgjgigcibgija	FALSE
bbb	FALSE
dgejdhbdbdibbaaa	FALSE
edbcfbdjccggdcaggaaa	FALSE
gcaaaaaij	FALSE
bbbefadg	FALSE
higfcahfdahjebfeaaaa	FALSE
iffbagebbbb	FALSE
dcaihjhddfehbcaaaafigd	FALSE
jiaaaaaed	FALSE
bbb	FALSE
ibabbbbhdheidd	FALSE
bbbjiehggejdbe	FALSE
bbbedahjaabgcbiebab	FALSE
jdccchaaa	FALSE
aaa	FALSE
