cbcbcbdcbacaadcacaa	TRUE
bbcbadadddaddccadcccccca	TRUE
daacdcaa	TRUE
aa	TRUE
adddcadddaaccaacd	TRUE
bcbbcaadaddaadddaaacdcaac	TRUE
bddcccbdccbddaccaadacacdc	TRUE
caacccdc	TRUE
dcbbdbbbaddaccdddccc	TRUE
dbdaa	TRUE
bcbacda	TRUE
aaaaccadcadaddcaaaacaac	TRUE
cbadaacaddccaadcdadcc	TRUE
bdbddccbccd	TRUE
caacd	TRUE
ddddcccbbdcbcddadc	TRUE
ddddaddcacad	TRUE
bcccdddcccbcaadadc	TRUE
badadcdcaac	TRUE
caddda	TRUE
bbdaccaadccadcccaddaca	TRUE
baadaadcccdcaacacaadcaddd	TRUE
baccddddaaaaddddaaa	TRUE
bbbbbdcc	TRUE
daddcccadccc	TRUE
cdbcdddbdccba	TRUE
adacdad	TRUE
cbdaa	TRUE
baadcaddcacdaaacadccacad	TRUE
dccddcbdbc	TRUE
aaddcaaddcaccdcdac	TRUE
adccdddcdccddccaddddccc	TRUE
acddacaaadcd	TRUE
bacadadaadccaacadaadaca	TRUE
caccdccadccaa	TRUE
acccdacadc	TRUE
bbcdbcdbbaa	TRUE
aacdaddcaddc	TRUE
bcbdaacddd	TRUE
acadadcaadadcccc	TRUE
cc	TRUE
bbdacccddaaacc	TRUE
ddbca	TRUE
baacaa	TRUE
dccbdbbcaa	TRUE
bcaaaddd	TRUE
bcaacdccccccccaadacda	TRUE
badac	TRUE
ac	TRUE
adacdcddaddddddacdcdaccac	TRUE
accdc	TRUE
cdcbcaddcdc	TRUE
aaadaacaddadaaddddc	TRUE
aaddacddaaddc	TRUE
cddccdccaddcdaadc	TRUE
acacaddacdcaaddaddcaada	TRUE
dacdca	TRUE
bccbddadadacada	TRUE
addacaaccadacacc	TRUE
aacadcdcdcdcadccadccac	TRUE
cacdacddadadacdacddccada	TRUE
dbbbdadad	TRUE
bbbcbdbcdacca	TRUE
caccca	TRUE
acddd	TRUE
cacddaaaadddddcacccacdc	TRUE
bdcbbbcccaddddadcd	TRUE
accacadacddaadddddcaacdaa	TRUE
dbcc	TRUE
bbcdcdbaaccdcacddc	TRUE
acaca	TRUE
bbaaccda	TRUE
adddcdcdcaaaacacacad	TRUE
aadccdcaadddaadacaaadacd	TRUE
dddba	TRUE
bb	TRUE
caddacddccdcddcacacadaada	TRUE
daccadaaaaaaaadccaccd	TRUE
cbaaddddaaaadaaacccac	TRUE
aadddcccaaccdaac	TRUE
cbcdaacdaacca	TRUE
cddaddddddccdadaddadcc	TRUE
adcdccdddacddadcd	TRUE
aaad	TRUE
dddddbddcdacdcacaaaadad	TRUE
cbbddadddc	TRUE
cc	TRUE
dcdbadaca	TRUE
bbdddaccdcccddcdadda	TRUE
cddcbbdddbddaaccccacccad	TRUE
cccadccaaacdaadada	TRUE
dcadccaadca	TRUE
acdddcaaccdaaacccadda	TRUE
aaaadccacdacac	TRUE
dcdcdadcccaaddccccdaa	TRUE
acdaddaddadccaaddcc	TRUE
cdacacd	TRUE
baadddaadccdcccdacdcdd	TRUE
accdccdaaacdccccc	TRUE
bbacddadadcadcacdcccdcdc	TRUE
dbb	TRUE
ccddacccd	TRUE
ccbacacdccdaacaacc	TRUE
ddd	TRUE
bbcdadcaddccacacac	TRUE
daacdaaaddccaadcadaa	TRUE
ccacccadcd	TRUE
caacaaccdadaadddcaaaad	TRUE
a	TRUE
dddbadcadca	TRUE
dca	TRUE
bcadccdcadccaaadddaacdcd	TRUE
ccb	TRUE
caadcddaaacadcccc	TRUE
dbdadcccddcadcdc	TRUE
dacacdddccacdadddcadadcaa	TRUE
cadadcadddcacd	TRUE
ccaaacddcaddaacacdcaad	TRUE
bbdaaddddcccc	TRUE
bcacdcaacdaacccaaddd	TRUE
bcdcbbaddadcac	TRUE
ccaaccdccd	TRUE
d	TRUE
ddadccddddcaaddddaadc	TRUE
bccddaaacaacd	TRUE
dbcbdcdbcbbadaddaaac	TRUE
daacadcdacad	TRUE
c	TRUE
dbddcac	TRUE
adad	TRUE
baadaaccc	TRUE
ccaaacaacdaacddaadad	TRUE
baccdcccadccddcadaaadd	TRUE
bbcccdbadaddcaddccddcadc	TRUE
adccaaacacddddddcccca	TRUE
aacddcacd	TRUE
aaccaadd	TRUE
d	TRUE
ccbdbdbdbc	TRUE
bbaacdacccdaaaa	TRUE
dadcaadaacaa	TRUE
dcc	TRUE
acaaacadcc	TRUE
daaaddddacad	TRUE
bcacaaacddcddcdddadadad	TRUE
addadccc	TRUE
daaadddddcacdcddd	TRUE
adddacddccdddcdcaca	TRUE
d	TRUE
bcb	TRUE
baacddd	TRUE
c	TRUE
bddaddddccaaddcdaadcaaaa	TRUE
aaddcaaccaada	TRUE
cdbc	TRUE
aaacc	TRUE
adadaaadaacaaddcacacc	TRUE
bdcacccaacc	TRUE
dbbcccbdccbbdd	TRUE
bcddbdd	TRUE
bddbcaccadddddacacaaaccad	TRUE
a	TRUE
cdaa	TRUE
db	TRUE
bccddccdaa	TRUE
dbddd	TRUE
acaddcccadccadcacacddcccd	TRUE
daaddddcaadd	TRUE
dbbccdcdddadaacccccca	TRUE
acddaccc	TRUE
da	TRUE
dbaacdcaccaadcacdd	TRUE
dbdcccdacadacac	TRUE
dcccccadcaddadddccdccacc	TRUE
aaddaac	TRUE
cbcccbdbbcbaaaacaa	TRUE
dbadaaaaacdcada	TRUE
cadcccaaadd	TRUE
acadccacdacadcddca	TRUE
bbdc	TRUE
cacaacdd	TRUE
bccaacaaaddccd	TRUE
bbaacccaadcdccdcdcdaadad	TRUE
baaaccacc	TRUE
ccaacacacc	TRUE
ddcacdddaadaacdc	TRUE
adadcaaccccdaddaddaadda	TRUE
dadacda	TRUE
dbdaccadaaadcdcd	TRUE
dbaacdddcddcddacacddcda	TRUE
acdadacdacaca	TRUE
acaaaadcaaaccadd	TRUE
acdd	TRUE
aacddcdcdcdaacdcacaddcdad	TRUE
bbdaaccccccc	TRUE
dcdbcacda	TRUE
bcbdccacdcdcdcddaaddac	TRUE
baacc	TRUE
adcdcdaca	TRUE
cbcbbacd	TRUE
accdaaaaada	TRUE
ac	TRUE
aacdadadaddacacdc	TRUE
adadcacaacadcdacadc	TRUE
bbbbbac	TRUE
b	TRUE
acdcddda	TRUE
aacdcdacdcadcdadadca	TRUE
bcbd	TRUE
ca	TRUE
ddcddbbbbdcdacacddadcd	TRUE
daadcdcaaadadddccadcdcccd	TRUE
adaccdcaddd	TRUE
bbcadaccaaacaacddc	TRUE
bcaadcccccacddaacccad	TRUE
ddda	TRUE
dc	TRUE
ddadacddaaddadaca	TRUE
bd	TRUE
bcbbd	TRUE
badcaca	TRUE
adaddacdaccaadaaaaa	TRUE
cbdbadcaaccddadadddcd	TRUE
adcdaaaadc	TRUE
dcacdddaaaa	TRUE
d	TRUE
bdccbaddddddcdac	TRUE
aaaaaccacacd	TRUE
bbaccc	TRUE
accadddcdcddccc	TRUE
aad	TRUE
bddacdddddcccdaddaa	TRUE
dcbbdbbdccaa	TRUE
bbbbddadcca	TRUE
acdacddddadaaaacaaaddddda	TRUE
acacdcacdaadadddd	TRUE
cddbbdaaccacccdcaaccaadaa	TRUE
cccaadcddcdadcddcaddc	TRUE
cbbbadddaaacdccda	TRUE
bdcacaaaaaaacdccacaacdccc	TRUE
bcbadac	TRUE
adcacccdddcccdcdaadccdcac	TRUE
aac	TRUE
dbbcbcbaccaaaadcddda	TRUE
caccdaacdddccdcacacdaca	TRUE
da	TRUE
dcdadcaadcccdadacaaac	TRUE
cacdcddccacaddacaada	TRUE
db	TRUE
dccbcacadaadcaada	TRUE
daaa	TRUE
dcbddaccdacdadddaa	TRUE
caaaaaaaadcadcacadc	TRUE
aaaaa	TRUE
aacdccaddaccdddcad	TRUE
dbccccdcac	TRUE
ccacacccdada	TRUE
adcdadacdc	TRUE
bbaddaccccddadcada	TRUE
ddbbbcbaacacddccdadca	TRUE
addcdcaadda	TRUE
dcbbaac	TRUE
aaaaccacaaacda	TRUE
adac	TRUE
acacaaddacdacaccc	TRUE
dddbcdacaacacdcaacccc	TRUE
adadcac	TRUE
c	TRUE
addccacadaacadacccc	TRUE
aadddd	TRUE
baacaadadcadcddddddaada	TRUE
caaadaadcadaac	TRUE
cbcdac	TRUE
dadcddcaadadd	TRUE
daaccaaccdccdca	TRUE
dbadcdcddccccacdcd	TRUE
dddcaaaaaaddaacdcc	TRUE
dcadaa	TRUE
bdbdbbbdcbccdadd	TRUE
caddcccaacdcaadc	TRUE
dccbcddca	TRUE
bdbcaadcdacadaaaddc	TRUE
daacaaacadaadd	TRUE
bdbacccaadccdcd	TRUE
ddaaad	TRUE
bbaaccacddaa	TRUE
ccd	TRUE
daacdcadac	TRUE
bbbccccadcaa	TRUE
bacdcadadacadaaddcdd	TRUE
adccadaaacdddacadadd	TRUE
dcdbacdddadaddcaddacdd	TRUE
cbadccdddcac	TRUE
badcddddcadcccdda	TRUE
dbd	TRUE
adcdccaadacdddaaadaaacd	TRUE
dacadcdadd	TRUE
bdbacddddacdac	TRUE
ccbcdcccdcddcbaa	TRUE
cbaacddadacdcddadddcca	TRUE
bcacadadacacd	TRUE
acaacacdacddccaaad	TRUE
c	TRUE
dcad	TRUE
aacdcdaacdc	TRUE
ddbadcdcaaccdd	TRUE
dadcaddacccacccaddadaaaa	TRUE
dbaccddaaacdcccacacdadcd	TRUE
dcaacccccddcdd	TRUE
a	TRUE
adcaaddc	TRUE
bbbcbdbbdcaadd	TRUE
adccddccaaaaccdaddaadaaad	TRUE
ccacadddadaaccadcccdaa	TRUE
aaaaaadcdaada	TRUE
dd	TRUE
bdcddbadcadaada	TRUE
dddbd	TRUE
acac	TRUE
bcdaddda	TRUE
dcdbad	TRUE
cadcd	TRUE
dccacddaacca	TRUE
cddaaadccdacccdcccaa	TRUE
daaadacadddcaaa	TRUE
aaaacaaccdddaaac	TRUE
cccb	TRUE
aaddcdadddc	TRUE
acdaadcccccccad	TRUE
cbbddc	TRUE
caad	TRUE
dccdadadc	TRUE
dadaaadddcdddccd	TRUE
adacdacdacccc	TRUE
dcaaaacacacc	TRUE
bcaaddcac	TRUE
dcaaccaaddd	TRUE
bacdadaaaaaaadaa	TRUE
daaccaddcadaaac	TRUE
ccdbdbbcbcccbbbbacadcca	TRUE
ddccdddcdaaacaddddaaccdc	TRUE
badaaddc	TRUE
ccccaacdaacacad	TRUE
cbddbaccdcdaaadcaaaaadd	TRUE
bdbaaaddadccdcca	TRUE
ddbcccdcddacdccaacccacdac	TRUE
dcbaaddcdacd	TRUE
dd	TRUE
aadadadaadcacac	TRUE
bdc	TRUE
adadaaacaaaaccaacdddca	TRUE
dcaccadddddcacaad	TRUE
aaaaaddadaa	TRUE
dada	TRUE
adaadaddccdcacdddcdaa	TRUE
acacdccacaadacddcdcc	TRUE
cadaaaacd	TRUE
cadddacacddadccaca	TRUE
cbacdaaccadaaaacddaaaadca	TRUE
aacccac	TRUE
baacccddc	TRUE
bccdaddddacacd	TRUE
dbdbdbbc	TRUE
cacccdacd	TRUE
dacdaddcdaccacacdccccadc	TRUE
adccdaacaccddaa	TRUE
bdcbcbadcccaaddacaccaddcc	TRUE
c	TRUE
cbcaca	TRUE
dadcddcaccadd	TRUE
cbacccdad	TRUE
cdbc	TRUE
cba	TRUE
ac	TRUE
ddbda	TRUE
acdaadcdacdccdcacccd	TRUE
aaa	TRUE
cbbccaccdaaacdddcdc	TRUE
caaaaad	TRUE
ccaa	TRUE
baaadadacacdd	TRUE
acaacaacaddcc	TRUE
ccdcddaadccddcddcd	TRUE
dadcccc	TRUE
cbaccc	TRUE
bbbad	TRUE
dbdacaccaaddccdadccaddd	TRUE
dbcddd	TRUE
cbcddbdadccd	TRUE
dcadddccd	TRUE
dcdbdadccddddaadcac	TRUE
dbbcccbbbacdcdd	TRUE
bbdcacacdddcadcddcccdac	TRUE
aacddacdcc	TRUE
bccdcca	TRUE
dddc	TRUE
dadddadaddaccaddddac	TRUE
bbdacccacddcaadd	TRUE
bcbad	TRUE
cdbacccacaaaaadacaccacd	TRUE
daacc	TRUE
daaaccccdadad	TRUE
caacdacadcaaadd	TRUE
cacddcdaa	TRUE
ddbddac	TRUE
dbacccac	TRUE
dbdcbbbbdbaacacaadd	TRUE
bcaddcdcdaacaa	TRUE
adcdccdca	TRUE
dcacaadadac	TRUE
cdaadadaaaacaada	TRUE
dcdbbaadadcccdcaaacd	TRUE
daacaacdaaccaddaacaddddd	TRUE
bbbcacacdadccdac	TRUE
aaaacaa	TRUE
aaddacddcddcaad	TRUE
aaddca	TRUE
cdadcdaaadaddcddd	TRUE
daccdcacdcccdccadacaad	TRUE
bbcacddcaacadcdaaddaccd	TRUE
bbbbdaadcadcadc	TRUE
bbcbdbcadaacaccccca	TRUE
adcadcdcadccacca	TRUE
dac	TRUE
acddddaadcacd	TRUE
cdddddcaddcadacdddcaad	TRUE
aacaccdcdcccdaaaa	TRUE
dbcddb	TRUE
cddaacccadaaccdad	TRUE
db	TRUE
addccaaaaccccadaa	TRUE
cdaccdcccddadacaaadcaddc	TRUE
bcadcacccaddaaadacd	TRUE
bbcccdcacdaaaddadddacc	TRUE
c	TRUE
dcaacacdd	TRUE
cadcac	TRUE
bccdbc	TRUE
dc	TRUE
cccdcbbccc	TRUE
bdbbdcdbdad	TRUE
aadaadcadd	TRUE
badaacadcadaada	TRUE
adadaaaaacdcddcd	TRUE
bbc	TRUE
bbbaacacadddcacadcaadc	TRUE
adacddddacdcdaadcdddd	TRUE
baaacadaaaddddcdaaacac	TRUE
bdcbaaaaccacccdcdcda	TRUE
a	TRUE
ac	TRUE
dcdbdccadaacd	TRUE
cdcbbb	TRUE
db	TRUE
aaaacddcddadaacdaaad	TRUE
bbadadccdacdcddddda	TRUE
a	TRUE
cdcbcbcb	TRUE
cbbcadccaddaaac	TRUE
ddddcdbcbccc	TRUE
cbcaadacadacad	TRUE
ccdadacccd	TRUE
dacacdda	TRUE
cdb	TRUE
cdadccaaacccaaccddaac	TRUE
ddcdcaacdcadcdaacdc	TRUE
ada	TRUE
cacaadadacdadccdcccdaaacc	TRUE
ddddcdbbadaacc	TRUE
acdccd	TRUE
bbdbadadcaacd	TRUE
adadacdcddddcd	TRUE
adccccdcaaddaa	TRUE
baaacaacaaacdcaccdacd	TRUE
d	TRUE
dbadaacaadacadaaddadaacd	TRUE
c	TRUE
aadcdacacacdaaaddcdacadc	TRUE
bdcbdcaca	TRUE
dcbdbbdbadaadcccaac	TRUE
dddaccacaccacacaccacaccd	TRUE
bcdadccdcadcdc	TRUE
aaaadaa	TRUE
ccdbcbadcad	TRUE
b	TRUE
addcacaa	TRUE
ddbcdccc	TRUE
dbaa	TRUE
bbdaadcaddaddcdcdadaad	TRUE
badacdccaaaadaacccd	TRUE
adacaadacacacdcaacddadc	TRUE
ccd	TRUE
cdacaacdcddddccdc	TRUE
a	TRUE
acddcaaaadaacdaddddaccd	TRUE
bbdcdcaddccdccacacaa	TRUE
dda	TRUE
cbc	TRUE
caacaddcacacddccdcadad	TRUE
adccdcccdccdccdaa	TRUE
bbacaadabdbabbcbbcbbab	FALSE
cdadacdcbabcbcbdbccb	FALSE
bbdacbb	FALSE
acbb	FALSE
baabd	FALSE
cbdbaabbaadadcdddadcb	FALSE
adaaabbbbcdcddac	FALSE
cabc	FALSE
dbaabbbbdbdacbcbbbccacba	FALSE
ccbadbadaabbaaccbbdbb	FALSE
accbbdaaddacccacabb	FALSE
dabdac	FALSE
ddcabdbdda	FALSE
bbddaaaadbca	FALSE
adcddcababdbdaaaacddb	FALSE
cacabcbaabdbdbb	FALSE
aabbdadab	FALSE
dcabbbccabcbbcaadbdc	FALSE
dbbdcbbaadbadbbdaac	FALSE
dbcdaddcabcbcaabdcbc	FALSE
cddbabddbababbcbccccbcca	FALSE
aadbbcda	FALSE
cbdbabdcaddccdaadabcdab	FALSE
aadcbddabdbaaaddbdcbb	FALSE
cdbadcddabddc	FALSE
abadadcabbcdd	FALSE
acddbcaaadbdaddbacaddbdcc	FALSE
abccddccbbbddccbadc	FALSE
aaacabd	FALSE
adb	FALSE
cdacb	FALSE
dabdaacccdbc	FALSE
babcd	FALSE
bacdbcbb	FALSE
dddaababc	FALSE
abc	FALSE
aabd	FALSE
cdbaadabdcbbabbd	FALSE
abcccadbbbdacd	FALSE
acccbcadddaabd	FALSE
dcdcdacbbaaaa	FALSE
aadabdb	FALSE
adddbcaacbab	FALSE
dbaacbbdcbaadbba	FALSE
caacdcaadbdbbdbb	FALSE
dbaadbbcbaaab	FALSE
bcdacdbc	FALSE
abaabbddccbaabbdaabbccdcd	FALSE
adcbabdbabc	FALSE
cab	FALSE
baaacbbcbdbbcdbbbcbbdabbc	FALSE
cdaaddaabaabbbbcccdadabd	FALSE
acbdbbd	FALSE
cab	FALSE
bbadacbbbdbcbdba	FALSE
bcdbccbbcbdbddaabc	FALSE
abaccbdbadbcbbb	FALSE
aacdcbdcbcadbbc	FALSE
ccabb	FALSE
bbadadadcdaabbbcdbacbc	FALSE
bacabcdb	FALSE
bcbcbcaabbb	FALSE
ab	FALSE
baaadabab	FALSE
caccdbaabccbbddccc	FALSE
dabddccacbcabbaca	FALSE
ddaabdcd	FALSE
aacbbbcca	FALSE
caaadddba	FALSE
badb	FALSE
abab	FALSE
daaadbcbb	FALSE
ccacaacaccdbababdbddd	FALSE
dcaabcaddcdbdbdab	FALSE
abcaadcacabbaccbddbddbcbb	FALSE
daddcaabacbbbbadc	FALSE
ab	FALSE
cbabccdba	FALSE
bdcdaacdcbccdcabb	FALSE
aaccdacaaccccbd	FALSE
ab	FALSE
dcabcbacacdbbdac	FALSE
cabaabbabccaabaaa	FALSE
dbabba	FALSE
bcdbbacaababbcbb	FALSE
adaacdaababca	FALSE
abbbbbc	FALSE
dcaabacbb	FALSE
adbadbbabcbbbcccc	FALSE
daacdab	FALSE
cabbcdadbbdbdbcc	FALSE
daacdbaddaaacbcccadba	FALSE
bcdbaddbaadcbbbabcc	FALSE
dcaaddbccab	FALSE
aadcbabbdbaddaccbbbbb	FALSE
dbaaccdabda	FALSE
cacbaccbda	FALSE
bcaaabcddcacdaaacbbbba	FALSE
dacabbdcdcbbaabdbbd	FALSE
cdadddbaacbbd	FALSE
daaabaaddabccc	FALSE
aab	FALSE
cbdabbcccaadcbdadd	FALSE
bbccbacadcbcabcbabcdbcb	FALSE
aacacbddbdabcaddba	FALSE
dccacb	FALSE
aaba	FALSE
dacbcdadb	FALSE
ab	FALSE
ab	FALSE
ab	FALSE
dbdacabccbbadbda	FALSE
baaabdb	FALSE
abcadbaabadabaab	FALSE
dabbdbadab	FALSE
aabb	FALSE
dcbabbaaacbdbddcdaca	FALSE
cabdcbdd	FALSE
caaaaabbbbd	FALSE
abcbaddadcabdbdcbb	FALSE
aaaacb	FALSE
adbdabdcabdccddbbddaba	FALSE
aab	FALSE
bdcbccadabbacdcdabddbac	FALSE
cacbcabaacddcb	FALSE
dbacbdbdddddbacdbabbacccb	FALSE
caacbaccbbcad	FALSE
dccacabcdccbbbbb	FALSE
bddddcaacbcacdbdbbabdcbac	FALSE
dacaacdacabdcbaccaa	FALSE
dbbacbc	FALSE
ddacbabbbb	FALSE
babdcbbbb	FALSE
baacbb	FALSE
dbaabbdccbdadcbcab	FALSE
adcbd	FALSE
abdaabc	FALSE
cbcabdcdbdcadcdbccdb	FALSE
cadcdcddbdbcccabbaaccabb	FALSE
acabcdaacbccabcc	FALSE
caacbbccaabaabb	FALSE
cabccccabcddbadaaccc	FALSE
adacbdbbbbbdddadcaabcac	FALSE
abddcbbabcbaabdbc	FALSE
ccacacbddbacddbdddbaaa	FALSE
aaaaadaddbdbaabbacaaaada	FALSE
caddcacbbccbcdbacdba	FALSE
dccdcaacbdaadababccabdb	FALSE
dbbaaadcabbdbdababbdbc	FALSE
dbbdcbcccacacbbdb	FALSE
abbabcbc	FALSE
babbccabbbcaaccbbbabdddd	FALSE
abbb	FALSE
babcdbabcdd	FALSE
aadbbacbcdaca	FALSE
abdb	FALSE
ab	FALSE
aabaaabcbcbadabada	FALSE
abbbccb	FALSE
acdabbcbc	FALSE
bdadadadaabbbc	FALSE
abdbaa	FALSE
ddadcba	FALSE
daabccacaa	FALSE
aabbbccbadb	FALSE
abbaacbadbccababc	FALSE
bcabcaabdddbaddaddaa	FALSE
ab	FALSE
ddacb	FALSE
bdbdaccacddab	FALSE
bacabbccadbb	FALSE
aacdbadddbcbbbdcd	FALSE
abddcabd	FALSE
cabdbbccbdabcbcd	FALSE
aacccadccdabbbcdcd	FALSE
acadabadaddaaccdadbbbccca	FALSE
cadab	FALSE
cbadadcadbabbcacdac	FALSE
acddbdbbcaadaab	FALSE
ab	FALSE
daccbdbcaccac	FALSE
daaadccacabacbcad	FALSE
bbaababdddddbcaccddabcc	FALSE
daccacacaaabcbbabcbacca	FALSE
adbab	FALSE
dcaaccdbaccbccbabcdc	FALSE
cddbcdaabddab	FALSE
abc	FALSE
adcccadddddbcaacaddcabbbb	FALSE
dadbdacbadbc	FALSE
acbabacddddadcb	FALSE
cbcdabc	FALSE
ccdbaacabadcbacdbbac	FALSE
caacabdaabcbbbbdaca	FALSE
bcaabbab	FALSE
cdadbadbababaabdbcbc	FALSE
caddabba	FALSE
aaccaaddcccaabbbbdbcb	FALSE
bbdddbcacaadcaccbccdcdba	FALSE
dab	FALSE
cbaddaabbcbdc	FALSE
ddaabcadadaccdadabdc	FALSE
abdbba	FALSE
abda	FALSE
cdaabbcdccbbdbad	FALSE
caaacccbabcdcbbadb	FALSE
cdacbdabdabb	FALSE
acccadcbdcddcbdbaabaaaacd	FALSE
cccdaddabbbbcababbabb	FALSE
acb	FALSE
ccadaaadddbcabb	FALSE
dbaaba	FALSE
cbcaabccadcaccbbacbbcdbcb	FALSE
aadbcbacbddcdddcbaac	FALSE
abaaabadbabaadadbccdbcdcb	FALSE
bbdadbccb	FALSE
abb	FALSE
abc	FALSE
abaadcdacdccbcccaddbdab	FALSE
dcbccbaaacadbadbccaadad	FALSE
dacbbbdabdcddccbccb	FALSE
baba	FALSE
abbbabdcddabada	FALSE
aabb	FALSE
bcaacbac	FALSE
abdcdbaabdaccb	FALSE
bbccbcabbccacb	FALSE
babcadbbbb	FALSE
cacabdab	FALSE
daacabaabacbbbbaadaccac	FALSE
cbdaaddcdbadacdacadddbabd	FALSE
accdbcabccacbbcaabcbc	FALSE
dbcdbdddbacbccdbdcaabbcb	FALSE
adddaadbcccdcdbcdbd	FALSE
aadcbac	FALSE
aacbabcdbdcc	FALSE
babad	FALSE
bcccaaacabbbdcadadaddcdcd	FALSE
babdccbdbdbcbbddbddcbacab	FALSE
cdddccadbbbcdb	FALSE
dabccbdcdbabcbcadc	FALSE
abdcbacaaadbabbaa	FALSE
bbadcaabbab	FALSE
acadcbbbccddbcd	FALSE
aacbc	FALSE
ddbaaabdbddbdb	FALSE
dabddbabda	FALSE
aadabdbdabbabcddbaabd	FALSE
adbcbabbbaccbcd	FALSE
bcaaccbbbccbdad	FALSE
bddacaabcdaaaabaaabba	FALSE
dcddbddacba	FALSE
abaacbcdabbacd	FALSE
dcacaddadbddaacba	FALSE
addcdabbbcdca	FALSE
accbbabdadbdaaabcdabb	FALSE
dabbbdccdbbaacdbbaadcad	FALSE
cbcbbaabbdda	FALSE
adcdcacdadbabccd	FALSE
dbcdbdcbabc	FALSE
adddb	FALSE
ab	FALSE
adacbc	FALSE
bdbabbbbdacbddbbbdacad	FALSE
adbbaaacabbdbdbdcb	FALSE
ab	FALSE
abadbacabbccd	FALSE
ab	FALSE
baacbcbbacababaaabdbdcdb	FALSE
acdccbbab	FALSE
abbcb	FALSE
bcccbcdabbbc	FALSE
babcbacccab	FALSE
abbaaabaacdb	FALSE
aaabaaabc	FALSE
bcdacdddbd	FALSE
aba	FALSE
cdcaabbbcdccbcb	FALSE
acbcabddbbcccc	FALSE
abccaaccbb	FALSE
caabadbbbdbcc	FALSE
ab	FALSE
abaaab	FALSE
ddbdccccbbdabaabbbdccbcbd	FALSE
babcbcacaadbaaaabaab	FALSE
acdbcbbadbd	FALSE
baddcccbabcaabbd	FALSE
cbdacccbacbbbc	FALSE
abcdadbbad	FALSE
abcadcbbccadbbddc	FALSE
abb	FALSE
cddbbcdbadcacadcabadbb	FALSE
cabdccaaabbbcbdbabcbbcc	FALSE
baadba	FALSE
babcbabcbdad	FALSE
dddbaabdbbbdddda	FALSE
caabbdcaddaaabb	FALSE
caabacdcdddcbbaccb	FALSE
cddaabdacccdbba	FALSE
ddcbbcdcadbbbbbbadcdc	FALSE
bbcabadabccadabcbcabbbcd	FALSE
cdbaabcdddcabdbaccdcba	FALSE
cbaabcdcdaabadbcbabaacb	FALSE
dadadcaccbabacacadccca	FALSE
acabadddacbdddabacbdbb	FALSE
bdaaacbcdadccddcbdabdddc	FALSE
abbaabd	FALSE
dacb	FALSE
bdabbbabdbdcabbccdcca	FALSE
aaabccbca	FALSE
ddcdab	FALSE
aabddccdcabaaddadaabab	FALSE
bcccbacccbccabdbabdaccb	FALSE
aadb	FALSE
adbdaabcbbcdcadabbdaa	FALSE
abddcb	FALSE
dbadacdbb	FALSE
bcbabab	FALSE
ccabdcddbaa	FALSE
acaadbbbbbbcd	FALSE
daaddaabdbddbdabcdb	FALSE
acaabbcdcba	FALSE
abbbadbaaddcbccbabbcad	FALSE
adaacbaadb	FALSE
dbaaacadbd	FALSE
ab	FALSE
bdabddaaca	FALSE
badabdba	FALSE
daba	FALSE
baabb	FALSE
aab	FALSE
caadbacbdbcddbaadbddaca	FALSE
dddabbbbabcacadbcadadbdb	FALSE
accbadddcaa	FALSE
cdbacbd	FALSE
abac	FALSE
adaaadbaabdcbcaddaccbbda	FALSE
aadacababcdbabaacabdc	FALSE
acbcddddcadddcbcab	FALSE
bbdbdadabcdcbbcdcdab	FALSE
bcbacbcab	FALSE
abdcb	FALSE
ccddcaaababcbbabccbccac	FALSE
daccacbbbaabbbcbdbca	FALSE
adcadadbbb	FALSE
dbbabbabdaacbdabdd	FALSE
bbdbacba	FALSE
ccaaccaaadbbaddbd	FALSE
dcaaabdbdba	FALSE
aadccbcdddbb	FALSE
bdbccbababbbbdcdb	FALSE
cabaccbcdadcdabdbbcdb	FALSE
acbbb	FALSE
abdc	FALSE
bbabbaccdad	FALSE
bdbcccbaddccaddcbbb	FALSE
aba	FALSE
adcaaaabadbaba	FALSE
bccabbcacd	FALSE
acaccbcbdbaddacddabbbdc	FALSE
cacbdabcccb	FALSE
daacbcdacdddaabbdcaddca	FALSE
abbaccadcabcbcabcc	FALSE
bcadbdbaacca	FALSE
aaacdbacadabba	FALSE
ab	FALSE
bbabdbbc	FALSE
adcdba	FALSE
bcaabab	FALSE
aabbaddbadbcdbaadcbb	FALSE
cabccab	FALSE
acb	FALSE
ddacaabadbccaadbbdbbcdcb	FALSE
babaaaaadbbaba	FALSE
badddbdabaccbdbd	FALSE
ab	FALSE
abadaabbbaba	FALSE
baab	FALSE
bbabc	FALSE
aaaabbaddbdccabdddda	FALSE
bcacdacdacbcbcb	FALSE
aaddaccaadcabaadb	FALSE
ab	FALSE
abdcbabaaadacbbbdbcdcd	FALSE
cbdababddcdabaadbccbadb	FALSE
daababaaabcdbbbcaa	FALSE
abd	FALSE
bbaaabbbddbbcabd	FALSE
ddddadcbbddbaacbdbdba	FALSE
cadbbcbdddbcc	FALSE
bcbdbaaccaab	FALSE
adabc	FALSE
bbbddbdacabbbcaaacdbca	FALSE
cdacabcacbbabadcdabcaaadd	FALSE
caabccbdc	FALSE
baccbadddcaabaccb	FALSE
cadddbacb	FALSE
acbc	FALSE
caacdb	FALSE
abaddddbdaddd	FALSE
addcbcccabaaccddcdc	FALSE
ddacbbcaab	FALSE
cadabddacabbcaabad	FALSE
bdcacacdcb	FALSE
abccba	FALSE
aabaacdcacbac	FALSE
cccdab	FALSE
aacaacbabbca	FALSE
acaccaaabbdcaabbbbcd	FALSE
adadacbc	FALSE
ddadaadabcbdcdacabcdbbaa	FALSE
daabadaaaaacacbadbcaadbad	FALSE
dabcb	FALSE
ab	FALSE
aab	FALSE
bcabbdbdddcdcdcbd	FALSE
ccabcdbcacabaadaabb	FALSE
bdcaccbaabdbacbaadd	FALSE
aaba	FALSE
acdabcabcbbcaddbdbcdbaaaa	FALSE
dcddcdbdadabbdacbdbb	FALSE
bdbabc	FALSE
cab	FALSE
aabddbabcabbbdccbbbbabad	FALSE
baaddaabcdcb	FALSE
cdadcacbdabdbb	FALSE
cbacbabcbbdbdbdaddbdbaad	FALSE
badaaab	FALSE
bacdbacbcaadbdabdcd	FALSE
aaddbcbbddbbcdbbaa	FALSE
acabbccbbaca	FALSE
dbabdbdb	FALSE
cabaabbd	FALSE
bbbabcadcbbcdaccdc	FALSE
cabbaacdadabaaaccbbdbd	FALSE
dacadbcc	FALSE
dadacacabdccdddaccb	FALSE
ab	FALSE
aab	FALSE
aadbdbadabacdbacbbbcdddb	FALSE
cbcaabcbdd	FALSE
aaabbbaaaabccba	FALSE
caccbbbdda	FALSE
dabcabadcabcbdabdcbbadd	FALSE
daadcdaacccbaba	FALSE
dabcabccaaaacca	FALSE
acabdadb	FALSE
addbdaababcbabacb	FALSE
aabbd	FALSE
ccbbaabcdcdbbbbbdcb	FALSE
cbadb	FALSE
cdaddabaaca	FALSE
adaadabdbaadadbaddccba	FALSE
abacabbbabddbccbccc	FALSE
dacbcacacabdbc	FALSE
abadcabcabaccc	FALSE
dabbaabaacbaadcbccacbdbab	FALSE
ab	FALSE
dadadbd	FALSE
ccadacacdabaaaa	FALSE
ccdababbabda	FALSE
acbdabbcbacdccddbbdbcb	FALSE
bccadaabbbcaba	FALSE
aaabbaabb	FALSE
daacbadbcbbdabbddba	FALSE
cdaaabdbbacbabbdbaaddc	FALSE
babaab	FALSE
accabdcccad	FALSE
bbbbacaabbbdbdaaaaabccdb	FALSE
accdbcdccabbca	FALSE
bcccaaabcadcabcababbc	FALSE
cbdabb	FALSE
abdcaabbdbcacadcababbcab	FALSE
acccadbadc	FALSE
aaddabdcddcbb	FALSE
bcdbabdacccabbabdcdbbb	FALSE
aaddddcbbadabbadbd	FALSE
acaacbcccdbbcbdbabdcbbabb	FALSE
adbcaacbddbb	FALSE
adcbdaadccaadbdc	FALSE
