gfcaia	TRUE
gdachbeacdace	TRUE
eeccigddcfdhjcd	TRUE
dhacbfgbff	TRUE
jcaffhageidcajiicbj	TRUE
dgjbbhih	TRUE
fihhbeeidjiccfhggcccjdii	TRUE
hjjbdhcdhhaecdgafgcgef	TRUE
abhaic	TRUE
dhdheeiei	TRUE
jbiijfhbcadcbfg	TRUE
hebhbbe	TRUE
dcbcjdjjaiih	TRUE
baf	TRUE
ibcgjhiadeeiceecjiggb	TRUE
ahighieiiagbejhdd	TRUE
fdcfcfabai	TRUE
ihahe	TRUE
cbeggcjbdecb	TRUE
jjigdefeefijgdccjhc	TRUE
gfgcadcdicdcdehjeicade	TRUE
eabbddbgegehiacidccd	TRUE
jfdejbggddejfj	TRUE
afjj	TRUE
efghhfidegfdfdaahbcadhe	TRUE
fdhbbjfgdgggjgfjbcd	TRUE
hdidc	TRUE
gbcfajbeeficf	TRUE
gdgdibgghdbacdaae	TRUE
ieigjbjcdhgcd	TRUE
cjcjj	TRUE
hgdjejchgeahhcffebbccifa	TRUE
ifb	TRUE
gjgfefdebdjceh	TRUE
iiebcdgjgabiajhafbijedcg	TRUE
gehcgjcgahieagbajegjbgehg	TRUE
abfedgbecaiidhgceeji	TRUE
dfhfc	TRUE
fgiahigdcbjhacacaejjbibca	TRUE
gdc	TRUE
fejdeghf	TRUE
hehcaibjcef	TRUE
bcabgabibgd	TRUE
gjhbifgj	TRUE
fbbcfigbadjeabfdhjc	TRUE
fddbd	TRUE
fhfedbbafdf	TRUE
ciabiedgadahfgchgbbebj	TRUE
ddgjiahabbhbhi	TRUE
hcffaihfihcfccfcafdahhh	TRUE
jegddhhicchidief	TRUE
b	TRUE
gdfdcdichhigjjidhfgdbg	TRUE
bieabfbbgh	TRUE
jgefjh	TRUE
aedeiheedgbbejhij	TRUE
eigchagdddjega	TRUE
jhbeiefa	TRUE
bjdh	TRUE
iecjjf	TRUE
jejidbjcjcafjghahjeb	TRUE
ficjaiediiacgifihihid	TRUE
gehggfdb	TRUE
dhbbdccbbeighehhg	TRUE
fibhdai	TRUE
bdhfjejfgcedeadgehfhchhhi	TRUE
hgjdajdh	TRUE
jcgbfgbahcji	TRUE
cdicjjbedjacicjidfafga	TRUE
ihejefchabhide	TRUE
dfcfh	TRUE
e	TRUE
jeicaaigaajbeeebebdbadeha	TRUE
fadcffgcabbieecaj	TRUE
fdceadfehjjcibbf	TRUE
eg	TRUE
jcbdbefgdhejaghhehccg	TRUE
d	TRUE
ihibfjgghhicbihefjdajcife	TRUE
fabgiegf	TRUE
cjgji	TRUE
edagcbefdfd	TRUE
iddejjijiiieaaej	TRUE
iejajieghfec	TRUE
ijbfjefgjadeiheaidaebj	TRUE
iggjcbjfehhgbgeie	TRUE
hdgjhabgfgiaaefag	TRUE
jb	TRUE
ebcaajdiacjafbed	TRUE
eaehgdafijdejjjffijiciag	TRUE
aabibchbcjgifcjbcfb	TRUE
dfbedbcdbi	TRUE
jddhbfbhjbbjgaaccbeeh	TRUE
cbfabdjcddiij	TRUE
dhiacabfhcdjeefbeg	TRUE
j	TRUE
hgbajab	TRUE
dgcchjcbfjfcjihcigbbhhbf	TRUE
cfdeggeghhcfhah	TRUE
h	TRUE
fbijbgfbagcfdjcjdefg	TRUE
gjfgbjfgbbjcfddababieiiab	TRUE
ffbb	TRUE
eg	TRUE
bffibcfibhdadffghba	TRUE
gbgcaeeib	TRUE
aagcfefdaabfgd	TRUE
fideihiefeahgghd	TRUE
dbcfef	TRUE
efjjgdcbdbcehheheicbb	TRUE
jdcbdajdcjffafdfdeajd	TRUE
hheihefbbiichfcgc	TRUE
ahbcbajjfid	TRUE
ciefadijjhhgggdgde	TRUE
hejgggcde	TRUE
cbgdiheahagcdg	TRUE
gjgfhbcidedff	TRUE
gfcdiafddddiadcjgbdah	TRUE
dchdfiiaajecfb	TRUE
gfcceegbgafdigjebciihghhe	TRUE
gehjaabfaddc	TRUE
chde	TRUE
aggjbaicebhici	TRUE
ijc	TRUE
bie	TRUE
aidcgbghfgfaajhbdg	TRUE
dedfeijfcba	TRUE
heafhjee	TRUE
hijhgcchijjh	TRUE
fed	TRUE
gfihfghgbfhe	TRUE
bcgaedjb	TRUE
fdgfijb	TRUE
cfiijfjfgd	TRUE
cbeficfagjhfgjhgiiggibj	TRUE
biffegdcihcchehdhga	TRUE
efiiacgdgfdeec	TRUE
ebaeaafjjihaghdieibbidiai	TRUE
jjeegicee	TRUE
hddeaciaghjgjbjabcbfefe	TRUE
iaci	TRUE
fcchbefabb	TRUE
eecje	TRUE
df	TRUE
gibfdebdjdehccigfebjcbjj	TRUE
gjabibcagbiigeiachja	TRUE
idjbfbjbebdd	TRUE
bdagdhhgghfhhbf	TRUE
gehjebfiacjgbcd	TRUE
ebcbgfjjdheeajaccjidhedha	TRUE
afbeaehgfh	TRUE
ahae	TRUE
ghihijedef	TRUE
ihabaajd	TRUE
afggbaiheeedecfh	TRUE
faebhjcbbhihebfg	TRUE
ia	TRUE
iecjeiheaejihabjfecgcgb	TRUE
bcdfdfcfiachfddjggifi	TRUE
ceb	TRUE
hehbbg	TRUE
hdjefhfjh	TRUE
hfajegdhggggccgagad	TRUE
bcagcfjih	TRUE
gaegiacdbhf	TRUE
dbeghacdjebigeb	TRUE
dgdijef	TRUE
cj	TRUE
fjfg	TRUE
bdicdfffb	TRUE
dgfhjhbacb	TRUE
bjajgaiadcdecfif	TRUE
jhbhgcagfbacfdca	TRUE
iaeifgg	TRUE
jbchdae	TRUE
gcdaidiabhhacfdgc	TRUE
afjiedi	TRUE
hajafbhjeeihgicfaeceega	TRUE
fiabaaj	TRUE
gca	TRUE
cdjibje	TRUE
g	TRUE
jjfeeigicfjighbe	TRUE
gebhigfcchhe	TRUE
bgdecbifjedddbbc	TRUE
biiafaedbijjbgdhgi	TRUE
afhifibaegahdffehi	TRUE
aehigjiae	TRUE
iifeebijjdhfb	TRUE
fihgcchaddgcc	TRUE
cgbbcaje	TRUE
i	TRUE
fhdggacbe	TRUE
acagfdi	TRUE
daie	TRUE
eedicfhdacgb	TRUE
ifhgafghajafehjibjj	TRUE
fccideeifhejjgbfdehc	TRUE
fggjijijafj	TRUE
ajcacegajfjdeb	TRUE
d	TRUE
degfbddcbchfchajfgbd	TRUE
dbabejd	TRUE
jbjeajjhb	TRUE
cgacdccb	TRUE
hiehidcbcfbijbhcgf	TRUE
bgjea	TRUE
cf	TRUE
bbigadcfjaihajdcebdcjd	TRUE
eeabjjhbdhfcjedghb	TRUE
deaahcafdbej	TRUE
b	TRUE
j	TRUE
jdieceag	TRUE
ahijjidhhjcbeeegcfi	TRUE
icdddjfceibbdiafijfc	TRUE
ihfid	TRUE
fccagehcgggegjajgijcehc	TRUE
igjeajhbccbgg	TRUE
gghagiidideiafbfd	TRUE
aaiihgiihecdgicgai	TRUE
jiaifdbegabbjfaighegfcafe	TRUE
bjiebdgbjjgahjigdhcechfh	TRUE
ggbjdjeabicbiecafhhc	TRUE
hbgjcjcfbbadcghheggeec	TRUE
jbacdidadadagf	TRUE
gahbjadcahaheedaaii	TRUE
jgejehffahabjjccieh	TRUE
bagiiggdddjggiiehge	TRUE
ehdajfd	TRUE
gdfbhadcjhggj	TRUE
i	TRUE
jeiafaageidgafie	TRUE
fjbgiijciadcjdccef	TRUE
gdjgceabihi	TRUE
acbjcaiifacjcbcaihjchifgg	TRUE
cbchiibdcfafgicfgbeajeaa	TRUE
bdddefaeacdb	TRUE
hgfeajjaabgacga	TRUE
hiabb	TRUE
baiadjib	TRUE
abijgaffehchdahc	TRUE
db	TRUE
fdbhgfceaifidgfcjbjhaifg	TRUE
jjidhibgi	TRUE
igbcai	TRUE
gbhacicfdfdacfjdfh	TRUE
gbdcjjaeghcjbbhejajjffeh	TRUE
fighdhfafcic	TRUE
fhg	TRUE
edhice	TRUE
ibfcadecfgigheeh	TRUE
hehfjdajaifha	TRUE
ac	TRUE
aid	TRUE
ibhaih	TRUE
iigcfjfcihbhiiahgc	TRUE
jbhiegafejhbed	TRUE
ibebfhhd	TRUE
hiacfdefaihb	TRUE
jgjaeabgffdebjg	TRUE
bgeghheaf	TRUE
fhijcdhegag	TRUE
dcbaiideagbigcei	TRUE
dighcfcigchbjcdcgdhajcid	TRUE
fj	TRUE
egadbcecaf	TRUE
chbf	TRUE
hhffhafaiefg	TRUE
ijgefhigeahiadechdifbijjg	TRUE
ajeicihhfjjbdedeeaagfaeb	TRUE
g	TRUE
cbgifjihjcdab	TRUE
jeadghacbchcdjgggi	TRUE
ccdijfabf	TRUE
fbcbciigjegdgbdcadfafdj	TRUE
eddbejiebhfcecgajaceihh	TRUE
bdfieheehgifcdaffdjhbfe	TRUE
ebichdgjdcadfh	TRUE
fefhghhfchjhjhgadeebabeji	TRUE
dbeidaggaf	TRUE
hijbfafddabbcice	TRUE
bfgadajbcbceahicfe	TRUE
hjhdeh	TRUE
heaediaadfjafjajdgjdaig	TRUE
gigjhfiagechgaafchega	TRUE
hhaeaegdjaifcc	TRUE
cihbhefdajidg	TRUE
jha	TRUE
ggefeehdebcgcchjd	TRUE
hdiacgbbdffggfdhicbc	TRUE
baehbjifaficdjfcggfb	TRUE
jgb	TRUE
efbahfgejed	TRUE
iddjh	TRUE
efabiiahaggfjfhdeffhe	TRUE
hiifj	TRUE
gjeha	TRUE
jfdhegdchahhhagjcjfhebheg	TRUE
jaabjieghefhiij	TRUE
dijbjhjdejjdji	TRUE
hhdjgiiabbh	TRUE
efibbhaejieb	TRUE
fcbcf	TRUE
ecdaejcfejii	TRUE
jajfgeagajf	TRUE
ihggecjei	TRUE
gaebajhbadefbjbcidjcfjf	TRUE
ha	TRUE
ddicaefgcebcgjd	TRUE
bfjdehecbhadebadfjchg	TRUE
jbfedjbihjdjfcgbdejdj	TRUE
jgde	TRUE
heijahdf	TRUE
eebcifgcfhfeibecadjdj	TRUE
aaif	TRUE
chgaifjhfeg	TRUE
hdeihjiififjbif	TRUE
diaa	TRUE
ejjabfehjjgigcdeaabchi	TRUE
ejegdbcaebdccbhhjdidc	TRUE
habjhdeej	TRUE
bccgbcccbgaacbcfif	TRUE
fggec	TRUE
ffhfhfcfbgidgdfcgagbgdc	TRUE
jghhebiidijb	TRUE
eaeagfdegbhbbcfdjae	TRUE
fjahdjccfhbhcfhjdgiggi	TRUE
iafchc	TRUE
jcedecbffceejgijabceghce	TRUE
adbhehdafgdddhiafghjbfic	TRUE
bfijjbjhddejfdig	TRUE
gegcagefacdjbjjfagjibf	TRUE
bccbade	TRUE
gdhghiejh	TRUE
ffdhhbedhdcgheghf	TRUE
iaedgb	TRUE
cffjahgfeba	TRUE
cffjebidjbfccbfjd	TRUE
hdjbfgb	TRUE
b	TRUE
eheahicbccefebjfecgefhg	TRUE
jadeijfdjhiadji	TRUE
agehacefjefbche	TRUE
iah	TRUE
gab	TRUE
fe	TRUE
ebe	TRUE
gag	TRUE
ghfdeddgah	TRUE
jagfhjcdiaddjehfedeacbfe	TRUE
ghdhfeecefiaajicffed	TRUE
djcebiaacehdbbegb	TRUE
ghheijaajbbceghd	TRUE
iebfajgihifjhhhfbijfdje	TRUE
gbif	TRUE
fba	TRUE
jhfdd	TRUE
ejhcje	TRUE
cfjfhh	TRUE
ibb	TRUE
ffbbhdbecadeddhaig	TRUE
fadbjdhdhbfede	TRUE
ci	TRUE
jaefjgacje	TRUE
ghgdg	TRUE
feebfcgcgbbecagiggihjfa	TRUE
ggdiaccebf	TRUE
dhjiihfgcghejcgcaja	TRUE
edcbigghidiahibdc	TRUE
aeaafjbejhbjbffciecai	TRUE
acgdhehcbhbhedjf	TRUE
f	TRUE
beggfgefadjcjed	TRUE
idgeeiihde	TRUE
hcifjeiifgf	TRUE
jdddhdacefdehfahb	TRUE
ia	TRUE
efjefbbc	TRUE
idhjifdbbadb	TRUE
degehaebhabeeeebbeegjgj	TRUE
cjhgifibejjffgcgghbe	TRUE
jgcefajbcgbejjcjbghg	TRUE
ffjficddggfdaeaiejigjha	TRUE
dbbffabdbifhdjgfgffegff	TRUE
gifibijjigefj	TRUE
ajgbeaaacjgjfgaiedgef	TRUE
bda	TRUE
bjifjaecicaih	TRUE
hbfhjdbbdaaifedfhghjgggg	TRUE
eaid	TRUE
cadbachghjacc	TRUE
dbdefgjjcdc	TRUE
hbjiebfiidaiiccgcce	TRUE
ddejaiijg	TRUE
deedhebijffbbjeaidc	TRUE
be	TRUE
e	TRUE
hehhbdebfeeigbjccdgdaagid	TRUE
gigfhhbf	TRUE
j	TRUE
ciegjhcfjffdccficaciejgf	TRUE
iddh	TRUE
d	TRUE
hbbiagfbihbbh	TRUE
ha	TRUE
jahdabfhhbfbeac	TRUE
afagghjade	TRUE
fdaaicgcehiebghfhb	TRUE
dhgbcaicb	TRUE
gcghifbfbjb	TRUE
gcgfhbhihibjjfbdf	TRUE
fibei	TRUE
daafchachedia	TRUE
cjjcje	TRUE
bagbbcbdacabg	TRUE
ejhjbccdibcaidj	TRUE
fgjgfahgddc	TRUE
aeaccbjffahhfcdeicg	TRUE
eghjgbjciggfaedhidbiajehd	TRUE
bebhiiedd	TRUE
jjbabhjhaefhaea	TRUE
eegc	TRUE
jigaffbgdabdede	TRUE
bhfdjbefehajbhehhhhbh	TRUE
caaifhbijgeccgdc	TRUE
gfjffhbjchdadfgidafdhigec	TRUE
hgjbe	TRUE
edccffceijejfiffdacbccj	TRUE
fbbdjdcaheb	TRUE
fbjigij	TRUE
ahccddh	TRUE
ad	TRUE
idgb	TRUE
jfhhhhehdgbdadaaifeci	TRUE
adidfbjcjfhaifaejdba	TRUE
eijcebfhiadgbfafegje	TRUE
dhfbjaffffbgh	TRUE
hccfjfabhbjfagebggfgjddfe	TRUE
ebijdcihid	TRUE
iebfif	TRUE
ifaefbffgijbjajjdh	TRUE
ega	TRUE
hhjidccejhbaehgghdeecd	TRUE
hcbjddjhdhaeffffjjaeeb	TRUE
jehfgifjijighhiacf	TRUE
gdhd	TRUE
bhaidicheffieafeaijijfcj	TRUE
jdicchbeea	TRUE
aaaefegabjbiahj	TRUE
fgedcg	TRUE
hjabijebadiedcdgigeijf	TRUE
gj	TRUE
ifedddieghchiceccbgejd	TRUE
hjahefje	TRUE
hccidhfbigegibigbcejhjdai	TRUE
ddeghghdjjaeaegjbji	TRUE
hhjgiadeeghfgagiidcjff	TRUE
hdjhcfehgbbeddhhibajj	TRUE
cbaeabfgcijhgb	TRUE
aihcceibjggi	TRUE
ijaedbhdaigfghbgdgccda	TRUE
jcjfaadadadbdabjjhg	TRUE
dfeeecei	TRUE
gceeejb	TRUE
jeajfhjaffcjfif	TRUE
ihgigai	TRUE
bj	TRUE
fcgbfa	TRUE
ijabhcacjcggbgafcgbebdai	TRUE
baaeidhicjdgje	TRUE
edacec	TRUE
cjgefchbccechcdhf	TRUE
bebfhhgafcjjaggbjbjdbffd	TRUE
achgejebfjhdbhbaag	TRUE
cbeibafebjehhjabbecd	TRUE
d	TRUE
dgifgciehicgdfbgiefh	TRUE
f	TRUE
agbcjhjdhfjfcfcgi	TRUE
addhbfheidfgdh	TRUE
dbhc	TRUE
gjhighhgcd	TRUE
gjidgg	TRUE
ahacddjgeccjhjfgg	TRUE
cgfjbafiafafb	TRUE
fifheheaca	TRUE
g	TRUE
fhbbgacjfaigceadgj	TRUE
jdiadfigabddbdcbhffdabfbd	TRUE
efeeidgcefegaigdgdafa	TRUE
bidhecdajeghfbbefabfdf	TRUE
fgcijcjjecfiabddabca	TRUE
aibahfgjhjjeghbjhaaccg	TRUE
bebidhh	TRUE
ca	TRUE
ccbh	TRUE
fbchabifg	TRUE
bidcgcaidbbejjjjjgdebh	TRUE
bagghdehefchiidcibig	TRUE
bghfejejbacfeaaa	FALSE
bbbbgeaddjd	FALSE
ajhajfajijbaaa	FALSE
djjhhbagjfbbbbei	FALSE
iaaa	FALSE
cidgahdbafecieadddchacaaa	FALSE
bbbbdafabf	FALSE
bbbhedijdbaefghdbefhbcafh	FALSE
bbbb	FALSE
ffcbehjdijicaaa	FALSE
bbbafehie	FALSE
jdfdedgdbaaa	FALSE
bbbighffjcbfggbghbebgjfce	FALSE
jhgaaaa	FALSE
ddihjhajihiejibbbbbjaa	FALSE
aaaajjjbec	FALSE
bbbbbif	FALSE
bbbbi	FALSE
agfaiaaa	FALSE
aaaa	FALSE
bbbcdbcgcd	FALSE
cbbbbia	FALSE
dcgiehejdhaaa	FALSE
bahfgeaaaaabacicbd	FALSE
bfgjfgiedaaa	FALSE
fgihchibjfaaaahffj	FALSE
bbbceijfehgddcigeejcjij	FALSE
dfdbbbbb	FALSE
hahfaaa	FALSE
gighbbbbfjeege	FALSE
decibbbbhejbceidbhgheb	FALSE
hbiahgbcffdaiiebjaaaafb	FALSE
faaa	FALSE
biaaaahege	FALSE
aaa	FALSE
eaaa	FALSE
bbbbjed	FALSE
aaa	FALSE
cegfbacbaaaai	FALSE
bbbeifegg	FALSE
eiibfaaaaagchacfdjb	FALSE
jhggaaa	FALSE
diijaaaab	FALSE
bbbahbafefeda	FALSE
bbbg	FALSE
ffbgafjeediegiijaaa	FALSE
iejcgfjcagcjfjadaciaaaagf	FALSE
faaaabadfjgf	FALSE
aaa	FALSE
bbbffe	FALSE
ajbaedgcggaaaa	FALSE
hhiehaaaacebici	FALSE
bbbhceiah	FALSE
bbbcjdegjaccceaabjdfac	FALSE
ibjaaaahajcgcfbbdc	FALSE
higfcahfdahjebfeaaaa	FALSE
bbb	FALSE
aaa	FALSE
egdbbbbbfc	FALSE
abehaajeadffcgcehabbbbdd	FALSE
dichhhfcdbbbbfeihi	FALSE
gbgciebcjbhbiejibfjaaa	FALSE
fgccfgbcaeccgbeibbbbga	FALSE
bbbbbjhaggda	FALSE
bbbadgiahghjii	FALSE
eehbbbbbhiggcgeiebf	FALSE
bbbbfceeieadaefcihhfdjbj	FALSE
ibabbbbhdheidd	FALSE
ifjiihdibhhajjabjihaaa	FALSE
jcfijgfeeiefeebbbb	FALSE
dehgicdhjahgbfggaaa	FALSE
chiaegafgbbbbbhcgdj	FALSE
dgejdhbdbdibbaaa	FALSE
bbbijgbbacjbjjeggfccb	FALSE
aaa	FALSE
bbbjadbh	FALSE
bbb	FALSE
bbbijdgiai	FALSE
bfcbabbbbfjbfgaf	FALSE
chbbbefjcciahaaa	FALSE
hbbbbh	FALSE
hbdjafibcaaaaejeeajae	FALSE
fjedeigcdiaedbiicieejaaaa	FALSE
abaaaa	FALSE
ihajcaaa	FALSE
bbbecaddbjfdbcdfbfjggggd	FALSE
bbbb	FALSE
igjdbgcfgdfaaaabd	FALSE
jffddgajaaaa	FALSE
bbbgdgiibiafeffhcieie	FALSE
giheeaaeaaa	FALSE
dciaaa	FALSE
ihhdgiehgjfagecdhfdcjaaa	FALSE
icacbhaeigbaaa	FALSE
jhjdbbeadaaaaecfb	FALSE
agfbgjgebbbbfgah	FALSE
bbb	FALSE
bbbejjjfeji	FALSE
bbbafdafjccbjcddgf	FALSE
eaihhhbbbbaba	FALSE
bbb	FALSE
bbb	FALSE
aaa	FALSE
jhacgdjjdccdfghihbbbbfjc	FALSE
bbbdiehfce	FALSE
iiejggbcheifhjaaa	FALSE
bbbicgdejbdaiig	FALSE
hfegiechaaa	FALSE
bbb	FALSE
bbbfec	FALSE
hegdiaaaaaedeeg	FALSE
gjhceagagjeciiafajdeaaa	FALSE
hjhigacaaaa	FALSE
aaaadgjgigcibgija	FALSE
geaaaadbjg	FALSE
jbbbbijidihjiaabagcfa	FALSE
gbahhfhihfgdbibaijaaa	FALSE
hjddccijahbfjcaaa	FALSE
eghcccbheaiagbgaaa	FALSE
aaaajagfhgifaeaffaghdgh	FALSE
bbbcahgbgjhhbdh	FALSE
hdjhaaa	FALSE
fhhaigbjcghceciheaaa	FALSE
bbbbc	FALSE
aaaa	FALSE
ficaiaaahcdjagjfadbafaaa	FALSE
aaaafbbg	FALSE
aaaa	FALSE
gcheggagehaaedhaaa	FALSE
bbbaabbd	FALSE
bbbbj	FALSE
jedfefbgdijcfaaaacadeeh	FALSE
bbbeajgbcjhigaeficiecbea	FALSE
bbbbigcigbgi	FALSE
bbbbbfc	FALSE
aaa	FALSE
dabbbb	FALSE
bhcfaaaabfhcfciifdib	FALSE
aaa	FALSE
bbbfecihedcjbhedacde	FALSE
hdeicbbbb	FALSE
bbbjeiacfgd	FALSE
fhfchgebfddbceigedejfaaa	FALSE
fcbbbbdhcj	FALSE
abhaaaaejbbjfeijbdj	FALSE
bbb	FALSE
bbbfacafdgjiadijaa	FALSE
afhbhbhidhbbbbbjefjgg	FALSE
bcdgfehabiaaa	FALSE
gefaaa	FALSE
bbb	FALSE
dgfeeaaaaeeegjjjjbddd	FALSE
heicfgajafhefgigfchjjhaaa	FALSE
hiejhgbdgaaa	FALSE
aaa	FALSE
bbbfcdhgihejh	FALSE
jggheicjgjbcbhcffaaaa	FALSE
bbbddabaedibiefbigia	FALSE
bbbjdiijgdd	FALSE
jcijecaiebaaaacf	FALSE
eajbbbbijdigdh	FALSE
eijgfjbbhaaa	FALSE
bbbbhfajcbhjjff	FALSE
fgaaaa	FALSE
bbbggfifh	FALSE
ebiecdceghdiaaa	FALSE
aaa	FALSE
bbbci	FALSE
ifggifebcigjaaaa	FALSE
hfhbjdhjibbbbgegi	FALSE
gaadaaaah	FALSE
aaaaj	FALSE
bbbbifcccabicajjjaadfdjhf	FALSE
aaa	FALSE
bbbgghjgachefgfga	FALSE
bbb	FALSE
aaa	FALSE
bbbicbidgjfhhge	FALSE
biejaaa	FALSE
bbbicehfccdecdgcd	FALSE
hgaihhfaaa	FALSE
chegfjejjjbbbbachjagacche	FALSE
beicajgbdiajeaaa	FALSE
bhhhbaaa	FALSE
efcbbbb	FALSE
bbbajbh	FALSE
abbabaabbbbg	FALSE
bbbifihdiaiacjhb	FALSE
bbbhcfgfagdaafhhjjhgdefje	FALSE
badbbbbhegca	FALSE
bffgchbgfdaagafjdaaa	FALSE
bbbbb	FALSE
biebdjeeaijbdcgfhfbbebaaa	FALSE
bbbicffhabachfbhd	FALSE
bbbbeifdfd	FALSE
bbbf	FALSE
bbb	FALSE
bbb	FALSE
jhgcaaa	FALSE
bbb	FALSE
faaaaf	FALSE
dcgabiiaaa	FALSE
daieiaaa	FALSE
gaaa	FALSE
bbbbe	FALSE
bbbaaac	FALSE
cbaihaaa	FALSE
bbbfgaghidegjjichid	FALSE
eaeaejieeebdaaaage	FALSE
dhfaaaajdjccjhfga	FALSE
aaa	FALSE
dgfcfdghajjaaa	FALSE
bbbedfiafdgjcdcahhhh	FALSE
daaaaceaabdgbb	FALSE
bbbbbdibhgac	FALSE
deaaa	FALSE
febbbb	FALSE
ccefjehcaaa	FALSE
bbbfhdeddfiege	FALSE
egaaddgfgichaaa	FALSE
aaa	FALSE
bbbb	FALSE
dbbbbbcaafagjeiddc	FALSE
ejfdjbacdbbbbbeigbbjbbc	FALSE
fhcibbbbb	FALSE
bbbadcbhhgghecjacahedce	FALSE
dbbbb	FALSE
jiaaaaaed	FALSE
bbbhiegbgiddhjci	FALSE
bhhbbbbbfbaiebdiba	FALSE
bbbheiejbcfbcajajaei	FALSE
haaaaccibjahj	FALSE
ecfbcdhedbcaaa	FALSE
bbb	FALSE
haaaabdge	FALSE
idbgaaaafbe	FALSE
bbbjiehggejdbe	FALSE
iibbbbdbdeah	FALSE
aaaac	FALSE
bbbggehbeabgfciihjg	FALSE
bbb	FALSE
djjjcfgaaa	FALSE
jjehbigfjjjceagbbbbadj	FALSE
bbbefied	FALSE
adfbbajfbhadbbaaa	FALSE
fcdhjaaaagcghccifdfcgb	FALSE
jgaigjeefjabbbbgibh	FALSE
cbbbbd	FALSE
bffdfjfbbbbaebccjfeghgj	FALSE
aaafejbdcbcbaddgaaa	FALSE
eiehgdjjhibaaa	FALSE
gfeechaaa	FALSE
jfbddficjcbbbbi	FALSE
ahbedigjbihaaaaahahfi	FALSE
giceaeegjacdefdhabbbbc	FALSE
bbbicadghdjafacce	FALSE
aaa	FALSE
aaa	FALSE
bbbcdgaegahbggcbhegggjb	FALSE
gjibbcebbbbhghabgjjec	FALSE
bbbjdicjfahdhge	FALSE
dddieccbfcagdaaa	FALSE
dedaccdbcjifbbbbhjj	FALSE
aaa	FALSE
aaa	FALSE
cdbgifgebbbbijhabdfjacdej	FALSE
ebaaaahd	FALSE
bbbigeigjjjdaj	FALSE
hfdgjbbfaaaaj	FALSE
gaaahdccbhigaaa	FALSE
baaa	FALSE
aaa	FALSE
bbbjbaddfhbadb	FALSE
idcbijeaaaaehiijgeccfbaa	FALSE
bbbjahifjefiabgbgdbei	FALSE
baaaa	FALSE
bbb	FALSE
chijbdcgdffbbhjhaffaaa	FALSE
idbffjheafaeiecaaa	FALSE
aajbhdigchbbbbhdfcgei	FALSE
gchjagggdgebeaaa	FALSE
dbifheaaaaadd	FALSE
bbbbjh	FALSE
ejbaejfigbbbbfcic	FALSE
bbbajcbhb	FALSE
dajbbbbcijca	FALSE
chhdgfdichcbjhjhaaaaa	FALSE
fcfihhaaaajifdejhi	FALSE
aaa	FALSE
bbbfbbaejhbdfjbffed	FALSE
bbbbfgehichjhichieg	FALSE
bbbghaihdaiahgigeeiichce	FALSE
aaaa	FALSE
jfjeaaaaffgigebaee	FALSE
dicaaa	FALSE
cfgjdbghbabbbb	FALSE
ceedjcdaaaajae	FALSE
bbbchgea	FALSE
aaaaecahaicbfedcghfgefgcf	FALSE
gaaa	FALSE
aaaaaaeei	FALSE
affchahceaaaagifjdafjhddb	FALSE
bbbbbfbafdgcgbggighigbbc	FALSE
bbbbcd	FALSE
bbb	FALSE
bbbcbab	FALSE
afgjahdgchbjbbeijgbhaaaa	FALSE
bbbejhfafdgdgejg	FALSE
bbbaccajefdhjcdjfbedajc	FALSE
eaaa	FALSE
aaa	FALSE
ejigjaihibjihihiaiebaaaae	FALSE
efdaijabiaaaadjafbee	FALSE
dbdbcdahgccjfjfaaa	FALSE
jaaaa	FALSE
ffdaaa	FALSE
dcaihjhddfehbcaaaafigd	FALSE
cdcgiijhddgcbagbdaaa	FALSE
gdfeaaaaeafb	FALSE
jeidebbbbbidafdi	FALSE
bbbajhebcgjb	FALSE
iihijbbbbgaceaiadbf	FALSE
bbbbiiajc	FALSE
jhbjfdahhgaaa	FALSE
aaa	FALSE
jdccchaaa	FALSE
fbbdicdjbceaaa	FALSE
hfhfjhbbfaaaaijajbaabjacd	FALSE
bbbbfdhafbbcehdii	FALSE
bbb	FALSE
aaaacd	FALSE
aaaadfjae	FALSE
cgbghaabaaa	FALSE
bbb	FALSE
accdhiafaaaa	FALSE
aaa	FALSE
aaaaeihie	FALSE
dadiaebbbbcdhjcd	FALSE
aaa	FALSE
bbbicdefabfhfi	FALSE
bbbjfigiciggfacbcibgc	FALSE
gaaa	FALSE
bbbhbffbhceeffaibhdefabf	FALSE
bbbeg	FALSE
hibcdachcgbjahefaaaaehfdh	FALSE
hbhfaaa	FALSE
cbegedhchaaaa	FALSE
gggchcjajefdagccbhciaaa	FALSE
dgaaaaafcdgb	FALSE
gcaaaaaij	FALSE
bbbjfhadjdaah	FALSE
bbbgffafdfbchcc	FALSE
ccfhificihehghbbbbfhdh	FALSE
gaciajaaaafifaggejefdbgd	FALSE
gihcecaaa	FALSE
jijdfaaaaif	FALSE
ahabbbbcii	FALSE
bbbiefabiejch	FALSE
fgigcdacahaaa	FALSE
bbbcc	FALSE
ccfhbbbbhcfhiahjjhfgbage	FALSE
bbbj	FALSE
bbbhfjjabdfdajfegbhaggd	FALSE
bbb	FALSE
hjccbghejhdeigbfcjfcaaaag	FALSE
jbcdjhgeeidiehhgjaaa	FALSE
bbbeihciahidjgjaefd	FALSE
ababbbba	FALSE
bbb	FALSE
bbbfaihfiebd	FALSE
bbbedahjaabgcbiebab	FALSE
hijdaaaacgg	FALSE
dgaaaah	FALSE
efjeggabbfagghhjgiaaa	FALSE
bbbchhcjdagjejaebfhbdji	FALSE
aciecbbciaaaadfgajj	FALSE
aaa	FALSE
ihaibbbbagj	FALSE
aaaa	FALSE
bdcfdajhjjdjcceghaaa	FALSE
cbbbbde	FALSE
bbbeiffggc	FALSE
hccdajbbdbdbbbbghfdedcif	FALSE
gaaaa	FALSE
bbb	FALSE
cdjdddcedbbbbc	FALSE
ibbjbejgahbajaaa	FALSE
ahdedaaaaiihddij	FALSE
ccidgdaaa	FALSE
bbbdijgcigajefhcegaabfad	FALSE
bhhjicbadcadbbefchidaaa	FALSE
aaaaahfbdcibgabjffbehb	FALSE
bbbde	FALSE
bbbdidgg	FALSE
fjfabbbb	FALSE
gfhdbiegdehehiaaa	FALSE
bbbddddgaf	FALSE
bbbbbae	FALSE
bbbibehbcafdadf	FALSE
gebdebbbbefdacccidbd	FALSE
ghaafefccacfbdcfjfjaeaaa	FALSE
bbbffaaecgc	FALSE
dbfjhbdhffhfjijdhhgaaa	FALSE
ggbdffjghbccjcfcbbaaa	FALSE
aaa	FALSE
bbbefadg	FALSE
bcdihcjdahjdgiiaaaa	FALSE
ghfgaedhgcdaegaaa	FALSE
bbb	FALSE
didcbbhjhbgbaaa	FALSE
bbbbbgiefihig	FALSE
bbb	FALSE
hbgdiaaaaa	FALSE
aghjbdfgdjcgcdabbbbfh	FALSE
gajhidhhdiaaccgghdfcaaa	FALSE
eddbggeadjgbhaaaahijcc	FALSE
bbbhg	FALSE
ceajhhbghhbbbbb	FALSE
bbjeajbedhihjgaaaahegdigj	FALSE
bbb	FALSE
edbcfbdjccggdcaggaaa	FALSE
fgaaa	FALSE
fdhdhibjghbbbbhjfgbb	FALSE
dgbigaaa	FALSE
ehcgibbbbg	FALSE
bbbiahhgchdcjfffhchigb	FALSE
bbbifhbbibdafaeahebjahhe	FALSE
bfdedfbfacjhbaaaa	FALSE
dahibgiedaaa	FALSE
djiahhfiabbbbaji	FALSE
bbbab	FALSE
aaaa	FALSE
jfdgeeebbbbje	FALSE
bbbgfceagjjajhf	FALSE
bbbjjheh	FALSE
bbbijgjidajbdcabfb	FALSE
ijabiaaaaaj	FALSE
efegjiedhbhahjheaaa	FALSE
bbb	FALSE
bbbaidgaacafjiefeca	FALSE
dcagihbbbbi	FALSE
igbechjcabfheiahijfbfdaaa	FALSE
aaa	FALSE
ehcbdcebbbbfbafiebii	FALSE
iffbagebbbb	FALSE
bbb	FALSE
gidhiccigggaaaaabjgd	FALSE
aaa	FALSE
chiaaa	FALSE
aaa	FALSE
bbb	FALSE
dbejbgidbbbba	FALSE
fdacbbbbddaaihicehigi	FALSE
ecjgahieeccfibdfdhaaa	FALSE
bbbhjaajjjc	FALSE
deaiaaaaicajeab	FALSE
bbbecchicjcd	FALSE
ahegbbbbbjhebeahjb	FALSE
aaa	FALSE
ccdjiiddaiiaefaaa	FALSE
bbbjjaie	FALSE
bfgicbdjdjbdfddaaa	FALSE
bbbhbjaaahggjfafcadjif	FALSE
bebbbbe	FALSE
bbbafaadejhjfcbgbigehha	FALSE
fhjfegccebbaaaajfhadfhd	FALSE
ajbbbbehaaaefgc	FALSE
bbb	FALSE
bgaaaaaddja	FALSE
bbbgccdbcceihjjfddgig	FALSE
jfadhfbaaaaaaheedjae	FALSE
efihdheaaaa	FALSE
acdeiebbbbdhccgaiedfjg	FALSE
effdabbbbjaaaggbgggh	FALSE
chhhaibbbb	FALSE
bbbbdh	FALSE
jcbdfdigdifafaccjbehaaa	FALSE
jgcdaaaaaijid	FALSE
gbeiadhdhbbbbbf	FALSE
hbgfcdaaaahfgfihbiheac	FALSE
hdcidcfdajcgaefcheijaaa	FALSE
ijgaacegaaaaddbcbfcfbj	FALSE
bbbaccccccgbddgffcgb	FALSE
eaegdjcjfbbbbjice	FALSE
cjbaaa	FALSE
jeehbbbbjh	FALSE
bbbaifdiagabedacffadabib	FALSE
aaifhgibfbbbbhfif	FALSE
baaaaahfjabff	FALSE
ggbbbbiihgjbigbhbijiefc	FALSE
bbb	FALSE
jcfigdbbbbfci	FALSE
aaaae	FALSE
bbbbfh	FALSE
bbb	FALSE
ahbgcfgaaaafafid	FALSE
bbbbhdf	FALSE
bbbjaajgjcbghajjee	FALSE
ebbjdbjhhiedcjcijhiaebbbb	FALSE
fagcaaaa	FALSE
