cbdab	TRUE
cdaddacadbdccd	TRUE
cdbdabdccddbdbdbcdcadabd	TRUE
ccdacacccdbdac	TRUE
adacacdadcb	TRUE
cacdccdacdbc	TRUE
dccdacddddacacdaddadc	TRUE
ddc	TRUE
cbcbcddbcdbcdcabadddcb	TRUE
ccdcccaddbabddaccdaccbcd	TRUE
ddabccaddababcacddc	TRUE
dcdcadccdccdbcadcaddbacd	TRUE
abccbabaccddccddb	TRUE
cabacbdcbdbcdb	TRUE
ddacbaccdcbcbcdbdbad	TRUE
cdddadabddd	TRUE
ddababdbddac	TRUE
dcbddcaccdadabcd	TRUE
dacbcacd	TRUE
ddddcddd	TRUE
ccbcdabdbdb	TRUE
ccddccbababcdabd	TRUE
dcdb	TRUE
cdcdcdcdbcb	TRUE
ab	TRUE
dabccc	TRUE
dcbacdbdadcccdcd	TRUE
ccccddadb	TRUE
acbdadcdabacbd	TRUE
abcbcdbabdacdbacacdddb	TRUE
ccbccbcdb	TRUE
dabacdcdddad	TRUE
cdcbacdcbabdadcdcbcbdabc	TRUE
acacdcbacac	TRUE
acabdd	TRUE
adcddabddbdadacbdcddcbc	TRUE
dcadcddbcadadabadddabd	TRUE
c	TRUE
dccdcdcbdcabc	TRUE
dbadddbd	TRUE
abcdadcacacbabcb	TRUE
cddccddbdbadbabddcd	TRUE
cdcccadcdbdabcddcdadabcc	TRUE
ccdcbabddcacabcbdacadd	TRUE
abcdd	TRUE
dacddbccbdcdabaddadbacac	TRUE
ababddddcbcd	TRUE
acbcdacaccad	TRUE
cdabcd	TRUE
cdcbac	TRUE
ddcab	TRUE
addaddbcccddaccbd	TRUE
ccbadcbcaddb	TRUE
cccabccbcdaccb	TRUE
ab	TRUE
c	TRUE
dcacbcdacd	TRUE
ddcad	TRUE
ddabcabacabddddcabdbcbadd	TRUE
ab	TRUE
addc	TRUE
ccdabcadcacdcbacccccbadd	TRUE
cccaddccd	TRUE
dbc	TRUE
dcaccdaccdd	TRUE
adbcadbadabadcabcddc	TRUE
dadbacddacdbcccb	TRUE
ccdddaccaccccbccdddad	TRUE
cd	TRUE
ddddbdbcdcdbdcbdcacddc	TRUE
dbdbcddcdacdddddacb	TRUE
adcdad	TRUE
cbdbdddc	TRUE
ab	TRUE
dcbdddbddadbadcacddbc	TRUE
ddddbcdbdbcabcaddcccddc	TRUE
adddcddcccbacdcdaddacbccb	TRUE
accdc	TRUE
db	TRUE
adcdacdabdc	TRUE
cbccacddcbadabcccccddcb	TRUE
addcabddccc	TRUE
acbd	TRUE
acb	TRUE
dbd	TRUE
cbabccbdbcaccccbcbcacbccd	TRUE
cbdbdbadaccbacccbd	TRUE
dcccbccdccc	TRUE
ddbdacadabdacdbaccdcbcb	TRUE
ccabacbdbcabdacacadbc	TRUE
adabdcbccdacdadacabacd	TRUE
dacbddacacabadccddccccc	TRUE
accbabdabcdabac	TRUE
ad	TRUE
acccbdcabacdc	TRUE
dcacdadcabdcbcbcd	TRUE
cccadcdcddcac	TRUE
cbaccddbdbdadddcadbdd	TRUE
dcabcddbdcbacaddbccbacdcd	TRUE
cbdcbcbdcb	TRUE
d	TRUE
cccdadccbc	TRUE
cbccdbdbacacdcdb	TRUE
dcdbd	TRUE
d	TRUE
acbcadcdcbabcaddbc	TRUE
abccdbcabcdbdbccc	TRUE
abdbdbcddcab	TRUE
dbdbccabdac	TRUE
ccdab	TRUE
abdababcbcdddbcbddcdd	TRUE
cbdbdc	TRUE
ccdddcbcbd	TRUE
cbdbcccdbaccdccdccdbcab	TRUE
adddddabdcbddddbabdbdab	TRUE
dccbdccadbcbcabd	TRUE
cd	TRUE
c	TRUE
ccbc	TRUE
acdddbacccccacbabdcdd	TRUE
addbdadccccccacadbd	TRUE
cabcccdabdddbabdd	TRUE
adcbdcdacbdacccadc	TRUE
d	TRUE
cacdccdccccdbaccdccbdbd	TRUE
acbd	TRUE
abccdaddacbababcad	TRUE
cbcbadbaddbcacddabcbddddb	TRUE
dabcdcbcd	TRUE
cddbdcadb	TRUE
abddbcadacad	TRUE
cccddcddbcdacd	TRUE
cbadcddddadcdcbddadc	TRUE
ab	TRUE
ccbcdccbcacacccadd	TRUE
accaccdcdabab	TRUE
cacdbcaddabd	TRUE
dbcbabdbdacabdbccdbdadc	TRUE
dacacc	TRUE
ccccbccdbdddcacbddc	TRUE
cabd	TRUE
dcb	TRUE
dddabcdccabcbcbcbdadacdd	TRUE
dbdbadcb	TRUE
ddcacacdcccdadd	TRUE
adcacababddcbdacacaddc	TRUE
dccacac	TRUE
dabadcbcccccdbccbcdac	TRUE
abddddbcacdddcddbdcadbdb	TRUE
adacacdcad	TRUE
dadabacccdcbdadbdbc	TRUE
c	TRUE
cbddababaddbdcddbd	TRUE
cdd	TRUE
adddacadacbcac	TRUE
ddbd	TRUE
ccab	TRUE
adddccdcdbcbdabcb	TRUE
abdbdbccb	TRUE
ccadadadc	TRUE
abacadadcdbadaddadbdc	TRUE
dccddc	TRUE
dcdbccadadddacbadddcbdab	TRUE
acdbdabdcdcdbcdacbcad	TRUE
ddbdcccbdbdbabcdcdbdcb	TRUE
d	TRUE
caddcb	TRUE
ac	TRUE
dabdabcbdbacabdadadcabd	TRUE
dbabcddadbaddbdcacdbddddb	TRUE
adacdcacdacabc	TRUE
ccbacdbdbaccad	TRUE
dadbddacdcadccdbcabdcccc	TRUE
ccccac	TRUE
abcbcbacdc	TRUE
ddddcacacdbcbcadaccad	TRUE
dabdcababcbdd	TRUE
adbcdbacbcbadbc	TRUE
ad	TRUE
cddacbacbccbdcdddaccccb	TRUE
accacdd	TRUE
abdcbdcaddacccd	TRUE
acbccddabacacadcdcc	TRUE
dddbcdcab	TRUE
cbadccbdadcdcbcbdbadcacc	TRUE
cabccbcbdbadd	TRUE
ccd	TRUE
cccdacbacabadcbdcabc	TRUE
cdcdacabdbccccbcac	TRUE
cbdddd	TRUE
cddaccddbcbabdccccababcdd	TRUE
cdddacc	TRUE
ccdacacbdccbab	TRUE
ccdabcabdacadcdbddb	TRUE
ddaccabdbacdcacadccdccb	TRUE
dacbaccdcdcdbadcdb	TRUE
cddcaccaccdbdddbdccbcacb	TRUE
addbdadddcbc	TRUE
ad	TRUE
dcddab	TRUE
ccbcbdcbdddcac	TRUE
cdadbccc	TRUE
adccacdbcad	TRUE
ddddcbad	TRUE
cddababcababcdacabdcbc	TRUE
cadcbadad	TRUE
abcacbcdbcabddcdcbab	TRUE
abdc	TRUE
abcadcbadadacdad	TRUE
dadccbcbdccbdabd	TRUE
ddc	TRUE
d	TRUE
ccabccbcbddccdaddbcacdcbc	TRUE
acdabcbadddd	TRUE
dabdadbacdacccbccac	TRUE
dadabadaccbadcdabad	TRUE
dddababcddacdcbddbddd	TRUE
c	TRUE
dddacadbadddabacbccaddbd	TRUE
cdad	TRUE
adbdabdbcadc	TRUE
cacadacababcd	TRUE
cacabacdbcdb	TRUE
ddcadccabdcbdaccccac	TRUE
cccbdbdcbdbdbcdbdbd	TRUE
cdbaccbdcddcbdb	TRUE
ccacc	TRUE
addcdbaccccac	TRUE
cdcddcbdccdddcadd	TRUE
cadcbcd	TRUE
ccbabdcabdb	TRUE
ddddcdccdbcddd	TRUE
cdadccaddddbadcdc	TRUE
acbdbcc	TRUE
cbadccdbadad	TRUE
cccacccdcbc	TRUE
cdcddbcbacbdbc	TRUE
dbcd	TRUE
dddadbddabadccbabccccddb	TRUE
ddbaccdadddbccacabdc	TRUE
ddabcadadbcaccdbadadacabd	TRUE
cb	TRUE
dabcacdd	TRUE
dac	TRUE
dcdcddd	TRUE
dabdddadccadcddadcddbd	TRUE
adccbcdcabadbdcacabadbc	TRUE
c	TRUE
dcddb	TRUE
ddbacddd	TRUE
abdabcabcacabacbcadc	TRUE
cddadccbacdacddcabdd	TRUE
addcbacdcadcbdbccddb	TRUE
acdaddbdcbdbdbcc	TRUE
dbacdacbacacddcbcccab	TRUE
cbdddbdaccdc	TRUE
adcddbcdcbcbccadcddbdb	TRUE
cdaccaccab	TRUE
dcadaddccb	TRUE
cbcadadad	TRUE
abccadbccddddacdcbcb	TRUE
cacbcddcbddcbcabdcdbaddb	TRUE
dbddbc	TRUE
adcabcddcdcddd	TRUE
abccbcb	TRUE
dcad	TRUE
dcbabddbababd	TRUE
d	TRUE
cbcabddccbddcacdd	TRUE
adcdbacc	TRUE
abac	TRUE
adabacbcbdbac	TRUE
dccccccbdadcbcdbdacd	TRUE
cdabdcabccbdbcabdbacccacd	TRUE
d	TRUE
cadadbdbdadbaddaddbcb	TRUE
ccbacaddacadacb	TRUE
acbacd	TRUE
dabcdacabdbdcadc	TRUE
cbcbaddcabc	TRUE
cdbacbcdbdcddccb	TRUE
cccac	TRUE
adacccdad	TRUE
cdc	TRUE
adbcbdcdcddcccacdc	TRUE
ddbcdcccabcabdacb	TRUE
dbddd	TRUE
cdccddcabdabad	TRUE
dcdcadcbabddbadd	TRUE
ccccadab	TRUE
adadbadb	TRUE
cacaccad	TRUE
db	TRUE
acdbacb	TRUE
ccbddcacdcabdbdbac	TRUE
dcacbcadadcabdddbdc	TRUE
ddcddbacbadcbadcdacbd	TRUE
d	TRUE
ccbabcddab	TRUE
acccdbab	TRUE
ddbcbdacbcacacdab	TRUE
dbcbacbcbabcdcbccc	TRUE
dcbacbdddbdcd	TRUE
adddabccbcaccdacadad	TRUE
dbdddadcdcbdcadddbadaccab	TRUE
d	TRUE
dcdacdb	TRUE
acdabcbcccadcdcdbcad	TRUE
cdccbcbacddccabacabc	TRUE
cadbadacdcccbaccddcccc	TRUE
ccadadcbcbddcadcd	TRUE
cdccbadabdcbcdacdadbad	TRUE
cdabacbcdabadbddadc	TRUE
db	TRUE
dacbddcddbadcddddd	TRUE
ccb	TRUE
d	TRUE
c	TRUE
cbaccadccabd	TRUE
dbaccd	TRUE
adbaccbaccdbdcdd	TRUE
acabddbd	TRUE
abcddbdd	TRUE
adbccddcdddbaddbcbcdd	TRUE
cdddabacbacdcadacb	TRUE
cddbdcbcbcbcdddddbd	TRUE
ddcdadabcaccdcb	TRUE
ccbacaddad	TRUE
dacc	TRUE
acadddabcbcdbd	TRUE
ccbcddcdacbddccd	TRUE
acbccadabdc	TRUE
acabdc	TRUE
adbdddd	TRUE
dcd	TRUE
ccabc	TRUE
dcabddbcbadc	TRUE
adcddcbacadaccccbcacbadab	TRUE
ccadbcdcdbacbabcc	TRUE
dcacbabababcabdcdacadd	TRUE
abdcacdcdcdcccc	TRUE
cbccc	TRUE
cbdccbdabac	TRUE
dddccdacdccbc	TRUE
dacdccdcacdbdcc	TRUE
ccccbabdcbdbdccbd	TRUE
cbdbdcdbddaddadadcbcdc	TRUE
acdbcbdbd	TRUE
addacbc	TRUE
cccdcbcbccacb	TRUE
dbabdaddadbdcdbac	TRUE
cbddbcddccdaccc	TRUE
cdacabacdacdbdcbcbc	TRUE
adbdbabddcacd	TRUE
cabadacbabdadddb	TRUE
adbadcadadccdcadb	TRUE
abcccdbdab	TRUE
ddcccccccddcddccbcab	TRUE
ccdbad	TRUE
c	TRUE
dcdacddbdddcac	TRUE
c	TRUE
ddcbcbcb	TRUE
cdabdddcdcbccabcdc	TRUE
acacddbdddcddddabcaddd	TRUE
dabacdadcdadbadddbcccccc	TRUE
dbaddbccddccdabddbc	TRUE
ddddddddcc	TRUE
abdbdcb	TRUE
cbddadcdcc	TRUE
dcccacddcadcadb	TRUE
dcdb	TRUE
ac	TRUE
cccacdbcddcacaddab	TRUE
dadddbc	TRUE
acbccdabdacc	TRUE
dacdcdcaddcdabdcad	TRUE
dcdadababdbdcdcddcabacd	TRUE
adcddbdacadbc	TRUE
cacdbc	TRUE
dcadabcdadbc	TRUE
cccaddcbdacdac	TRUE
abcdbddddcb	TRUE
ccbcdbdadcdab	TRUE
ccdc	TRUE
dcbcdbabd	TRUE
acbabdaccdddbdaddabac	TRUE
cccacdb	TRUE
dbdbcdd	TRUE
ddbabadcbdcbcdddd	TRUE
acdabcdcbccacadcaddacadc	TRUE
acbcbdc	TRUE
acbaddbcdcbccddcddcddd	TRUE
dcdabcdaccdcddbdababdcc	TRUE
cbadadccdcccccbccdacbacdd	TRUE
dcddacacacdabcbadcab	TRUE
acadc	TRUE
adbdbdbdcabdadacabdad	TRUE
dd	TRUE
adddb	TRUE
abdcdcddcddbcbdccbadcacb	TRUE
acdcbdabdbacddb	TRUE
dcbcbcadabcbdcacaccb	TRUE
cdacad	TRUE
adddbaddcbcbcbdacdd	TRUE
ddbadcdbcdbabdccbcdabc	TRUE
dbacbdcc	TRUE
dcab	TRUE
adcdcad	TRUE
ccadacadcab	TRUE
acbdccbd	TRUE
abccdbacbacddab	TRUE
dacbccababacdddacdcdc	TRUE
accbcadacdbacbd	TRUE
adcddabddbddacdbdc	TRUE
addabcdad	TRUE
caddcbdbcd	TRUE
ccd	TRUE
dcdcbacdc	TRUE
add	TRUE
adcbc	TRUE
abad	TRUE
cccaddacabccbcacdb	TRUE
cababdccddaddabcaccdbccdc	TRUE
cdddbcaddadaccbccdbcccd	TRUE
ddcbcbc	TRUE
dcbdcccad	TRUE
cabccc	TRUE
cabcbdbacdccddb	TRUE
abacacbdd	TRUE
cdcbccdcdadbdabab	TRUE
caccadbcdadcccc	TRUE
adcdaddaddacabcadababacbc	TRUE
cddd	TRUE
acdcddddcab	TRUE
abaccdcdddacdcd	TRUE
cdcbadddbacdcdacacabdcadc	TRUE
dccbccdbccbdbabdcbcdc	TRUE
ab	TRUE
acccddcbcbcaccdccdddbacbd	TRUE
caccbdac	TRUE
ccccadccbdbcddb	TRUE
cdbdcadbdabdbdd	TRUE
ddabcccadbcdccddbacb	TRUE
accabcddab	TRUE
accabcdcd	TRUE
cacdbcbabcbd	TRUE
dcc	TRUE
cccbdbccdcacccdcab	TRUE
cccdbcddac	TRUE
cabcdad	TRUE
ababcccdbcadbcdcdac	TRUE
dc	TRUE
adadbacbaccdcddadbdbacbdb	TRUE
dbdcbdbdbddcdacacdcddad	TRUE
adcbcdcabadbac	TRUE
cccdbdcddbacacbdbcacbcdcb	TRUE
dbd	TRUE
ddbdbdabcb	TRUE
dcbcd	TRUE
dcbdd	TRUE
daccabcdcc	TRUE
dccbacdcacadabcabcd	TRUE
cdcadcdadacbaccbdbdcccdad	TRUE
ab	TRUE
cccbcddcbdcabcdcc	TRUE
caddddccbccdbabdaddadbd	TRUE
cbcdbccbddc	TRUE
ddc	TRUE
cdbcccb	TRUE
ccdbc	TRUE
dccacbacbd	TRUE
dcdbdccaddabac	TRUE
ccab	TRUE
dbdcbaddccccbaccbddc	TRUE
cdcbadadcbababadcdcdccc	TRUE
daccddccdcbaccadabdbdc	TRUE
dccdcddcc	TRUE
cadbc	TRUE
adbadcacbdcac	TRUE
dbddacdccadbc	TRUE
ccccdcdddbdab	TRUE
dbc	TRUE
dbddcbcbadccaddbabdddc	TRUE
addcccaccbdadddd	TRUE
dccdacccdddcabad	TRUE
cddadadbabcdbccd	TRUE
ccc	TRUE
cddcbcddaccdcccdcbddabc	TRUE
cbdccdccd	TRUE
ddc	TRUE
ccccabdcbacbdccad	TRUE
dacaddcabdccd	TRUE
addccdcdcccaccc	TRUE
acdbddcbab	TRUE
c	TRUE
dcacccacccaccabdacd	TRUE
adbcdddacdcdddbc	TRUE
cccbacbdcbacbdbcacdbcbcd	TRUE
dbaccacdbadccacabd	TRUE
cbbcadcbac	FALSE
dbdccaacaddaabbaa	FALSE
cdbdaacbacdcdc	FALSE
bbccbbdbdb	FALSE
accabbbbacabca	FALSE
adadcacabdbdaa	FALSE
bbbbaccdcbbdddaadbbdd	FALSE
ca	FALSE
daadcdcccbdbbbcddcacbc	FALSE
cadccbbcdccdbcdc	FALSE
cbabcbdaab	FALSE
bdccbcd	FALSE
ada	FALSE
dbcbbcbdcbdccdcdd	FALSE
dcdaccbcbcacbb	FALSE
aaacacbccbaca	FALSE
dadcaabcabbcdd	FALSE
bdcd	FALSE
bbaaabcbcdadbbdddaaba	FALSE
adacdca	FALSE
bcbbabcbdca	FALSE
cbccdbbabbbddddbcbabda	FALSE
adbcdbbbaadbdcacd	FALSE
dddacabbacaaba	FALSE
adcbbabbdadcdbcabdd	FALSE
b	FALSE
acdcbbbcbbbbbcdc	FALSE
bd	FALSE
baaaaaa	FALSE
cbcabbaa	FALSE
cdaadc	FALSE
cdacbcbababadbcccaabcbcbb	FALSE
bacddcbddaac	FALSE
ccbdcbcbaccabaaccc	FALSE
dbbcaddaacacdabcadabaab	FALSE
bdbacaddaaadbadcdabcb	FALSE
acdaabcddbcdb	FALSE
aaccabbcbbadccdddbdb	FALSE
dabbdbbcbddbabcaddaacbdd	FALSE
dbbbbc	FALSE
bdad	FALSE
adcbaabaddbdcbcdddbddbcb	FALSE
accabdbdbbadbaaccadccd	FALSE
addccaacda	FALSE
a	FALSE
bccaaadabbcdbabbbcaacd	FALSE
ca	FALSE
bdc	FALSE
aa	FALSE
ccddcddddaadcaadab	FALSE
abbddcbdddbacadacdaacb	FALSE
abdbca	FALSE
a	FALSE
acbabcbb	FALSE
aabbacbca	FALSE
bacbadb	FALSE
bccdbb	FALSE
cdcdbaab	FALSE
dccadddddcbbddabadaaaab	FALSE
cdbcdbba	FALSE
cbcbaac	FALSE
a	FALSE
cabddaaaacbdabcbccacca	FALSE
dbcdcdabcacaababaa	FALSE
dcbbbc	FALSE
acbcdbbdddccbac	FALSE
acdccddacccabbba	FALSE
caadddbdcbbbcabbbabda	FALSE
cabbbdacacbcdbbc	FALSE
ba	FALSE
baddabcddbca	FALSE
dbabdbbccd	FALSE
adbbbaccabddadcac	FALSE
cddddadcddacaadc	FALSE
cdbabcbbaccacddaa	FALSE
ccaaddccababcadbbdadd	FALSE
aab	FALSE
bacabbbdcadadc	FALSE
bbac	FALSE
bddbcaacacaccddd	FALSE
abbdacaaaddaabcdcacadb	FALSE
aabcbcbbcbbbbbdb	FALSE
bd	FALSE
addabcabddacada	FALSE
abdbbbbdadddcbb	FALSE
bcbdccbdbacbdaadabbbba	FALSE
cdddadddabbbdbcdca	FALSE
bccbbaacdbccbc	FALSE
daddca	FALSE
baa	FALSE
cbb	FALSE
bddabcaca	FALSE
bcaddbabcdbddcddbbddadbd	FALSE
caacdbbcadabdbbbbdbbdd	FALSE
dcabbdcdddcabcbcddadcac	FALSE
baabacdbc	FALSE
cacacbdacbdccbbabdccdba	FALSE
dcdabdbabbdcc	FALSE
cbddaccdadaaacbccbadc	FALSE
bbaadacdbaccacc	FALSE
acabbdaccadcdb	FALSE
ccbacdadbdccacddbbaccdac	FALSE
b	FALSE
bacbacdaaaabbbaa	FALSE
dbddcaddadcbcaa	FALSE
bbcdbdacdabbabdacacdcbc	FALSE
baccbacdcaadbabcdccbaabb	FALSE
adcbdabccba	FALSE
dbadaaccabcdcbab	FALSE
cccbcbcdccbbca	FALSE
bcadcbabc	FALSE
bbabcaadaadbdd	FALSE
babcdadaacd	FALSE
abbdadabbdccddacd	FALSE
a	FALSE
acaadac	FALSE
dbaaabdbcdcdcacddbddcc	FALSE
bcabca	FALSE
bbdb	FALSE
cbbadadabc	FALSE
ccbcbada	FALSE
bdccdbccabddbbcbbbbab	FALSE
bdd	FALSE
badabbcdd	FALSE
bccccbcdb	FALSE
cbbadcba	FALSE
bbdbcaaabc	FALSE
dbdacadccabcbdda	FALSE
bbdbcadbdddacdd	FALSE
baacac	FALSE
abbcccacdccc	FALSE
cbcddabaacbcdacaacd	FALSE
aadbdbdcbad	FALSE
bcbbc	FALSE
bdbdbcabdababbdbbccadacd	FALSE
ddaca	FALSE
ddaccbdacaddacaa	FALSE
bdbabbcdbaabd	FALSE
acdcccdbdbbb	FALSE
dba	FALSE
bc	FALSE
bbbccaaadcac	FALSE
aadbdbddccbbdbdaaadbbbd	FALSE
abdadabbda	FALSE
dda	FALSE
aaccbbabcadcbdacdbcdbda	FALSE
ddbacbabdbbcdbbbbcdababb	FALSE
acda	FALSE
bbbacddbadcdbbdca	FALSE
bbbbcabcacdccdbdbcaaab	FALSE
bcdbaccdadcbbcabd	FALSE
dadaabcdcdaddbbcddb	FALSE
ccccadcdbbaaaacaabddbcaa	FALSE
acaddccabbcdbbabbababbbb	FALSE
cbbcda	FALSE
abbcddbdddaadacccddbada	FALSE
adbdbcadaaaabd	FALSE
acaabdbbdcbddbcca	FALSE
cdbaaaba	FALSE
aabcacdaabc	FALSE
daacdcdddcbdbadbcab	FALSE
bccacadaddbcaaaddaccacbb	FALSE
bcbbd	FALSE
dacbbabbcdbaa	FALSE
ccdabdcdddbdbabaaaacbcdbb	FALSE
adaadbbbdaabcdb	FALSE
cabaadccaa	FALSE
dcddbaaabbbaaadcdbc	FALSE
ddacaba	FALSE
bab	FALSE
ddaaddadbbaadaac	FALSE
bdacbddcdbbccbdcbdd	FALSE
b	FALSE
cacddbbcbcdacba	FALSE
aaddbcac	FALSE
adbdcaadabcabcdbbbcadbdc	FALSE
ccadca	FALSE
abddbcdccbcadcabbacaccad	FALSE
cadbcaaddaddacdadc	FALSE
bdca	FALSE
ddacbdaabdbacccd	FALSE
dcca	FALSE
ddcbb	FALSE
bcccccbbbaacacabadcbbabd	FALSE
b	FALSE
bccb	FALSE
cbaddbada	FALSE
dcaacacdccd	FALSE
abcbdcccabdcbcbaabcd	FALSE
a	FALSE
ba	FALSE
cacbbbdacacdbabdc	FALSE
caabbad	FALSE
dccbbbdaabddaaabdd	FALSE
abca	FALSE
accdcaadcddddbb	FALSE
acabcccbaddbddbbdcdbacbdd	FALSE
dbbdcbbaddbaaadbbaccad	FALSE
ccbcdaaaaaa	FALSE
a	FALSE
bbdaabbdbbb	FALSE
cbaba	FALSE
dacaaaabbadba	FALSE
acbbdccbbbaccdd	FALSE
aac	FALSE
accbccdaacaadc	FALSE
cdbbcaadbcaccdaabdbacbaa	FALSE
bdabbaccdcddcabdaabc	FALSE
daadcadbddaaaabd	FALSE
bdddc	FALSE
dccbda	FALSE
aacbcbadaabbc	FALSE
caaababdddadbdaadadca	FALSE
dbbbbcabbbbcddaaa	FALSE
aadcdaaccabad	FALSE
bbcaccc	FALSE
acaacaabadcdbbbd	FALSE
adbcdacabda	FALSE
a	FALSE
dcbbccacdbcdacdacabbcdd	FALSE
cddbaabdbcaac	FALSE
cddbccbcddcddccbaaddcc	FALSE
adbbd	FALSE
bccacaadaaaab	FALSE
bdccadababacdcaadaaca	FALSE
ddcddadccaabdccad	FALSE
aabcdaaaacdbddbbacc	FALSE
dbdbdbadaddaabaccdcdcdaaa	FALSE
aaadc	FALSE
bbccdaad	FALSE
abcaaabb	FALSE
ada	FALSE
dcbbabbcac	FALSE
bdcbdacbcacc	FALSE
bbacadadbcd	FALSE
adbbabcbaccddcbdcaddacdca	FALSE
aacccaccdbcdd	FALSE
acabccdbdacca	FALSE
aaabcacdabbacdbaab	FALSE
cdcbccbdddcaacbabcb	FALSE
abaccddadbcbacbbadab	FALSE
bbbac	FALSE
abcbccbbbba	FALSE
cbaca	FALSE
bccdcdbcaabcacacdbd	FALSE
bab	FALSE
bbbaadbcbdbbccbaaa	FALSE
accdadaabbcbdacbdadc	FALSE
ddbbdcda	FALSE
a	FALSE
dbbbadabbdbbbd	FALSE
cbbbbaadbbb	FALSE
bcdcddbbabdaccdddb	FALSE
acddcdccabdddbbcdbaa	FALSE
aaaabcdbdcda	FALSE
bbcaccdcc	FALSE
cdbbcbcbb	FALSE
ccbdbbbcbbccdacaddcdc	FALSE
babadadddda	FALSE
bbac	FALSE
cbadadaaac	FALSE
bddbddbaaddc	FALSE
daabddcbabccaddcbdbb	FALSE
abbcadba	FALSE
bc	FALSE
dabdcbdacbbdb	FALSE
baaadbddbaddcbca	FALSE
dabcbcada	FALSE
badbbcca	FALSE
acbbadcaccabdbddbbbdadadc	FALSE
bcdcbbbdbbb	FALSE
daaccd	FALSE
dcccaccddcabbddabcacbdbdc	FALSE
acaddaccbddddbbccaaaddada	FALSE
cdcadaabbadca	FALSE
bcaaccccacad	FALSE
adcba	FALSE
dcdbadca	FALSE
badc	FALSE
acdadaadccaabbadaabacbcdc	FALSE
cccbcaadcbdb	FALSE
bcb	FALSE
babca	FALSE
cbcadbbcdccbbacddcadaaba	FALSE
dcbdbbcccaccabcdbbcddca	FALSE
bdabdcacaccadbcb	FALSE
adbabbbabb	FALSE
ddbcca	FALSE
bdabc	FALSE
ddbbdabbaddb	FALSE
ba	FALSE
acccbbaadbdacbbc	FALSE
ccabcdbbaa	FALSE
bbcc	FALSE
bccbcdaaacacdcaabaabcbba	FALSE
cbbdadabaddc	FALSE
bbbcbccabaccbadbaacbba	FALSE
bbb	FALSE
baabdbacdadbaad	FALSE
bbcdaddbdbaabdcc	FALSE
bccdbbbcaccaacaadbcbdbcdb	FALSE
acbccabcabdbdadaddbada	FALSE
dcaaabacdbaca	FALSE
daabcacabbac	FALSE
cbadccbbbabbbababbadba	FALSE
bbccacaabddcbbacbbcdb	FALSE
cbacbbadbbdcaccab	FALSE
bdb	FALSE
bccdcdcbacdbcbadcd	FALSE
adcddacccbcbccdddcdbaadcb	FALSE
dbaabca	FALSE
daadaacdbcadcdddcacab	FALSE
badbdddaaadbbddaaab	FALSE
ddbbdcbddcadcaddd	FALSE
badddcaabddba	FALSE
b	FALSE
ddaccdbabcbbbbaadbab	FALSE
cdabddbbadbcc	FALSE
adacbbcbcdbddad	FALSE
ddaabdcabbbaccbdab	FALSE
ddabb	FALSE
bddcd	FALSE
cbbdccb	FALSE
bcaabaacaccdddddbbacddc	FALSE
cdbdbcdbbcdacdddcbbd	FALSE
ccdcda	FALSE
bdbcacbbbacbaacdbcab	FALSE
bbdcbabdc	FALSE
bdbbacddbbbcbacbcbddc	FALSE
acddbaacdbabadcabaabca	FALSE
cabbabddbd	FALSE
aaaabccdcddadcddbacc	FALSE
aa	FALSE
aa	FALSE
dcaaacdbbdbbbdbdcabdcdacc	FALSE
abbbcbcdd	FALSE
dbbadabdbacdadadda	FALSE
bcccbddcabaacbbdbdaaba	FALSE
ba	FALSE
babdbdabddbbbbcbcbccaabb	FALSE
abbccababdacbabbb	FALSE
bcbacaadcdbaccbcda	FALSE
ccdcbbacdbaabccdd	FALSE
dbcbdcaa	FALSE
baaadaddb	FALSE
ccbadbcbaadadca	FALSE
acda	FALSE
cbaadaa	FALSE
acabaccdbadbba	FALSE
cdbddadccdddbddbdcaabddba	FALSE
bdbcbcdbb	FALSE
bacaaab	FALSE
acdbdddbcbaaca	FALSE
abbcccacdbbcbbccacaacbd	FALSE
bdaccadcaaaccbcabca	FALSE
dbbb	FALSE
bddddbabdabd	FALSE
baaadcbaadcadacdadd	FALSE
bbabcbbcdaacdababad	FALSE
bcaacdaac	FALSE
dbdcdcdbbadadda	FALSE
dadadbdaaacacaaabcd	FALSE
cbdbacbcbbaddd	FALSE
dcadacbaaabc	FALSE
dcaaddbbbdcdabaddcc	FALSE
bbdcaca	FALSE
acbabdcba	FALSE
bdccaac	FALSE
a	FALSE
bbcdab	FALSE
adddbcda	FALSE
bdacc	FALSE
cdaabbadcbdbdcaccacba	FALSE
dcbcaacdbb	FALSE
aabbaabddadbaadbadbbcbb	FALSE
bbadaacdcbbaad	FALSE
aadcaadaa	FALSE
dbbbbabdbddacbcbba	FALSE
dbbdabadcbaddbcbbabbc	FALSE
ca	FALSE
bdcaaddacbaadadcc	FALSE
bad	FALSE
acaa	FALSE
cddbcddbbbdccdadbabadcbab	FALSE
dbcbdbadbbddc	FALSE
abcbdacddabbbda	FALSE
dba	FALSE
acadcaaaaa	FALSE
dcddcaad	FALSE
ca	FALSE
cdbbdcc	FALSE
bbccbbdaaacbcdbabcddcbd	FALSE
dccaadddccb	FALSE
babccda	FALSE
bbbabadbacdddbbdacac	FALSE
bacbcabadcccabdaa	FALSE
aadcacdbbcbabcc	FALSE
bcdcd	FALSE
cdbacdcacadcdbbdda	FALSE
ccbcccbbb	FALSE
cababdabaacaaca	FALSE
dcdaaddcdbbddbddcacc	FALSE
daacaadcdbddcacbabacbcaa	FALSE
aababcdddbbdca	FALSE
baddbbca	FALSE
cdaccabbbdb	FALSE
ddccbaabda	FALSE
cccdbdcca	FALSE
bdccdaaaadddcaddbacbddb	FALSE
cbacbdbaddabcbbaacbbbdc	FALSE
bddcccdbdacaccd	FALSE
bccbbabbbaaccabadabca	FALSE
dabbddabaddc	FALSE
cbadabacbcdcccdbccca	FALSE
aacccabadabacdabdda	FALSE
aa	FALSE
cca	FALSE
acdadaaacbccbdbabdccaabaa	FALSE
babdcaabbabaccbbaddbb	FALSE
ccaaaabb	FALSE
bacdba	FALSE
abdabbaabccbadadccbaddadb	FALSE
acddbbaccaacbad	FALSE
cdcaccacdacbdbbdbccdbcc	FALSE
cccbbadbdbcbacdaab	FALSE
aaaddcdcaabccbb	FALSE
dbacbbbddbcd	FALSE
ddaaccdaadabdb	FALSE
cacbababaa	FALSE
b	FALSE
aacbcbdbccddacdbbbcc	FALSE
bcadadcaababcbdaca	FALSE
a	FALSE
ddbacbacba	FALSE
cbbb	FALSE
baaddbacbad	FALSE
ba	FALSE
ccacbccbcbbbbdcdbdbd	FALSE
bba	FALSE
dbbbcbcacaccdabccaadc	FALSE
b	FALSE
bbbdacdac	FALSE
cbadbbddbdddbbdaddabbcb	FALSE
bcad	FALSE
b	FALSE
dbddcacbacdbdcbbacdb	FALSE
ddaaabdccda	FALSE
cdaccaca	FALSE
addddcaaaddbccaccad	FALSE
abacacdbbaacccddaadd	FALSE
cacdcdacddbdcaacbaadbcbb	FALSE
a	FALSE
bbcacbbdcdbccdbadccabccda	FALSE
aaabccbcddbbbcbcbdd	FALSE
dbaaacadbccdddbabacb	FALSE
aabcca	FALSE
b	FALSE
daaabaaacabab	FALSE
bbcbdddbacbaacacbcb	FALSE
bc	FALSE
ddcbba	FALSE
bdbbdc	FALSE
ccdcddcbacbbaadbb	FALSE
da	FALSE
cbda	FALSE
bddabbddbdbaaddabbcbccdbd	FALSE
cbbdcadcaaadbddabacaa	FALSE
cdbcbddccccbacbbcd	FALSE
dbddbba	FALSE
bacbcaccdcd	FALSE
dbaadbbbcbcc	FALSE
cba	FALSE
bcbdaadcdccabbccabbaadddb	FALSE
dcaba	FALSE
caaaaadabccbc	FALSE
dbdccbcdccdbccbaaaadcdd	FALSE
bc	FALSE
bccddabdbddcaadbaddccd	FALSE
dcababcccdabaadab	FALSE
dcadaadbbddaccbcdcaaca	FALSE
caad	FALSE
bcbacdcdbaac	FALSE
baca	FALSE
dccdbababaddababbbbac	FALSE
dcadaaccddcacccadbabbadac	FALSE
caaadbdddadacacdddcdaddd	FALSE
aadbbacbadbacbcbcd	FALSE
acddbbbbbbbcbaaa	FALSE
ccccdbbddbacbbcdcbcdacc	FALSE
bacac	FALSE
daaaa	FALSE
bacdbcddcc	FALSE
dabaac	FALSE
dabbbccbdcbadcdaaa	FALSE
cdcbbac	FALSE
ddcbdccbacaacbdadcd	FALSE
dccdaab	FALSE
cbcdbacbbbda	FALSE
acdbabbaabdbbcdbbadb	FALSE
bbacbcdcddb	FALSE
