fcgghhaejfdfjdicjdf	TRUE
bdchj	TRUE
ddfbgjbhhbbeafdjhdfichf	TRUE
fjbg	TRUE
ih	TRUE
cbjifjjcibdgiigbifddahgb	TRUE
gihdg	TRUE
a	TRUE
bfdjbgbdjciaejiajhdghaii	TRUE
jjegjbbhbafaejdh	TRUE
hicefbjbjffhjhijjiaecd	TRUE
jfdbcafedchjfebf	TRUE
cjhdcdbbdhiej	TRUE
abighichbbgiiddecigadbbhe	TRUE
dhhbeh	TRUE
gjbehfdehcdd	TRUE
afjjf	TRUE
cabchefegg	TRUE
iia	TRUE
jh	TRUE
chbgfjah	TRUE
eeabffehgjiaidafh	TRUE
idfaijchdf	TRUE
fffbdjcfchdjddfegggdfehgh	TRUE
ji	TRUE
gba	TRUE
jjbighde	TRUE
higjgcggiidiebbaj	TRUE
jjgdgcjjbdbcbabjgfaabihf	TRUE
gedcehhjbggijde	TRUE
bhifhcggbif	TRUE
jciebhgh	TRUE
fdhjc	TRUE
bicigahie	TRUE
jafjffgab	TRUE
chfacbbgheheea	TRUE
bfgdajfjgefaafbgaeab	TRUE
gefdbedcehhia	TRUE
fhcfffjafejjhggbedgije	TRUE
ifegdg	TRUE
d	TRUE
jhdcdbdjfhficejhefg	TRUE
b	TRUE
cfaeijidbj	TRUE
chcjehbhfddfgaigfd	TRUE
gcggcahgf	TRUE
ih	TRUE
cjjaeaechciaecdcfighd	TRUE
ghfhehjcacfighf	TRUE
dcedfe	TRUE
bgfieidjhjdbbg	TRUE
bifijedfajdcfjibb	TRUE
abgegeghehdcjcgiidbidg	TRUE
hfbcbiggddg	TRUE
ehjijcac	TRUE
cfjhhjejib	TRUE
a	TRUE
cjheiaiddhccccebb	TRUE
eacjiejcggdebjhjfjedd	TRUE
hfjbggbacjaafffehchc	TRUE
gjgebgaigjjedjbae	TRUE
ibhjb	TRUE
abgfedbeafcbhjeahe	TRUE
ghihdbicfccddaj	TRUE
bfjchdebdii	TRUE
icfgiafgcbegfbadgg	TRUE
ceggfhcihbdaihhehj	TRUE
afghaigefgf	TRUE
agaehdhddbgbcgibhfifejhbg	TRUE
ce	TRUE
dieigaeiaijdgfjd	TRUE
heiegiceiicbc	TRUE
bdghidfgbgccahccdcghb	TRUE
ebgahfccg	TRUE
hgeegchhj	TRUE
gfbfhafgcajfggaj	TRUE
gh	TRUE
hejij	TRUE
dfadajhc	TRUE
fiaaegihgdebhib	TRUE
ce	TRUE
ibcfecaddaeajgddgbaiejceg	TRUE
fdd	TRUE
bbgcbdffjfbhbjdbheahj	TRUE
eficafeefhd	TRUE
chjddecbhhjfdajg	TRUE
a	TRUE
bfehb	TRUE
iigfdbbjhacaee	TRUE
hbcfifccdbgccc	TRUE
aedh	TRUE
iaedeejhbiie	TRUE
hgegfjcihcadgagcad	TRUE
gigjihia	TRUE
ggfjgiedhgdcahhiece	TRUE
fbfjaeejacagif	TRUE
ij	TRUE
abcea	TRUE
ejefjdccei	TRUE
ig	TRUE
bdfhiif	TRUE
fcfccgdiadbcaabcdbibeifeb	TRUE
hcfaiiecgdjdgdeaj	TRUE
cdbje	TRUE
dae	TRUE
jieggjbijbhdecgjijbbcf	TRUE
hdecddefeg	TRUE
ajifhejb	TRUE
g	TRUE
cjeiheabb	TRUE
hjacjfi	TRUE
jhead	TRUE
eicfi	TRUE
jafgba	TRUE
ebafccajieefidff	TRUE
f	TRUE
jajgdcccgjcfhih	TRUE
jbibhdicehigcegbac	TRUE
baeaafebeefa	TRUE
agiddhejfifeig	TRUE
ecag	TRUE
fihfhbgbhifgigaeiebffch	TRUE
jebiddbgbafi	TRUE
heecedfeeeiahgchibdgec	TRUE
chbefjfgddhbid	TRUE
ighhcfiacfehfbfecfidhbdb	TRUE
eabgjbhh	TRUE
gjadiaifi	TRUE
djafggiacfidbbfg	TRUE
b	TRUE
cgfeadgddifdicb	TRUE
ggcaccjjgaidded	TRUE
ijbabccagg	TRUE
dce	TRUE
cghddc	TRUE
agfi	TRUE
biaghaebaiedhfgde	TRUE
ffihifheihaddidjfbc	TRUE
afchafbaeb	TRUE
abbahebefdf	TRUE
bicagceigdjgjjeihddgjcji	TRUE
cg	TRUE
cfcajdbjcaehfcddebi	TRUE
cfihafgdbhcjbbaaideeb	TRUE
jjhciegfejeegagh	TRUE
bjjafcbjgaeffaj	TRUE
hfc	TRUE
hibjaeageegcihbggegd	TRUE
jjebeifajiafhhe	TRUE
babhedebgehhcgejcgf	TRUE
idhdbbcicgcjig	TRUE
h	TRUE
gbcjgee	TRUE
cjic	TRUE
efdjdbbdeidjhjaabheaab	TRUE
cebhcfibaacgfhdf	TRUE
aggdehaebejjegaaeibegdcg	TRUE
ffca	TRUE
dcfgcdhdhdfghifhagjbiah	TRUE
abghjggcadfhchcgfhbaaddi	TRUE
ghae	TRUE
fbjbaeehadfeidbiigcabi	TRUE
cajabhbbheafhdhjbbehhjj	TRUE
cehdgihabjfcgfbigiif	TRUE
jcfigggcahchfgefdfihfifec	TRUE
e	TRUE
fajcaehaffbehfacjd	TRUE
fedaejghcafjbejdcdijaahif	TRUE
fdiccgec	TRUE
ah	TRUE
jigfeadhjeidfcjbeegeaai	TRUE
aabbi	TRUE
gjihjfbffdeaeibecabjfgb	TRUE
dddjaefijciifdehdfjbiiaej	TRUE
iedfjf	TRUE
fgcfjcbdifdageffdgac	TRUE
hjbjgcdcebaei	TRUE
hffigdbchda	TRUE
cfaghacadhi	TRUE
dhdhfdf	TRUE
heijji	TRUE
cde	TRUE
hgeief	TRUE
dbjbcjfedgcifhbidhhgbe	TRUE
dhgijdhfgeicdfjgbcgh	TRUE
haefgich	TRUE
hdgcbihhjcfbggdhd	TRUE
jhg	TRUE
gidfffgieihhgjjdjdhbddhg	TRUE
ghgide	TRUE
hhdhaeh	TRUE
gajfgibaaejjbehdhhaijh	TRUE
eijbfhgjhbjdificgj	TRUE
aa	TRUE
ffded	TRUE
dghdjfjeibbjhbjb	TRUE
ja	TRUE
bidfeaaafiajagigahaii	TRUE
cfidjddjaefjhi	TRUE
diefgiceb	TRUE
cdiiidicgifajfeejdeaccbih	TRUE
jebccfffgjfe	TRUE
abhdjbc	TRUE
icghahhhifbbbahfchcg	TRUE
djefcihfejbbhaegddhfecf	TRUE
cacfdajejfjbi	TRUE
fciidjc	TRUE
hdbaebechbejddegeicag	TRUE
aihjdificbebaddehcha	TRUE
jgdigdbfgbiceefidahicehf	TRUE
hgiajjhjbghdgde	TRUE
jedbbgeihhbfffa	TRUE
fjijdji	TRUE
dbgjbcdadgijfgfjd	TRUE
cdejhagaddiaagabgehghgd	TRUE
ddiaefgafahjdj	TRUE
e	TRUE
hbdi	TRUE
icjjbeafd	TRUE
fbjgjbdhcebfabej	TRUE
gdcj	TRUE
ejegbjjebaigebhfihaaf	TRUE
cdhedhb	TRUE
gagjdjggdcgdijdgfd	TRUE
gacfbjagibdib	TRUE
jiefjiffcj	TRUE
djedgcdcdag	TRUE
ehgaggbicicgb	TRUE
bcejjgecdabf	TRUE
dhgjgfg	TRUE
dafgjbbfaijea	TRUE
j	TRUE
eigi	TRUE
dbabbfgddjiibdhacadabjh	TRUE
edacddgebfhifcedjaihdabb	TRUE
ajcjdefahaadgcbjbbbcajj	TRUE
gfgfgjjbjjjjggjjdh	TRUE
agdeijcjig	TRUE
fhdijfadaheeahg	TRUE
eagegghiide	TRUE
dbeffefihghic	TRUE
jedbigb	TRUE
fgficfdafbbd	TRUE
jdbeccfhbddchdbh	TRUE
hcacgjach	TRUE
jjjjefifgbgfidfd	TRUE
aaicecghdaifaghdigccehfbi	TRUE
ebcgdcbicjh	TRUE
jhgffdafadciai	TRUE
gcbdj	TRUE
ajda	TRUE
hgcgjjhjaeheeefiedifhfi	TRUE
d	TRUE
f	TRUE
geebecjddgibfbacgdjfai	TRUE
didcbceg	TRUE
hibghjihgi	TRUE
bbebhddhfeeij	TRUE
hejjegfbfaagiheebgaji	TRUE
bjahhiihfeiejfafecfdcjicd	TRUE
dgdhcicdffgie	TRUE
cdbfgjdbggbjehjdgjh	TRUE
aefigjbcgcceajcddjd	TRUE
diedacagjcifdcc	TRUE
dj	TRUE
fhehiibcj	TRUE
hdhigbgaefeacffjbebd	TRUE
hgeacdciajejfbbicijai	TRUE
aihfgedfjacbidcdghfjd	TRUE
gcc	TRUE
bieg	TRUE
hjcbf	TRUE
abeibddfjbj	TRUE
bgifhhdehhaadbaeehdaci	TRUE
eeejaaiadgbghfhcjg	TRUE
abdi	TRUE
ejfeidf	TRUE
cjajdjjb	TRUE
hghgajdfiaif	TRUE
baebegcajghafdcfcahbiiac	TRUE
ajiddibebhi	TRUE
gajigdffhgbeff	TRUE
jgi	TRUE
jgeegdda	TRUE
bedjjfbchiccdgcacg	TRUE
aafbgcbi	TRUE
dhjcibejaigbgeebigd	TRUE
iafjge	TRUE
acaceb	TRUE
hiacfibdgjdjidcfiidcfcjff	TRUE
aehbjdffbheibchhjbi	TRUE
higjjheefahffcideda	TRUE
ehaaeiadidhhfhbh	TRUE
bjejacaccfhgcgiahjjafaic	TRUE
gafcdiejdcejfhgjajidgg	TRUE
aegcidgaibecedafehah	TRUE
gaebbbfiegag	TRUE
ceejjfd	TRUE
giibib	TRUE
iddiffedggfjjbhgijfabae	TRUE
affejbehefhbhahghe	TRUE
eijcdfdjhhifibiagjhb	TRUE
jbfcfhabefdihdidheadh	TRUE
hacaiigjhbefafibijc	TRUE
jhibihgca	TRUE
gdfajfddchcfbfehifb	TRUE
gffbiegiaiifijiijgi	TRUE
ceefjfdhicgagedeaghi	TRUE
feacbhiifghfgca	TRUE
jgafbahiiefeadf	TRUE
bhbjebjjdihegjbfhd	TRUE
ec	TRUE
heceggecfabefcgfaeaiagf	TRUE
hhdbhagdjb	TRUE
cehdafehc	TRUE
ahiabgdbhgccfdjjheagaieje	TRUE
iiaeg	TRUE
gdfijcehehjbhfejj	TRUE
aeahegeifbgghc	TRUE
dhbchedffide	TRUE
cajdeheeeaehadcighgi	TRUE
adbgabdjiggddbejccfiii	TRUE
jedjidaihhahjjbhejbdg	TRUE
eieiefdjid	TRUE
f	TRUE
ejghacgeeacc	TRUE
di	TRUE
jiecadbbaddf	TRUE
bcgagag	TRUE
achbjcddb	TRUE
abbbhhj	TRUE
ibj	TRUE
hifaijaaiidhd	TRUE
bjci	TRUE
hfehdhebeeiajdi	TRUE
cihdfghdaceeb	TRUE
efigdd	TRUE
jiibfhhfjigciiedcijacd	TRUE
d	TRUE
dadfadhbihbdhcbih	TRUE
dgebjefdbdbggcdjbcche	TRUE
cgbjjgfd	TRUE
efhcfhfjjebdgjiei	TRUE
hbbbfgedbejebbfgh	TRUE
ihgfeaigecfhahabbijedcf	TRUE
decfiihbhccbbeebfda	TRUE
jeg	TRUE
adbbjfjaadiegihfjdhjcfi	TRUE
ijebagbiafbhaceh	TRUE
ijahdedjedidf	TRUE
icgaaaihdghcacedjafiifdac	TRUE
ffii	TRUE
jcacjhfceedghadaccdcijhgh	TRUE
jibhafabghfja	TRUE
fdafaj	TRUE
fijieahdhfgjdhbd	TRUE
feeaacjbbhbjcjh	TRUE
hhjbigebhbefffdde	TRUE
fbdfeaccfcebbdibejajfdbbj	TRUE
fecgiggbcghfhchcgfc	TRUE
bijhbibhbhhahdfiabhich	TRUE
ihaeejcgejcidaggcf	TRUE
idfgdieideheghcbiaj	TRUE
idjbgahhafgjegabbjdfi	TRUE
fddieehidejiad	TRUE
chegfhdbbahecehidd	TRUE
aifhahb	TRUE
ijafjgagcchhdbifbahdadhb	TRUE
beffgjchaecfgaeibi	TRUE
ahfijdjgbeabdgajb	TRUE
dgjceh	TRUE
eieafcdaccac	TRUE
cje	TRUE
fjcefbgicij	TRUE
gjia	TRUE
hedfaihbddgfidiejgd	TRUE
gidjhgicababcg	TRUE
caegjihjfiibajieg	TRUE
e	TRUE
ddhcchjeddjccac	TRUE
jih	TRUE
hfbagcadigfa	TRUE
aechffjh	TRUE
jfibgfhcffeghh	TRUE
jbedjbddfchcghafgbcbhhc	TRUE
adf	TRUE
dbggcbgbdjc	TRUE
bbjbechbeccdbifdbhcib	TRUE
jcijeiif	TRUE
bbhhgebehjggb	TRUE
aaejfgghebdjgcejf	TRUE
ii	TRUE
dajeihaaaed	TRUE
ddefabhhdaedcjgjafjghb	TRUE
iecfcfaijjiegcehe	TRUE
giighcbcdfcd	TRUE
bjgfbcgicbcdfgjdaajehad	TRUE
bdbhjiccdjdfegf	TRUE
biahg	TRUE
ajed	TRUE
jfdgchbcjgidcagbgeed	TRUE
cbjhghbbffje	TRUE
cfhhciafid	TRUE
feiebgdb	TRUE
biedaj	TRUE
dcafegeiceiaaj	TRUE
hagddcjg	TRUE
hfcfefebbafbacgc	TRUE
aaeb	TRUE
hbefgca	TRUE
iaggidiefhfchcbbhbdid	TRUE
e	TRUE
fdhdejijf	TRUE
aiagigdaihc	TRUE
fdfacajaghjeeiaefehdhec	TRUE
hdjgfgdjiaghigjhif	TRUE
fdcabccchjijficgbjcbji	TRUE
ehahcachcigdbdgbihecbi	TRUE
gbhbdihegjigb	TRUE
acicjibiddjfdihihdc	TRUE
bbjbahidghifbdbgiebj	TRUE
gabdhiafgibehafabgji	TRUE
hjchi	TRUE
cigddeeced	TRUE
bhfdcjijbjffjfiegi	TRUE
hdheee	TRUE
eajcjdjdf	TRUE
fbedbhibbbgjfgighgab	TRUE
hijdi	TRUE
hcidh	TRUE
jjigicjjjacig	TRUE
djidfc	TRUE
dgiafcahhcdajbjfeiafgc	TRUE
hhechhbhhhbccccc	TRUE
ddjecebaififbejbhfhijeeij	TRUE
eaeaficg	TRUE
eaj	TRUE
eccbbgajiidicj	TRUE
dhidaaaigf	TRUE
hb	TRUE
bc	TRUE
ddegahiefjdacjgibjdfdcb	TRUE
dhdaafiihi	TRUE
hdcchhajdjifhhbedbahhdbfb	TRUE
eje	TRUE
jgbgiffdg	TRUE
jbfaihhggieagjaadaiaa	TRUE
hfdjbcgchfhdbjejbfe	TRUE
aihcbdgddebdahhbahgefb	TRUE
fga	TRUE
ibahiehifb	TRUE
gfbieb	TRUE
hbbhhhhgejhbad	TRUE
ebe	TRUE
bjddjgebcgcef	TRUE
hedbcfefhdgiabieh	TRUE
bfejgbeahehbdagjhigcebjd	TRUE
haifigfacbig	TRUE
eigbehdjc	TRUE
cjcadbbahhdjh	TRUE
bhaebdhjacbffdf	TRUE
ceagcahjgdeaajiiehbiciei	TRUE
hciaahj	TRUE
gifj	TRUE
ffgfaabachigaihccddd	TRUE
djifdfjfidj	TRUE
ggbhcfeceaedffhg	TRUE
ihifbgiggbbijhgfchfbcdg	TRUE
jgdaigjggbebghiaaaac	TRUE
dijgjdffhbdcbcec	TRUE
ebjacfhcjjhjjdhjjjhaa	TRUE
ih	TRUE
jhjbehbefiagehbaeijed	TRUE
hfbgggbaic	TRUE
ceddjhcahcgcdjafafhagaff	TRUE
jhjg	TRUE
fabjhc	TRUE
aggjade	TRUE
i	TRUE
dbagdeadich	TRUE
eiegbejfcjbcge	TRUE
hdefdfgcbjecbcicghighjfi	TRUE
ibbgbfcehaehfchgbfhe	TRUE
dhgiffcffjgg	TRUE
baieeieihhcdjhijc	TRUE
fcaifabchb	TRUE
i	TRUE
ciaihiage	TRUE
cggdiejijfdj	TRUE
efaiafdijbefhgbebcahfgah	TRUE
fcgjjaceadcf	TRUE
jjdddhdgdahhcfghigcfejjdf	TRUE
iigdfjgaacaeeaigedbffejee	TRUE
feiaghgjfgdhgjjiahgeedah	TRUE
hjgcfidfcjibhccgfc	TRUE
hcgjdcegg	TRUE
caeidfdhagcecicffbbfjhge	TRUE
acf	TRUE
cdgcdfhfgee	TRUE
ieaafig	TRUE
ejaeabbfcaabba	FALSE
jafhfdbbeaaabbfhca	FALSE
eabbcaabjgbaj	FALSE
abjgbaabjcaaebgbda	FALSE
abbaabbba	FALSE
iabbahajbbbaa	FALSE
agbhacbfaabffjbiadbgjj	FALSE
dajjbibjaaahgcababbajgb	FALSE
aiijihbbajeahbjbac	FALSE
bcgaciabcjbhfabaaibgjbfha	FALSE
abbhaagabba	FALSE
bacbbicaaabjhbjahcgfbeg	FALSE
abjehbbajcbaabbba	FALSE
abbfaabceba	FALSE
hjdgbaeabdgbaaieabbaegacd	FALSE
babbajjabba	FALSE
aabibddajaggjbedbfdbeja	FALSE
agibdbdajcheabbfahbah	FALSE
abgbfaadbbha	FALSE
iabbhdhaabbaejhfj	FALSE
abbhadciaadbcbbbab	FALSE
fiabdgiibgdhaeaddjibbhfac	FALSE
ifeaibbhaagebghjba	FALSE
ajbbhhajcabbafjbcgjiabh	FALSE
abbbiffdidiedadagbiebdba	FALSE
abbjijgdahdabiebbibfca	FALSE
abcbaiadfabdba	FALSE
fafaeebjibiaddjcabbaha	FALSE
bgjfiaebbaajiaibba	FALSE
aadhbhbbjaahcbdbjbeabaig	FALSE
acbjeebadaghfiidhaabfegba	FALSE
ababjbgccaidabbcigafc	FALSE
abbaabba	FALSE
abbgabeabbda	FALSE
habbaabba	FALSE
dachbhhbcaciifabdicbhabj	FALSE
daihbdbaedabbaf	FALSE
abbaabdgba	FALSE
adbacbaahbbai	FALSE
acibbaahbbai	FALSE
abbijaaicbgbfdhahjh	FALSE
eabbagabbbagf	FALSE
gajeacbfjbebaiabbaac	FALSE
dacbgbdefceehabbiabdhajba	FALSE
ahcbbafcafjbbjahhdadijjf	FALSE
aijbibgdhdacjbbegchabbac	FALSE
acbicgbebaabjbaahijjeif	FALSE
abhjbbdaabbaa	FALSE
bababffjhggbjaiaahahbbcaj	FALSE
eajbgbbaaabbaah	FALSE
abebeahcccabbaibbhec	FALSE
abbabcacbbea	FALSE
jjbhaiaabjcihbhgafababfda	FALSE
aiaibchjdibbaabbah	FALSE
dfgabbiaacbba	FALSE
dhbahichbbacacbbbjbacac	FALSE
afajbhbeaahaacbbdifjga	FALSE
ageabbjibfccaaebibaiei	FALSE
abdhccbhgaahbjbda	FALSE
abcbacabbba	FALSE
jajabbgcgdbaajgbchba	FALSE
jhiacbhebaacbbafehc	FALSE
ajbbjjeibaabba	FALSE
abejbaababagda	FALSE
chabjajbafeabbba	FALSE
aibbbaafibbbfigda	FALSE
bhacbbhceaabba	FALSE
iabefdbjaagbbbbcbaa	FALSE
cabbadabhba	FALSE
cfagbcggbbabadbfibgahfd	FALSE
abjhbajbcaacdbjaachheabaa	FALSE
fabbhjaabbeajb	FALSE
iiabadbdacjaghbba	FALSE
abdbaaibba	FALSE
cagbeabagabbfda	FALSE
abbaiagbbadjbbahhdjd	FALSE
aabbaabbba	FALSE
bababaabba	FALSE
fagbbaabba	FALSE
dabafgabgaajbbea	FALSE
fcjabibaabbha	FALSE
babbaaibebab	FALSE
aeibcbdjchcbeifdgaabeba	FALSE
iabbgaeabadbafcj	FALSE
aebffbeggfagabbacabf	FALSE
abebajeegeahbjcbia	FALSE
gcfacbebbaabggbaajgjj	FALSE
abbadabcbab	FALSE
addaagbecbjgjaabiebfa	FALSE
abbaabba	FALSE
aigbabadaabbffa	FALSE
efecaijibfbaabbbefac	FALSE
adjibbaffigbdabbdbbhaafe	FALSE
afhbgbdbaehiababad	FALSE
abbaabba	FALSE
eihhabdbcjabaabjegdbcafg	FALSE
abadbaebadgacgjbbah	FALSE
gigjccgiajibbbaeacfbba	FALSE
fiabdbbadacbbbaf	FALSE
dabfibaadfidbajfbcdba	FALSE
abcbadaacjbhdbfacifdbgh	FALSE
gaajihbbacaabdfgbijia	FALSE
abbgiacjdagbabca	FALSE
aibbbjaaibbdaa	FALSE
adddbbbageabfhihba	FALSE
abbaabjba	FALSE
adefffbjbaabfdghhbbcdafg	FALSE
ajbbhadigdeabdjbafbfdi	FALSE
ddaabbbfdachajafbbbafda	FALSE
ifgacbhdibaajbba	FALSE
abbaafbba	FALSE
ceefhagebbdbhiaaiabbaa	FALSE
daibchjbaabgedbcjfgah	FALSE
cahbcfadbaijcacbbaagd	FALSE
abhbaaabba	FALSE
abcbhbaacbbagcf	FALSE
abbaabba	FALSE
abdbafabhba	FALSE
abbaafbba	FALSE
aabcbgbbbaciaadbabhbia	FALSE
eaabbaiajbccba	FALSE
ccabdbdffcgadabdjgbbhac	FALSE
ababdaabbba	FALSE
abbaaebba	FALSE
jfabbfgcaaddbhba	FALSE
iadcbbdaabbbaec	FALSE
iejgabcbaagggbbeaahd	FALSE
aedbjbeeaabbcba	FALSE
abbcdaahbibhabbeea	FALSE
gabbagdhehaaabbagiie	FALSE
ehabfhbjfdaajebhhiabad	FALSE
aghhaidbbfaedacbbac	FALSE
babibcadabecibag	FALSE
abfbaaaiebbgaeh	FALSE
ajfbbdbccbjaiajbbja	FALSE
fabbaibabbgbfad	FALSE
jfaghfbbcabiabbja	FALSE
abbaafbbja	FALSE
hddahbbgeaabbja	FALSE
hbbahbebbaagjdibbhabaeibj	FALSE
fagbfbigfgbaajabbhhbahgj	FALSE
eaadebbaidaagdjbcba	FALSE
abbaabbaf	FALSE
abbaabihibbha	FALSE
adibbaabba	FALSE
fabebibajcjabcbbaf	FALSE
habbjcacdabjbbcbaa	FALSE
abeeaebdaaccgaaghbibbag	FALSE
abbaabba	FALSE
abbaabba	FALSE
eeabbdaefabbah	FALSE
aibbajgiebabjbhba	FALSE
abbaabba	FALSE
baeehbbahbhbfacjacgbaba	FALSE
fgaibbhahfabbia	FALSE
abbaabba	FALSE
abebaabba	FALSE
abbdaabba	FALSE
abjbaabbibaghigbga	FALSE
ijihajbfbgaabba	FALSE
afbbaabgjcabgbaa	FALSE
habbgbibbfbhjiafjabba	FALSE
abidjbciaabba	FALSE
afcbhdehbiibabihjabcba	FALSE
fjabbaabba	FALSE
abhibeaabgbah	FALSE
hdjfjabbaaabibah	FALSE
abdbaabba	FALSE
afjabcbcaadfdbjba	FALSE
abjjibahbibabdaba	FALSE
abedjjbadiabgbag	FALSE
abbaabba	FALSE
gabbfeaaiibbafg	FALSE
abhcbebadeabba	FALSE
dabbdaagcbbaa	FALSE
eabjhbaabfba	FALSE
jacbbjaababa	FALSE
jaccabbaabibja	FALSE
abjbaabba	FALSE
fjbafebcbbcfaaahbcbae	FALSE
abbaabba	FALSE
aghafbfebbbecefaifabijeba	FALSE
eacbibiaafbbafdcjea	FALSE
abbacabba	FALSE
efgaebbcaaebagbagjh	FALSE
djfaicbbjgcafgbadeebciba	FALSE
abbaebaabbad	FALSE
ahcbdbahbaehbhgcfbaad	FALSE
afjjcebibfcdaajacbgba	FALSE
aibhbaabba	FALSE
bhabbbfedbgjaeabbabgcc	FALSE
abbaabdjba	FALSE
fiabgcbaagbdba	FALSE
aeigbhbaabbab	FALSE
ifaagdbbahaebibag	FALSE
abcagdbeedbabeeabbaj	FALSE
babaiahbaabbaia	FALSE
jabbaaebbbca	FALSE
ajjgfgbfbaahbbbcciac	FALSE
dabbaabbaj	FALSE
abbaabbacahic	FALSE
agbbbdaajbgbba	FALSE
ahbdhjbcabcgahcbagaba	FALSE
abbbbccaaaibibcja	FALSE
acbbhjagagbfeabggcaai	FALSE
aebbaaabba	FALSE
jadjbbcafhfibeaajebbaccae	FALSE
aebdbaabba	FALSE
abcbaabba	FALSE
ajabbcaajhjbbfjiheai	FALSE
jabhbagabba	FALSE
abcbaabba	FALSE
ajiabgbcaaadcbbacd	FALSE
abbaabba	FALSE
abbfeaagaacbbba	FALSE
aagbjchbghahfjabjjbfad	FALSE
hgabdbeaacgbgceebca	FALSE
abdbaffabba	FALSE
aibddcbajabiibga	FALSE
abbgeagabdabaj	FALSE
abbaafbfbgaaa	FALSE
adfbbaabbae	FALSE
afgfeebiejdfbajafdabfjjba	FALSE
chacbbaaieggabbdebjdia	FALSE
ddaiehbibcgajahebhbabcagb	FALSE
ajaaaeiibjabaeaceigacbbja	FALSE
ahbbbgaabbjbab	FALSE
abbajabbabg	FALSE
cbaffhhbabaeajdbifbibba	FALSE
afbcbgbcaiacibcbhhace	FALSE
aabjdbdiebaahbgjeebdfba	FALSE
abahbagjfgggabgbeah	FALSE
bjadbbjjaeaahbbbfaih	FALSE
aaigibbjafbabbaf	FALSE
abbaaebgba	FALSE
agbigijbcjdaaaibgcjebhach	FALSE
abcfbabaaebaiabbafa	FALSE
abbbgagagfgaiccabbdabghb	FALSE
acbbaabbaf	FALSE
abbjbabahbbbjbbbghae	FALSE
ahbbjhaafibdgijajiba	FALSE
abbdaabbea	FALSE
fabicbjajabbdifidbhaffad	FALSE
abbjaafbbha	FALSE
babbaaehbbab	FALSE
haibhbhbahaebbaaha	FALSE
abbaaajbfbha	FALSE
idfabbdibaaaajbabhicbjaj	FALSE
abbaabba	FALSE
dabbaabjbaa	FALSE
abbaabbab	FALSE
edabbhebgagabcgahdfaabba	FALSE
afibbaecacbbafcei	FALSE
aejbbaabibafa	FALSE
ajjdbabbaecabbba	FALSE
hagbbaabbafa	FALSE
abcbbbbaciabba	FALSE
biabbbjhahaaeddebba	FALSE
bjabbafhaaacebbeeaabha	FALSE
fadbbidafabbaihdb	FALSE
ajbbgaadhbecbbeah	FALSE
abbaafbcbaeidi	FALSE
aibididabaabbba	FALSE
edafbbeaihaebcbgbghhbhada	FALSE
abhbaababaf	FALSE
abbaabbbea	FALSE
abbaabba	FALSE
aibgbbaajfajdbdbdieag	FALSE
abbaabbfaif	FALSE
bdaibadbafgabcdgibab	FALSE
dabgahibaahjgdbafjba	FALSE
babdbbaabbac	FALSE
aabifidbaiabgbhbhadac	FALSE
aafghabchgffbafajggddbba	FALSE
aiebbabaiebbfeaga	FALSE
gadgbgjijdbjaabebhha	FALSE
abefdagbbdhaaafabhhbcaei	FALSE
ajbbahabbbad	FALSE
fdiehajjbbiaacbibad	FALSE
abdiebaabeebba	FALSE
abdbbaabbjgea	FALSE
fiabbdcaeaabgbaijh	FALSE
ebababaahcbbabd	FALSE
bfabbahabbad	FALSE
gfadebahfcjeigbaaabba	FALSE
jfabgafcbaabbbgae	FALSE
feadbbiacabbajcjfb	FALSE
aabbaabbadde	FALSE
abbbgaabbbhda	FALSE
iabbcfibgaabajiba	FALSE
aabbbgahfhacaaifdbddbbcga	FALSE
babchabbadahdbbjihba	FALSE
babcbhaiacbbjafg	FALSE
abebeacjafcbibjebhjbga	FALSE
gbabibaicabbecja	FALSE
abbaaibbbca	FALSE
abbfhaabbbhah	FALSE
fabadhbcadaebgdhbabfa	FALSE
abebaabdbiajhba	FALSE
abbaabba	FALSE
abbaabba	FALSE
agbbbaabbaaia	FALSE
ahbbaagibbdba	FALSE
abahbcdbddaaibfeadbgebhac	FALSE
abbaabba	FALSE
fdacbbabahbbaa	FALSE
bagbiefbabbiaabbjijaifae	FALSE
abibafiabba	FALSE
fabbaabhbag	FALSE
abbaabbha	FALSE
bgababhhghiaacbhhbhacef	FALSE
cbgfabccbbaaadhbbadbha	FALSE
egbabbffaabbbadbacc	FALSE
habbbaajbbbfbha	FALSE
abbaabba	FALSE
abfbajabdbaj	FALSE
aabdjbgiahabbdba	FALSE
eafffcbbdaiaabbajjj	FALSE
jaceebbehaeafcjabacbbaa	FALSE
jjhahbgaaciggbafgadbhba	FALSE
cgabbjbjcebgaiheacbbfa	FALSE
bcfabbcaaabgbhfajba	FALSE
ghdaagbhcfbjiafaeabfbiab	FALSE
abhdbchdeaabbhga	FALSE
ajbgbgaabfba	FALSE
babgdbgadcacagdbbac	FALSE
habbbageicfdaebbbadj	FALSE
agbgbfbedadicaaaabdhbbahi	FALSE
abgbfaaafbba	FALSE
ajabjdgbafabgcbba	FALSE
gggabjbbbiibhaeaaehbcba	FALSE
iabhfibadiafabbagi	FALSE
fbabbidbaaefabdffcbae	FALSE
abebbaabfaaaabdebabg	FALSE
abbbdagabbbebah	FALSE
dabjfdabaafbhgba	FALSE
babbadafabbejfbia	FALSE
abgbacbaibdjehjbaij	FALSE
chjaebbaiggaaafbffcaabada	FALSE
abebaabdhbejhbhaee	FALSE
abbaabbja	FALSE
acdbfbbaijaajbbicafafi	FALSE
habbaaiaibaibcbgbjafif	FALSE
haibfbiiaajhjgbbgbhjabai	FALSE
gcejagbfdbcaacbbfedcgahg	FALSE
ahahbbaaebba	FALSE
abbaabba	FALSE
agcabebhfajfcciabbecajc	FALSE
eabbaabbga	FALSE
abbaabhba	FALSE
abbhaabba	FALSE
abbaabba	FALSE
abbbaabfba	FALSE
abbaabeba	FALSE
aehbbaabbah	FALSE
abbaabba	FALSE
aaihbbedbcdaaafbbae	FALSE
iabebigaabbafb	FALSE
agfbbhjaaheehbba	FALSE
gfcdabbibbaaabbea	FALSE
