g	TRUE
eagcbibfdhjjjgbhaihjjjjcd	TRUE
cgefhcffccffjbgeefcbffaih	TRUE
dceigbigbah	TRUE
chgehefbjg	TRUE
dihhhjeagd	TRUE
j	TRUE
cgbeiicihgdiffjced	TRUE
cahhegbfcgfggfhcjabeg	TRUE
habdeejiice	TRUE
chjcddhfbhdjei	TRUE
cfjgccbjacgccedgd	TRUE
edhcccebigigdgbdjgch	TRUE
gchbghjjffjehefdebdhif	TRUE
degafgdehfbcebhfefggjj	TRUE
ijgibigcbdj	TRUE
fbifeijfegeh	TRUE
afhiceibfijgajjbh	TRUE
jacgceej	TRUE
iehajegcjfh	TRUE
giaffegceicghfbebcgcj	TRUE
abegiahhddeggbeihgjaefbh	TRUE
hehid	TRUE
eggddjejfhdfbgid	TRUE
diafahiiacbgigibhijj	TRUE
heieijjjf	TRUE
ahadjehjjfehebibcgie	TRUE
ee	TRUE
ii	TRUE
eiijejfbcdibacjehc	TRUE
edchfcbafcchjgahjgafbaec	TRUE
ehajfhdeahihhbd	TRUE
cigbijgbghgjidbijicgjbib	TRUE
ae	TRUE
cacahfcfgifjddf	TRUE
deegaehfd	TRUE
afiaihbhhcghj	TRUE
igffcjadedhihidf	TRUE
hafcebjffcibai	TRUE
acfjcjbdcad	TRUE
figegijejjeibegeh	TRUE
fcddbgjeeeidhahjeciib	TRUE
cabgcfei	TRUE
ghaigjfac	TRUE
ihhdagbc	TRUE
adcbaeghchffbecdghggdg	TRUE
jcjjhfbacehijh	TRUE
fdcaieeafaidaccgafhhhfhb	TRUE
gibaiabgiaehebf	TRUE
ccffcjccacgiaeiijahe	TRUE
cfafecedbjcadjcfcjaebihgd	TRUE
fhdddbhhhegigbgdh	TRUE
acjdebe	TRUE
fgjjedeehggchcdggadgh	TRUE
dffdhidgiigcgihibgahbgj	TRUE
ghehfifdehfghbajgbeic	TRUE
ehbhcedheied	TRUE
hidicdeeicjjfjbfhbaii	TRUE
iidi	TRUE
dabdbgcjadbehh	TRUE
ffbjdbdgbajfgdgghahedjgh	TRUE
dacib	TRUE
hgedhaeabggigbcfhafe	TRUE
ichdfacgfffaheedadbjbgg	TRUE
gddgbcbhjhegidhghhehchcfe	TRUE
jfhdeafjifgjhbe	TRUE
jjhgf	TRUE
fdbieffhjebadabdb	TRUE
gcfhaefcddddgjjgbdghbgjb	TRUE
aeifhadagifcgifgb	TRUE
adc	TRUE
ejihaidbhcjbhedccf	TRUE
fdbiahfgbidjbgig	TRUE
hihfhjebcfjae	TRUE
ghadjbadi	TRUE
eiccbd	TRUE
dgachjhbaceejhd	TRUE
cbgjgagbciajjgcbiahbgbe	TRUE
hdff	TRUE
hjceihibh	TRUE
cieajajdebadeeiihgddhc	TRUE
ifdfgddcdg	TRUE
ajgfjabajcihdej	TRUE
cafcbged	TRUE
d	TRUE
hgdjdhhg	TRUE
gfhdbjh	TRUE
jcafgdahjcdhcibhgedcdh	TRUE
egihgfdefijd	TRUE
ecgegbj	TRUE
fgbhajidhchgjhaehd	TRUE
fjcagjigice	TRUE
cd	TRUE
jcd	TRUE
edfgjae	TRUE
ihfcedigccegchdbdebeagfhc	TRUE
feicfcfigaeff	TRUE
fdacjeefcdejghhigdcc	TRUE
adijihdjheceg	TRUE
ibddgadidjgiecffag	TRUE
cbgbheifcigcidfdadjgg	TRUE
hchghbebcdi	TRUE
jfbjbjcfiefag	TRUE
jiddabcfiejag	TRUE
cjhcfhheefhghagjdgbje	TRUE
gcheibifffjifbfdgifdf	TRUE
hgfibhajafacedfbhc	TRUE
hjgdh	TRUE
ggciffgejhafbi	TRUE
hbhigihggcdd	TRUE
gcj	TRUE
d	TRUE
dbcaj	TRUE
geaihegbgabgfgaihifi	TRUE
hdjeajgjafajcfdeig	TRUE
jgjdde	TRUE
jcaehhcac	TRUE
ficbijhijfe	TRUE
ecb	TRUE
gfcbfbgjadfjai	TRUE
jdhiiegh	TRUE
idcfdjeghhgfccagjijehcccf	TRUE
giji	TRUE
hjachgdfejcfdjjhhc	TRUE
jhcgfgdeg	TRUE
h	TRUE
cfgcige	TRUE
hagheicgjfbjgjbgi	TRUE
dbchad	TRUE
dfacgafaedbfbacjihh	TRUE
iegfgee	TRUE
ggadbdefdfhhjbdhdj	TRUE
cjigfc	TRUE
cf	TRUE
edffcibfiaiifgje	TRUE
ifgegbjbgbcbe	TRUE
agfhgbehdj	TRUE
eajiccfaiaddgf	TRUE
hcjhgcaiaj	TRUE
hddbgccbcdiibjfajdi	TRUE
jaibhdicebeabcb	TRUE
ifhcgcdjhag	TRUE
hcjecgghfachefeajg	TRUE
hbjeaiicjgjdagcgfdciegi	TRUE
acdi	TRUE
dgcjifc	TRUE
idbffjeefchgihig	TRUE
aehgdbabdedb	TRUE
c	TRUE
ihgj	TRUE
h	TRUE
cfijhgeghj	TRUE
fgbeedfgjehgeidji	TRUE
ac	TRUE
gjcdiaj	TRUE
ifdajed	TRUE
jggefdfbhijhhebhcc	TRUE
facbg	TRUE
acgfjffgbeibajgjcg	TRUE
hcificefhciigjd	TRUE
dhehfacj	TRUE
deegbihjfhgecedagfgdhjfhf	TRUE
ahdhefjjagcacache	TRUE
ijdceg	TRUE
cbihccdgcj	TRUE
acddjeijeebigaee	TRUE
ah	TRUE
jicficbhfdjhfegjjcehajdh	TRUE
gffj	TRUE
ecefh	TRUE
fffbejdejhhej	TRUE
gfeihafi	TRUE
dfbebdc	TRUE
ebcdeafegg	TRUE
hjhfejfhifbhiaegghagh	TRUE
g	TRUE
fcfjdi	TRUE
ggjeebcjhgddddgdffcbcde	TRUE
ebhccbgdgj	TRUE
ebadchhj	TRUE
jibjchccaeabdcebcjjfdgb	TRUE
cgh	TRUE
iajdddadjcaifjbeafee	TRUE
feajcjcfjibaj	TRUE
ggjfdgdihhbgeiihbjdjf	TRUE
cfgi	TRUE
cefeigebgbcjfgagggd	TRUE
aigg	TRUE
ajd	TRUE
dfeb	TRUE
ddecgcffeihdfdfcggjci	TRUE
jagfcdchejdddehibjbi	TRUE
d	TRUE
iebccfbjdh	TRUE
dccfcbgiegehhb	TRUE
cheihjgfhbabhdeabjjjgiaj	TRUE
egffajgffgfhbgjdc	TRUE
fcdfdjgddjag	TRUE
jjhfjigdeahbhbddejjihfc	TRUE
fchahdghhddehffdeeeejah	TRUE
i	TRUE
jjfihadiiae	TRUE
hhfbaebhfagifdb	TRUE
fbciffefbjdcie	TRUE
jhjbiefecebfgibcaic	TRUE
ehage	TRUE
cb	TRUE
jidgffbchcfbiddijcb	TRUE
efeghachdjb	TRUE
ebfeafchbgigh	TRUE
acfcjeddbd	TRUE
jdhhhicgehcigidgg	TRUE
jceififfjdadbcahdabdjfcb	TRUE
gacdacghb	TRUE
adhfcejegjcajagefddj	TRUE
jbgdbjag	TRUE
hajhjbiii	TRUE
dcigheehbaiibgjafjfgfjhf	TRUE
ffbcfefafefh	TRUE
agieagcfbijgbc	TRUE
iffffbfbijhjeibf	TRUE
fefjejgfihiadj	TRUE
daj	TRUE
agdd	TRUE
idihicbhjfhb	TRUE
ciifcifdacefgedeefigch	TRUE
eceajccbejjgabace	TRUE
jdacedecgjdaidjeaihfegh	TRUE
idhahgggfbdbhejghfgd	TRUE
dcgaifif	TRUE
jdb	TRUE
ifgg	TRUE
cbdegidejcfbehbcffbg	TRUE
jaccefbcaedeafhijaeb	TRUE
icibejdcgdjdafdjdgjc	TRUE
adhhcdigji	TRUE
hjfacbicb	TRUE
cbifdjafajbdjcigegdbgib	TRUE
diaihcieiicbebggeijae	TRUE
ibdecahhbhjfijgjfcigjj	TRUE
aegeccccicjgfccfaeagjg	TRUE
caeejiahjdbggghfafffgbcg	TRUE
cddcbhdbcji	TRUE
fgeeibjhbhicbhbdebcbdj	TRUE
aedbggedegjeceehegieeaihh	TRUE
hiff	TRUE
gjb	TRUE
dfehdjjhidefijdagahaijjg	TRUE
hiiacahjaciiigcdeddjcjj	TRUE
heicdcdhhgbihgfbdc	TRUE
ch	TRUE
dbi	TRUE
dhjebiicdichc	TRUE
jj	TRUE
fhijjfecfbgcaegihid	TRUE
dcbeaied	TRUE
ebjadhfahjbchcebijdcggde	TRUE
jgbfcgigdcahgjheee	TRUE
hidjeghahfgfhcd	TRUE
fbejacdbibijadiccaibehije	TRUE
aiec	TRUE
dheece	TRUE
ieibhfcbfgchfehcfjc	TRUE
ehajgjdedifff	TRUE
jagajahgjehhf	TRUE
fjcicbedghgjibadeggfjfcb	TRUE
faibdbecdc	TRUE
djjiciggibhd	TRUE
ijdiicgebdgic	TRUE
dcachifbdheggjgedhd	TRUE
hdceaiccgdbigcibiec	TRUE
jfeiigigjiaejgegjigjhgdjh	TRUE
ibiahgjjadffidbchihde	TRUE
jhhbcbf	TRUE
jhjbagjfffi	TRUE
dhgcechhbfhiaddfjfb	TRUE
gbadjgj	TRUE
cecbg	TRUE
daghcfjbibgch	TRUE
ahijgfhcdffb	TRUE
dcfehbcdbjif	TRUE
ajfd	TRUE
ahefjdcibcgeafcc	TRUE
ggjiejiegf	TRUE
diaeihedgdcaggihdihbcffj	TRUE
gbjh	TRUE
egiccfddjai	TRUE
aehfdcibcebicje	TRUE
jebcaibaifegghf	TRUE
ahdihdadjbihcf	TRUE
cdcafdab	TRUE
hchbdgfccfcagiedd	TRUE
dcheadefhfc	TRUE
eabhfjigjjgdajficdee	TRUE
eajhiaeedijcejhcgidheeb	TRUE
diefhfgechfejbgg	TRUE
fbidihigcidc	TRUE
gehcebidjcdjdbe	TRUE
dccffcjfhgi	TRUE
difbc	TRUE
gjbibgfeccbg	TRUE
aicefigf	TRUE
ggjhjjabhieijehjfjgifaegg	TRUE
ejfhfbjhcaieedibffb	TRUE
fhghdhgeh	TRUE
dfahjjgjifdcajfbdd	TRUE
iajcfce	TRUE
hgjbc	TRUE
fgjfedgjfcifbhfhjhjfb	TRUE
dageibifffcfjaifbecf	TRUE
hhjade	TRUE
dccigidichdeajadafbe	TRUE
igfgacbfjiadfhhhi	TRUE
jheccc	TRUE
abicgghebfjjhacihcbcfhc	TRUE
dddigeihdjbdfhhb	TRUE
dbhjeifjggbichehijf	TRUE
ddgafdgeaihhef	TRUE
jeccjcffihgg	TRUE
eddhgeeadibcc	TRUE
icfbfhjdbehiibdifdachch	TRUE
cgigcaihdeajhahbibj	TRUE
hdebhgihdjgcah	TRUE
gfiajhfdebiedbdg	TRUE
hhjhhcifhahcbhhbhif	TRUE
cbdecbcgddhbcfdhihbccfcji	TRUE
iifefhbfhdci	TRUE
fdgbjiggeffjfbcaegceiceb	TRUE
aifcfbhcjg	TRUE
ibibccgbcidbfagigjhgajgjg	TRUE
ac	TRUE
ggcaif	TRUE
cgjehjifjdfhe	TRUE
dgafhdfehgbjeiiihhfaiiae	TRUE
abcbajaebddbhdgdibchbebdf	TRUE
idjfdibjeg	TRUE
jcehgfbac	TRUE
afdjbjjgc	TRUE
g	TRUE
ggdgiajfebciafb	TRUE
fjjjahbgaiijjbjfacdhjjebc	TRUE
i	TRUE
ddh	TRUE
hjcdejfeaedhhd	TRUE
jhfidefhjaehjhdhfgb	TRUE
ibi	TRUE
ccbj	TRUE
d	TRUE
ihgcigefgggegeag	TRUE
fdhgfjejcgabj	TRUE
jhcahdgahidfeabaghgjji	TRUE
debi	TRUE
ecfdddcadccadgdhdcdci	TRUE
gdffbjbfceeidgabi	TRUE
cfihecegdefdhiggjd	TRUE
cbicebe	TRUE
jedacabccagjhgfaifaib	TRUE
fhdddefigbecdeiaibcijag	TRUE
ddc	TRUE
fcifcfccfdifihbifh	TRUE
dd	TRUE
ebabaidcacadcdfai	TRUE
ggiecicjhcacicebacejd	TRUE
jcefcddhedecbji	TRUE
efcggjdbdhj	TRUE
hdciajjidjijfh	TRUE
fgehg	TRUE
cgigfd	TRUE
faeccfd	TRUE
gab	TRUE
ahjcfbacbj	TRUE
h	TRUE
dihgbcacdcfcehcfecd	TRUE
dchhhhjbhajiiai	TRUE
fffbcc	TRUE
afehececdcigdabddgg	TRUE
hefhciijjf	TRUE
geffhhcfjbjfjhc	TRUE
gejfgggjghegjjhaegjaijfhj	TRUE
djgfeeadecdjeh	TRUE
cfgjeeebhffgifdccjecbj	TRUE
dhjcce	TRUE
gbi	TRUE
gcceggicehbcb	TRUE
ghbdgifaijfdcecgbeh	TRUE
djgjfedfhbdadbcjeiahdd	TRUE
feafdheegbjdihhih	TRUE
feehbdabccjfgafjjdejfcd	TRUE
hhdiieiadfcbjdegdgcabf	TRUE
afeji	TRUE
caffdcbjefbhgddbcd	TRUE
c	TRUE
dfcgbhjebiefgdii	TRUE
ehahaeah	TRUE
ijgjaei	TRUE
jgbehajchgjhchdfhibjgd	TRUE
acec	TRUE
ejbcdigjejjfhbjibh	TRUE
fgeeebhdg	TRUE
iciggj	TRUE
gdbgcddfi	TRUE
eeeaee	TRUE
ihdebjgiihfdff	TRUE
jccegbdcaicifibeaeidbeei	TRUE
jhccc	TRUE
ajdicf	TRUE
cbghdcjbfdb	TRUE
hhijjh	TRUE
gjicjifcbigejiedfdgc	TRUE
cbai	TRUE
iefjcfeiidbacche	TRUE
acdbhhccb	TRUE
abcgb	TRUE
aehcjbaeg	TRUE
de	TRUE
hdddfjei	TRUE
fcacihcjieachhhdjeagaeidf	TRUE
jjbjjabcgjceei	TRUE
hfdhi	TRUE
hedeabj	TRUE
hfjhg	TRUE
c	TRUE
hceadgfg	TRUE
gefdddhddabcdegjhddhf	TRUE
iiffebjddedebefhfgajajaf	TRUE
ccjdcdjibebfjjfe	TRUE
ehafadehbacgcacjj	TRUE
ibeejaej	TRUE
dbadijihaecijjige	TRUE
ch	TRUE
gjiedgjgif	TRUE
fggcbcachjhei	TRUE
dhhf	TRUE
icceabdfh	TRUE
cieiifefffegcei	TRUE
eebcdfafbgjcijgbjgjgfebid	TRUE
efidibhhdcif	TRUE
aid	TRUE
edhijab	TRUE
hdihf	TRUE
ddiahf	TRUE
hcgdddfbhhjgdjjdbaeaff	TRUE
ahgcgfbfbeadjcfhgfdfee	TRUE
aeeiee	TRUE
jadjif	TRUE
jc	TRUE
gadcd	TRUE
efb	TRUE
jaehggh	TRUE
hhhhedbfjffbihhd	TRUE
aiiidfhcaieegdcbf	TRUE
ii	TRUE
hg	TRUE
dbcdj	TRUE
iiibfaffidjhajib	TRUE
cbicfafhfbec	TRUE
gecaigcbcdfhhgdfbidhbije	TRUE
icbdchcgfgdijjjajdgbhfb	TRUE
hidajgegcgfechbaiafi	TRUE
gcjebceigbhhcd	TRUE
fgdeabfaebdgbffebahcicd	TRUE
ebfgeajacd	TRUE
hdidffgbjccifhegfj	TRUE
eb	TRUE
cicbigbjgdedjgeifde	TRUE
ebeahcgbaidd	TRUE
acgbgafc	TRUE
jdabjibachcgdhijdfgehe	TRUE
j	TRUE
hacajif	TRUE
hgdhcjadceddffjbeedac	TRUE
cegefgjijhcefabfgdff	TRUE
djc	TRUE
iecbdjdjgfiicfaghiegfibhe	TRUE
hj	TRUE
fdc	TRUE
ibadbgfijifbfebecicjifbcg	TRUE
debdjajaggfffgbcgbfgig	TRUE
jibdiddcc	TRUE
ejaeibafbdefceaceagdhci	TRUE
hiifiggfjfahebei	TRUE
acdiidaiebgcbch	TRUE
dfhiaihagbibhdf	TRUE
adecddche	TRUE
acejbeaf	TRUE
jggfbaihbdff	TRUE
fdfdccicgfd	TRUE
gcafiagdgdebcadc	TRUE
feadbcgbgcfbieaebcehgc	TRUE
ijfhgfbcceegccecfhd	TRUE
ii	TRUE
hhfeabeecac	TRUE
e	TRUE
h	TRUE
fghajajjdfbihiidahibddg	TRUE
giieieaiaiiahdfeaehcce	TRUE
g	TRUE
gjefhecdbgaghihg	TRUE
jdeiijjiface	TRUE
fab	TRUE
fhgcibeabdadfa	FALSE
jchiacbahebgafbicdhgjgbea	FALSE
bbbdbhaegjeibehabha	FALSE
edcfbgbfffdcgjhbhhbbcbb	FALSE
bffhfd	FALSE
ejedbhgbhcihijabbd	FALSE
fjfgbbhdidcjeifhjeeeaad	FALSE
iiea	FALSE
bicdbihhcbbdfid	FALSE
jdjbcjgihidihjca	FALSE
defjdedfca	FALSE
bhdcibhjcdjghcffabhbfad	FALSE
bdadieb	FALSE
hchhjbaeefjgdgcbbebjiihid	FALSE
beaadfaaebhhic	FALSE
jgjacgfa	FALSE
gga	FALSE
idecjhgbgfifbibaaidihb	FALSE
bfcbijgegicb	FALSE
aedffgiccabbaabc	FALSE
agihcafbiahhgaccia	FALSE
dibebbefdaeigdibjbij	FALSE
hggagadjidbbabdibdaidbjaj	FALSE
gbadejjaehfjacejjeadgejca	FALSE
ia	FALSE
begagbgj	FALSE
aabadacgjegbjdeddecfej	FALSE
cfcibejbbidcbecjccbi	FALSE
jbhjghghjadjjcfedjbagia	FALSE
bdgbe	FALSE
jhfaebaadd	FALSE
bjfhjadfcffgcigigfiafibic	FALSE
bjjdghiebebcgdbhh	FALSE
cgciccdhgjbbhce	FALSE
ja	FALSE
aaahidjc	FALSE
ahgcjchbjggbbga	FALSE
hiaabaejdcggcdeje	FALSE
bcifcfigjbbgi	FALSE
fbedcdeeddjdaadjaefibgc	FALSE
hheiffebdbbhgigefeea	FALSE
djcaahfa	FALSE
bidbihghbeiihiabdhc	FALSE
bbijgee	FALSE
hcbiihhgcgbagadca	FALSE
bh	FALSE
fgbieaaagg	FALSE
bbhbfbbcghiiejfaejic	FALSE
bhhadagjicegc	FALSE
fccgaafjaefcf	FALSE
gfbdicfihijfcaba	FALSE
biegcjadff	FALSE
bebafafagfhceaffhbfcb	FALSE
b	FALSE
bcfjdegcacab	FALSE
bddigjbb	FALSE
a	FALSE
bcbdgeighfigfaidcefidhfhf	FALSE
baafidacidhdggg	FALSE
abfdegdjiefcighgadeia	FALSE
ghfdccfhfcjeiehjdddgfgafa	FALSE
bfbeffdfiejgaidfi	FALSE
biafegh	FALSE
jhdiffcjfheia	FALSE
hgbbhagiifeg	FALSE
aabebbaffffiafifebjcjgfad	FALSE
cfaaecfjcdcfcdjeaag	FALSE
iagcjcdaiicfgheahdea	FALSE
a	FALSE
aigdjjcaaaidbdhhaic	FALSE
dcdagjja	FALSE
bdhff	FALSE
bgaeecaagbahafejdgibaf	FALSE
jjcdjfbacea	FALSE
bgcchhgieg	FALSE
aacfhbha	FALSE
bjdidcejbifffia	FALSE
ibihbadfdaghadaadb	FALSE
iejghga	FALSE
ehejgbhiaehbbb	FALSE
b	FALSE
higbcdaheghaffibbf	FALSE
hfa	FALSE
faehbbajchajafecidficd	FALSE
afbdfdcgcdjigdccaacdh	FALSE
bbbgeffcfffcebecbdghef	FALSE
hahbghbca	FALSE
ehedjeicbhjjceaafje	FALSE
accijaijibbcaga	FALSE
abheicfhcfbdfbbhh	FALSE
bdgdfbejfg	FALSE
jbbjeghdbjaijgjc	FALSE
bajbda	FALSE
bajd	FALSE
ia	FALSE
bfgcjbfdiecgjddjbhdjefa	FALSE
ehdfhjjaafffgbihfifg	FALSE
diiefhaajfidifjjacf	FALSE
hgjbegabijbfdehbbej	FALSE
jjedga	FALSE
bjgebedfdbecaaj	FALSE
ieadddicjaeajiada	FALSE
gafajfaagdaahccaadjhdi	FALSE
icegaaa	FALSE
jifachhbbacfe	FALSE
bchifcbi	FALSE
jjgfgbejcbcbbi	FALSE
bfebifcgi	FALSE
cheafbb	FALSE
iciajdfagcgfdagaiaejca	FALSE
a	FALSE
bhbjh	FALSE
hadddjbbcfhb	FALSE
bgabidiebge	FALSE
dbjdacfjcaeba	FALSE
bf	FALSE
jaa	FALSE
jehfcehebbeicdigfi	FALSE
baegffheecdhhggdcajicdb	FALSE
bbigfdg	FALSE
bfebdfjaddceceiiggeghj	FALSE
gbgijgddifbbeceicab	FALSE
hfecfada	FALSE
hhieifbicgaae	FALSE
icchigieaccdgfeaidhcdha	FALSE
ga	FALSE
bebahedi	FALSE
hbfhcbbgafdhgejfcc	FALSE
beifdbbafgacfdhbjjh	FALSE
fa	FALSE
bh	FALSE
ffhdbeccgaiehga	FALSE
aaadgbaab	FALSE
bdgchigfcjcjceiabcb	FALSE
becj	FALSE
dfdajdfdbbabegaiaahbebfd	FALSE
bfdgggiifafgjcdgag	FALSE
heafciibbdhjgfddjf	FALSE
jagdfaahcebcbf	FALSE
jcfeidfbjgbhbhdhjebfgcca	FALSE
bbji	FALSE
ggedcfjcja	FALSE
bdgcbiefcg	FALSE
diecibijjdcaajfgedc	FALSE
ja	FALSE
diaga	FALSE
jhdjgcahfaibb	FALSE
baj	FALSE
eibibbijhaadbjbgebfab	FALSE
aaficbehfge	FALSE
jeidfhaahcaefjd	FALSE
afbhbbijbhcdhggb	FALSE
bgjgjfgdachj	FALSE
bhgcdabggaiefbabhecbcb	FALSE
beehdccdc	FALSE
jbefcbbgjbbefacg	FALSE
b	FALSE
jaaif	FALSE
jjabdicigjchibaa	FALSE
cifefcgabbchhfjbbhic	FALSE
bjefgcafdjhegaehbfa	FALSE
b	FALSE
fiaabcbggbddai	FALSE
cbeabbaeebehg	FALSE
hbidjcba	FALSE
ceaafiejhcdbfihcaeja	FALSE
jjfja	FALSE
fehbiajbbfhdadjcehbg	FALSE
ifecha	FALSE
addfeefibbbfgdijhjf	FALSE
bcagihcfeacihdbcihfg	FALSE
aheahjdfdeeibifcga	FALSE
eibhecaajad	FALSE
dhejbaahaajfhiaijfbj	FALSE
dghaeijfaabaifjai	FALSE
dbbjcf	FALSE
feaaijigfbabjffichbd	FALSE
aeiadbegcffahbaahaeihbdea	FALSE
bcifedchj	FALSE
feaabgfihehfbjhdhiah	FALSE
bbgbdj	FALSE
ibdefibeaigjcgda	FALSE
a	FALSE
bidfbaedbddeaie	FALSE
eaabibgjhgec	FALSE
be	FALSE
ahiefbbidjbfegbfchfgfcfc	FALSE
gadfijjhhbaaibcjidaajggi	FALSE
ggbjbba	FALSE
ggbaafhdb	FALSE
iaaffigghbfchdccaibj	FALSE
bfhbachfedgbd	FALSE
dcjafdfbcfdaafjgfjcjja	FALSE
ccciagddda	FALSE
dcadbhifeha	FALSE
bggchaffeeh	FALSE
ca	FALSE
habdbihfdghbaa	FALSE
beehbaahfhged	FALSE
jebbejgfecagaj	FALSE
bjifehbagggge	FALSE
jbhhecjicgfhbacdafefa	FALSE
jhjcidcjjjiibia	FALSE
aegfafhaagabc	FALSE
agihihdgbbjdjadfeg	FALSE
ghhdjiia	FALSE
hcbfigdaadbiijdiijbihdbdd	FALSE
bdgab	FALSE
ahjheehfadia	FALSE
jicja	FALSE
daaejdjhhgigafciacjehf	FALSE
bccjfjfhchchaaci	FALSE
bfj	FALSE
bjfchhj	FALSE
ijgbfa	FALSE
gcfchfihihhha	FALSE
ifgdbafcbhjebcfggahdfdea	FALSE
bjeeca	FALSE
hiciideecjbbdbjeiehafbibe	FALSE
eidiihedcfbgbbbgfi	FALSE
bgafgaigbghhieafcbadbbc	FALSE
bj	FALSE
efbebicbbbegaibdf	FALSE
hbbcbghjac	FALSE
ghbaiegffdbjhihhaafeeicai	FALSE
dggahabbbbdc	FALSE
agbfhgaacgf	FALSE
bdfgjh	FALSE
gfdegdfgcgbfhbceijcbbic	FALSE
daijfaejhaabefgedfhchdfi	FALSE
bbhadhcbegbaiehjhj	FALSE
iejbbjidbhh	FALSE
eijccaaejdjd	FALSE
edhhjfdafhaajcggabafacbf	FALSE
bdgfjcideajceec	FALSE
baiefebacieaddb	FALSE
jcbgeggbdbijdbbfbibdbeh	FALSE
idchciibfjbiahfgehcgbb	FALSE
bagcgddfgjfdfdbicihjabggh	FALSE
bcgcbbhij	FALSE
aaebegdefgiijhjfhgf	FALSE
ijjaghfaejafbbjhic	FALSE
bjbbbeafgjgafbdj	FALSE
jbbcc	FALSE
bjc	FALSE
bdafjad	FALSE
ihaaaebifh	FALSE
bdefhgafaicghba	FALSE
bfdhjaji	FALSE
ecbdfdiha	FALSE
chehaaiecedbeif	FALSE
bbgijchdbjbg	FALSE
ejfidehhehaafbebc	FALSE
dfiahggbahhjiiaaibghd	FALSE
jigfca	FALSE
aaicfcijhfaifegjhdd	FALSE
bbajeahddh	FALSE
jeeahbcga	FALSE
b	FALSE
dbjecfefdbbaaj	FALSE
bihieeeddedfjc	FALSE
afhga	FALSE
bbgachfijjigijbfjdifcjbd	FALSE
aajdhjgja	FALSE
hafieia	FALSE
bcbdbfbcehh	FALSE
fbifcjbadgjidfgahgeiaaeha	FALSE
gaabhjidbbiijidj	FALSE
fajchaifggcadabbag	FALSE
fadaajfbihjcfeichcgia	FALSE
behbgf	FALSE
bcbe	FALSE
bb	FALSE
iicaacbaifa	FALSE
bccidg	FALSE
bhfjifhbefcj	FALSE
b	FALSE
jiddjjcfhhia	FALSE
a	FALSE
idjcfhbhbjijdbbfhhegj	FALSE
ibbdbbjiggajcidicge	FALSE
ifgfagaja	FALSE
jfhedebbajiddahciaaidgg	FALSE
gbcaba	FALSE
cacabbaiaeghfcjch	FALSE
hfjda	FALSE
dgjjhdcgdccajdcjdbfbbig	FALSE
iddcgagfaachfffegjiafgii	FALSE
beifgfjbej	FALSE
bgagcbcghegjcjchhbggf	FALSE
bdjcfahefaaged	FALSE
eejbchagbgiea	FALSE
hbbfcdfgacghie	FALSE
ieiifda	FALSE
cbb	FALSE
idgaiaafediidadaffhbfghea	FALSE
bgeejdeifebgfhajjgbi	FALSE
aafhbbhhheccehgheigjgeijb	FALSE
aabaa	FALSE
dea	FALSE
jdaaaicfbedgbjcjjgghaadhd	FALSE
bdgbifagdeab	FALSE
jeadbffebca	FALSE
bejhihhgahhhaihbgae	FALSE
bfbdhgbcbcjiddgabidafafe	FALSE
bhfh	FALSE
aaeae	FALSE
aaecghjihibeji	FALSE
bcfeefd	FALSE
cbgibjbiga	FALSE
hgficdfchcdcjbfia	FALSE
dba	FALSE
fjaejaha	FALSE
ea	FALSE
bfbaddehc	FALSE
fedeebbdijjeafab	FALSE
bedgejjebaegggg	FALSE
a	FALSE
bhdhegcjhegjfiehi	FALSE
fhbb	FALSE
iejiafbjjfibaahfbiifj	FALSE
ejfhcefdgajcefehdaeha	FALSE
fgfjfbihjfbbaieigieha	FALSE
aafadifigdachhgicfdfbi	FALSE
iedbcaaddabiaacdicbb	FALSE
eheaidgdigedfadhbjaija	FALSE
hcbaaihggjffdcfagbhaj	FALSE
b	FALSE
bbdeejfcdhggjhgeji	FALSE
ibcebjfa	FALSE
eaaabdij	FALSE
adajffaabiheedfchaeif	FALSE
hchbjha	FALSE
eecheacajfgeifdbcbb	FALSE
dcbbebhabffjcdbehijjh	FALSE
aefjjbiigbddibbgfhaac	FALSE
cjagdiiegeafbbabeghbae	FALSE
gfgfbhfa	FALSE
efadbdgiabdidddha	FALSE
figjagdbjiaagd	FALSE
gdbfbabeffdejica	FALSE
a	FALSE
hgjaibaeididghdeajaac	FALSE
bfhhbabhgdidedhg	FALSE
bfibi	FALSE
afcabfjaahifbgdaahhjicc	FALSE
idbehffaacgjbebigiegfa	FALSE
bchbeebccf	FALSE
cbiihdibfccbafghbihjjaa	FALSE
bi	FALSE
bfijbjfedib	FALSE
afacdfdia	FALSE
hhga	FALSE
bae	FALSE
bafahfacbchjefcbbgbiae	FALSE
b	FALSE
aidhgbfaai	FALSE
gifa	FALSE
jcfdibagjbdabahffbba	FALSE
ha	FALSE
adbfdajaehgijejcgbhiaaig	FALSE
aab	FALSE
ecfbcdfaad	FALSE
b	FALSE
ga	FALSE
bbbddjeji	FALSE
iacgdfghjfaecbeea	FALSE
fehijifchighjaaidac	FALSE
bc	FALSE
bahjje	FALSE
bghhdhgagccaaebjghfb	FALSE
bgd	FALSE
beeeiidcejdjghhi	FALSE
ihbehgdfbbicffieij	FALSE
bfbjchdfjdiedgdbebgcf	FALSE
jgebaafjchbjgchijeegdcgjj	FALSE
bbhieid	FALSE
bffg	FALSE
hbbihd	FALSE
aae	FALSE
bfb	FALSE
dbbaegdhjaib	FALSE
aafhibhecfbff	FALSE
ibdaagffidhbjfcd	FALSE
eecicja	FALSE
ichdbbdiceaffbdjbd	FALSE
bjadcidgjgh	FALSE
bddfgdhcace	FALSE
ecbjaiihgbb	FALSE
bjadc	FALSE
bcfaci	FALSE
bci	FALSE
bbdaegaaaca	FALSE
aegggedbbgceiaddceiagjb	FALSE
bhj	FALSE
agaabgeij	FALSE
didaihadidaiigciidbbgigh	FALSE
hhceaaiegb	FALSE
haaj	FALSE
dieebbadabjhg	FALSE
igjdfhicga	FALSE
a	FALSE
ghebaia	FALSE
bci	FALSE
dfdjjijfajagaea	FALSE
aagb	FALSE
ebhfhaagabd	FALSE
jabhhbb	FALSE
aaagbbddjbhc	FALSE
b	FALSE
daiigdaehaaicbfghjhbcfi	FALSE
bdejijbebjbfcgecdccfdfeh	FALSE
cifijibdibbdjhcfi	FALSE
aajdcaecaiaajfeadhdifd	FALSE
igibcedfabjbdbidcefifeaa	FALSE
deabda	FALSE
hieiehdfbbe	FALSE
gdbbcfffeaa	FALSE
djhjeibeefjbga	FALSE
icihjaahhagafecgf	FALSE
bjhb	FALSE
ajfaajfbejfb	FALSE
fabbaadbhjibaefjfbhchcec	FALSE
jafgifhgajbcbceabdefhha	FALSE
edfabhbbf	FALSE
igcfdggha	FALSE
djggdbgjfidiaabjceddcie	FALSE
bjjjdhdfbcdfeid	FALSE
gdja	FALSE
bcgegcgiiciaifjffhefehgi	FALSE
cedbcihifaga	FALSE
bejgifabgg	FALSE
cahcdcgbbhgb	FALSE
bei	FALSE
cbbd	FALSE
cfhbjgjihga	FALSE
hjefbhciehcjbhjiajcifa	FALSE
aefehjejhjeiidheahiafhfa	FALSE
dada	FALSE
giia	FALSE
bdhifhafcgafjdijdf	FALSE
hgjabaadbaiah	FALSE
hgbhbjgjdhajihiddhbccacda	FALSE
bcjcjdc	FALSE
bdaafa	FALSE
jdeajidebdccfcjda	FALSE
acggcdaca	FALSE
biidfcgbdgggafjg	FALSE
bg	FALSE
bbehgaajdfcgfbbhj	FALSE
jadbahebjeacdedba	FALSE
adceadghacdcjjhicjda	FALSE
adcbb	FALSE
fba	FALSE
bjdfgcgi	FALSE
ccibbdahjjidaiaf	FALSE
hhdicjaajhadhi	FALSE
bbjfajhffjfhcecjfegcj	FALSE
baiebha	FALSE
bgeafidffggj	FALSE
ihiibbehhcajbf	FALSE
ea	FALSE
beaaabiagiigb	FALSE
hdhbfa	FALSE
jibia	FALSE
ibbdgadaaebiic	FALSE
fgfhaacaecbdfcb	FALSE
bbijdebgjdbibe	FALSE
aacfaiib	FALSE
bifd	FALSE
iecehbcfbagicieagidccaea	FALSE
adgeffdhhhfhbaadhcgdfhhc	FALSE
a	FALSE
jchdfhcaeajafedcba	FALSE
iabbig	FALSE
daahhgbbgiahcgia	FALSE
cecbgeeia	FALSE
aaghf	FALSE
dbejjgaba	FALSE
fdeagadcaebbgif	FALSE
gehabahgaidebbfdgfbaje	FALSE
jbcejbfabbidcdffdhj	FALSE
fjfhhjbbcaahh	FALSE
bbfibhddbdedfaif	FALSE
daffejaaifjfcghfdfbbd	FALSE
cefhfefdeigdhjaaehjd	FALSE
cefbdabfjeaa	FALSE
bbfjjdhafgfcac	FALSE
hicgbjiccccfigcacgehdigaa	FALSE
gecfa	FALSE
bfibagcj	FALSE
bdaacfhgcfbddgcef	FALSE
bbih	FALSE
aggga	FALSE
bea	FALSE
bgecffddaicfjibhij	FALSE
b	FALSE
dfecifjeejjbfehfaaefgdh	FALSE
dhga	FALSE
cjfdbceiaaaiijejhjagajbe	FALSE
