b	TRUE
dccbcbadaabbb	TRUE
dac	TRUE
acbaabbb	TRUE
bddbbacbccdbd	TRUE
ab	TRUE
b	TRUE
cbddcdadcaccbbcccbdc	TRUE
cbdb	TRUE
ddcabaddccbbbdacadcbda	TRUE
ccab	TRUE
ccddcccccadbca	TRUE
aaaaadca	TRUE
baddadcaaabddcbdbaaadd	TRUE
dabaabc	TRUE
daaabdaabcbaaccddd	TRUE
acddcadbbc	TRUE
abcddcddabcbbccdbaabbbb	TRUE
abdaaaadba	TRUE
dcdcabcbbb	TRUE
daaccbddd	TRUE
bddccadbad	TRUE
cabb	TRUE
cdbbbaddcdcccacb	TRUE
acddbabddbadadaabcdddcd	TRUE
dcccdaaadcbcbacbdcba	TRUE
adacbbabbc	TRUE
bccacddddcbb	TRUE
addcdabcdbb	TRUE
cbcdbcabdcadbbcdabbbcba	TRUE
adcbdbc	TRUE
accabadcacdadcbbdbcdcdcbb	TRUE
bcddddbbd	TRUE
cccacdcbbccadcabdd	TRUE
baaaaddbbddc	TRUE
ddbba	TRUE
dcbabcd	TRUE
ccdaacabdcbacddaabbd	TRUE
adbcacaac	TRUE
cdcbccdaacbb	TRUE
bbdb	TRUE
dbaabddcdd	TRUE
bddcbabbcacda	TRUE
aabdcdbcadbabbcacbccb	TRUE
dabbadbacabcddbbcdacbddba	TRUE
ddbaadccdbbbccccc	TRUE
acadacbb	TRUE
bdaddbcddbcdabdb	TRUE
bdaccbcd	TRUE
caaacaaaabdcddc	TRUE
dcaaabcadd	TRUE
abbcbadccdcdcdc	TRUE
caddcccabccab	TRUE
bbdcdadcccbdabaabdaca	TRUE
adadbd	TRUE
ccddd	TRUE
ca	TRUE
cabcbaa	TRUE
dddaad	TRUE
bddb	TRUE
bdd	TRUE
bcddbdbaadcdcc	TRUE
b	TRUE
ccadccac	TRUE
dcaabdabcaabcdbcdb	TRUE
aaaabcadbdbaad	TRUE
cbcabbbbdacddab	TRUE
bacaaadddd	TRUE
dadddddcddadbcbbaacadca	TRUE
bacdcddcaaa	TRUE
adabccccabaaccbbb	TRUE
bbabbaddd	TRUE
bcdcccacbccccaabdbcbbaaa	TRUE
badcabbcddddcccbabad	TRUE
dcccdbaaccabd	TRUE
ddadbbdadbdbcbbccbba	TRUE
bdcbaddaadadbbdcaabcbabda	TRUE
aabbaacacdbaccbca	TRUE
abdcdbbcbaaabcaabddd	TRUE
dbabdb	TRUE
cdcdaacdcbaabcaabddcda	TRUE
addacbdbcbaddbcbabaad	TRUE
ccdacbbbaabcbbcdbb	TRUE
badbdaadadcdc	TRUE
baacbbabbdbadaababddb	TRUE
cbbbdbdb	TRUE
accdabbbcccbadaccbac	TRUE
dba	TRUE
cdbbdadaab	TRUE
cbdadbbccddcda	TRUE
aaccddbacdbbccbdabc	TRUE
cacbbaadd	TRUE
caacaabad	TRUE
bdcdbabbddb	TRUE
ddabcaabbadaccdcbbbbbdc	TRUE
dd	TRUE
bc	TRUE
acabbdcddcbcadcccdabbdb	TRUE
adcb	TRUE
cbdadcabbdabcbcbbadaacca	TRUE
ddcccdad	TRUE
dcabaddbcaab	TRUE
abcbdbbdbbccbbcbdcddaa	TRUE
bacaabcbbdcdabdab	TRUE
dccbaddaaaa	TRUE
adadcabd	TRUE
daabd	TRUE
dbdacba	TRUE
bcd	TRUE
cdbabacbbbcbbabbbbcc	TRUE
dcbabcabaddbbdaadcdacddab	TRUE
ccacb	TRUE
bacd	TRUE
aabdaabacbbc	TRUE
cdbaddbb	TRUE
bbdbabdadbdca	TRUE
bbbcdddbddcdbddadaa	TRUE
acabdbdabcbacdddbababcbd	TRUE
aadbaadbccbacdcbdbbdacc	TRUE
bdbddbdba	TRUE
abb	TRUE
dbaabbaccdcbcdcd	TRUE
aabcaccbbdacdcbbcda	TRUE
ad	TRUE
aadacbccbababcababdbcbc	TRUE
dcbacacccdcabd	TRUE
dadbbabbdbbcdbdbbbada	TRUE
da	TRUE
cdbddacbaabdbccccdcd	TRUE
aabbcdcc	TRUE
dabaccbcbabdbdaaddcabdbac	TRUE
bd	TRUE
bdaddbccabdacad	TRUE
adddaaccbaaabd	TRUE
dcc	TRUE
dbdaaddccaacccbcb	TRUE
bdd	TRUE
dbcacb	TRUE
bbccacdabbbbaccddbc	TRUE
bdbdcdcbbbcacb	TRUE
cdacaaacbba	TRUE
cdadad	TRUE
caadbdadbdbcccbdccbbbab	TRUE
dacccbdadbcdbcadbbdcaacd	TRUE
daadcbcbabdaabbd	TRUE
dbcdbadbcdababbdcaddb	TRUE
addcdbbaccbabdccbcbcbd	TRUE
cccdbccacdccaacacad	TRUE
dabbda	TRUE
daccabd	TRUE
bbababdabbc	TRUE
cdcaaccaaddadbcbdaaddda	TRUE
d	TRUE
ccabbbabd	TRUE
cbdcab	TRUE
b	TRUE
cbaaacdbcbdcddb	TRUE
caaaacdbdcacacadcadcccdad	TRUE
dbddaccaabbbcdcdbcdccacca	TRUE
bcbdddddbcabddacbb	TRUE
dacbdbbbbacabdca	TRUE
dd	TRUE
cdaccbbabda	TRUE
a	TRUE
bacacaabdddbcdcaccddacca	TRUE
caa	TRUE
bcdacabadccccabcb	TRUE
bbabd	TRUE
adbadcbabccaadcbaacaaa	TRUE
cacdbcbadbdbcbaccdcaadadb	TRUE
ad	TRUE
cd	TRUE
cbaabdcccabaddc	TRUE
ccdcdbddacbcbadabbcac	TRUE
bbdcbcbcc	TRUE
b	TRUE
caabaa	TRUE
c	TRUE
dbaccaccbbadbaddddb	TRUE
dccbaddadcbbcbcabda	TRUE
bacbdabadbca	TRUE
ddcacddcbadacba	TRUE
cbdcdadd	TRUE
dbdbaacdbabbcbcccdadddca	TRUE
cabbbdaacbacbbaaabbaaddd	TRUE
baadccabacaaaa	TRUE
aabdbbadabbcbbccbddabcbd	TRUE
dabbbbc	TRUE
acbbdddabca	TRUE
adbcabba	TRUE
adcd	TRUE
adcdbbacbcaaccbbaca	TRUE
adbcacd	TRUE
cbddadd	TRUE
abaccdddbdbcbdac	TRUE
dddaaadcaadbb	TRUE
dbbbbacccccaccc	TRUE
acdcbb	TRUE
adacacbcbdcabcb	TRUE
dbba	TRUE
bbdbdabcadcdabacda	TRUE
bbbbda	TRUE
dcacaaaaabbd	TRUE
bca	TRUE
cddadbadcacadbddccbddb	TRUE
d	TRUE
babbddaddacbaaccacdbacd	TRUE
bcccddcaaabaccbadcbaaa	TRUE
cbbbdcbbcadbccadbaca	TRUE
abdcba	TRUE
cc	TRUE
bbadadcacbcdccdaabcbdca	TRUE
bcbdbcbbbaa	TRUE
bcabcacba	TRUE
bcdaaccacacddbbcaddabbcc	TRUE
cc	TRUE
da	TRUE
dacddd	TRUE
cdbccddacdbdbbbaa	TRUE
a	TRUE
bd	TRUE
c	TRUE
dabdda	TRUE
cdbdadaadbc	TRUE
addcccbcac	TRUE
ccacccbccbdddcdaacbdbb	TRUE
cdbaccac	TRUE
bcadbddcadd	TRUE
aaabcdbccaabd	TRUE
cd	TRUE
acaddbbd	TRUE
cbddddcacddbccabadacbbbcc	TRUE
ddccdddabacabadccbbaaddcc	TRUE
cdbabbcadbadabbca	TRUE
baccacb	TRUE
dbdcaadccbcbccaca	TRUE
dbcadbbb	TRUE
abdcbbcbdadaadbcccccadc	TRUE
cbcadacbcbabd	TRUE
ddbbaccdadabb	TRUE
cbcabbdacccc	TRUE
accdabcaddaacdadccbadabd	TRUE
aaddccdcaacaccaaaabcbab	TRUE
bcbbcdaccaaabbabdd	TRUE
cbaccccadbcaddbbddcd	TRUE
ddcdbdccadbaacc	TRUE
bacbbcbabbdacab	TRUE
bbda	TRUE
acabcd	TRUE
dbba	TRUE
ccdabdcbdbaa	TRUE
abcbbcacabcccabdabdabd	TRUE
cbdcddcdacacb	TRUE
ababbaaddcbbbaabaccbbacaa	TRUE
cbdbdcddacddccadddcdd	TRUE
aadbdcbcacccaaddabd	TRUE
dabbabacabaccaadb	TRUE
d	TRUE
caad	TRUE
dacdaccdcabbaabcd	TRUE
cdbbccbabdcacabdcada	TRUE
dadcbdbddddddab	TRUE
acbcbc	TRUE
ddcdddcdacccadcdacaad	TRUE
adabdbdbcabbbccd	TRUE
bacccbdccbddbbdbaddacd	TRUE
bcbcbcabcbddbabbdbca	TRUE
dcbccdbcdbadabcdab	TRUE
aadda	TRUE
bdcdaaccab	TRUE
dcdcddbcbdaddadcb	TRUE
abdbadcbbaaddaabcdadd	TRUE
cdbdcbddbadbaaca	TRUE
cdbacbaddcbaabdbdacbdccad	TRUE
baadcadabdcbdcccbdbd	TRUE
accdbacddcaccaaacbcddacb	TRUE
cdbcdc	TRUE
bbdaadcbadbbacbd	TRUE
cdbbbadccbddda	TRUE
dbccbbccb	TRUE
d	TRUE
bdcdbaccddcabcadbb	TRUE
caabcdcdcbdccdbccbb	TRUE
bbaccacdcaddcdcdbbdb	TRUE
abadadacdbcbacda	TRUE
cdc	TRUE
cddbabdbabbb	TRUE
caccbdbbbdcac	TRUE
b	TRUE
dbbc	TRUE
dabbdad	TRUE
aaabccadbadcacadbcbd	TRUE
aaacababcd	TRUE
dbcbcbcb	TRUE
cbbadacdacaabacdcbcccac	TRUE
dbbbbbadaadbcbdacadbbdd	TRUE
b	TRUE
bcacd	TRUE
ccadcbb	TRUE
ddcdcdbdabcdacccbbacabcd	TRUE
bcbbccd	TRUE
bbdccbcac	TRUE
cadcc	TRUE
aa	TRUE
acbbcacdaac	TRUE
adcdccdbdcc	TRUE
cddaacddad	TRUE
caaaabddcdacad	TRUE
bcabcccbddaa	TRUE
ddbcaacbdddabdd	TRUE
acabbaaddaccbbcbdca	TRUE
bacaababdabbadcdbabcdcbdb	TRUE
ccbc	TRUE
bddbbbdddbdb	TRUE
aaddcaccc	TRUE
bcccbcccb	TRUE
cbbdcbbaaabccaccbadbbc	TRUE
dda	TRUE
cccbdcbcaaacbabadcab	TRUE
cbdabbdaccabaaad	TRUE
adacadaddabdbd	TRUE
cdaad	TRUE
cabdadccbaca	TRUE
b	TRUE
cdbbbbccdbbdcabbaacdbd	TRUE
bdacbca	TRUE
bccda	TRUE
dad	TRUE
aadbcaaaaabacdadba	TRUE
bcbbbdcdabdaabb	TRUE
cbdbcbccbabaccbb	TRUE
bbabdacca	TRUE
adbad	TRUE
dbaca	TRUE
dbcdbbbbacdb	TRUE
ac	TRUE
cadbcabbbadcacbc	TRUE
bcd	TRUE
ccc	TRUE
aabcccddcd	TRUE
abdbabaca	TRUE
abccabbcbcdcbbbaa	TRUE
cdabc	TRUE
cabbcddbdaaadaccdbadb	TRUE
dccdaccbdbbdddcb	TRUE
dbdbabdaaabb	TRUE
cacbdbcabcdbbcaabbddc	TRUE
dabbaddaadbabacdb	TRUE
bbccddaccacbadd	TRUE
cbbbcaaacaaacabccabdb	TRUE
acbddbcbbcdaaddcdbddccad	TRUE
bdabdacbdacbbbcdc	TRUE
ccdbacabcddcabaab	TRUE
cdcdcdabbdddaadbaad	TRUE
daadacaaadb	TRUE
adbaddaccbdbbcdddc	TRUE
badcadbabdcabadaaacccd	TRUE
caddcbadb	TRUE
addddacdbccdbc	TRUE
addbcddbabca	TRUE
db	TRUE
dabdbcb	TRUE
acacbadd	TRUE
dddacda	TRUE
caacabb	TRUE
bacddcbaaaacabcc	TRUE
acabbdbbbbaaabbadcbacadba	TRUE
ccdbcccbda	TRUE
cdbcb	TRUE
bcabdbbacadbb	TRUE
bbdaaabadbbdc	TRUE
bbdbcabdbddacdcaaaabbddd	TRUE
addaccbacadadaa	TRUE
cbadcaabacdccabcbddcb	TRUE
cba	TRUE
bcdbc	TRUE
cdbaabcbcaaddca	TRUE
caadbdaab	TRUE
cbbbcadccdaddabbdbd	TRUE
adadccacdcbabcbcabaabb	TRUE
cbbdbcacdaacbbbbbcadcda	TRUE
bccddaddbccdcc	TRUE
ccacc	TRUE
abddbacdcbca	TRUE
bbdaca	TRUE
ddd	TRUE
bbdaccdb	TRUE
caccdacbbddb	TRUE
bacbbacccda	TRUE
acadbcbabbadcdbadccbdd	TRUE
aabbdcabaacadad	TRUE
acddaacacdcbc	TRUE
dbaabd	TRUE
cbcaccccacabcadbabaaadccb	TRUE
d	TRUE
daaaaabbddcdabaabdaadd	TRUE
cbdcadbcaada	TRUE
dbccadccddccbabcb	TRUE
bcbccdb	TRUE
aacadacabbdddcbdaaaacbad	TRUE
ddddcddadbaabbdcbadadd	TRUE
ccacdaa	TRUE
dcadba	TRUE
cdbdadbcbbabdddbabcad	TRUE
cdcbbbaaddacbabbacb	TRUE
bdcbaabbadbcabada	TRUE
ddcdaadddbdddacdddcbb	TRUE
babbdbadcaaaddbbcababac	TRUE
cdbdadbccabccbdbdbabadda	TRUE
bdcdddbaccddbdbaada	TRUE
accabbabdcaaabcabdccccc	TRUE
d	TRUE
b	TRUE
ddccbadbaa	TRUE
cdbdcbccadb	TRUE
dbacaabbaccddabaca	TRUE
bcbd	TRUE
cbdcdddacddcbbda	TRUE
adbabdaccdccbaacaaccab	TRUE
acdbdbcababcb	TRUE
dcacaccbbabadcdacdcda	TRUE
acaccd	TRUE
dbcdaadacabccdcd	TRUE
abdaaadbaccc	TRUE
bbbabccdddbbacdabcbaa	TRUE
bdadbcbbdddcdcdcdbcadcdc	TRUE
bcddaaabddbbbcdab	TRUE
cddab	TRUE
bbabadbabdaaaacad	TRUE
bdad	TRUE
bbbba	TRUE
aaacb	TRUE
dcbabaaababcac	TRUE
bcaa	TRUE
acaaddddaaccadababbcccb	TRUE
aacb	TRUE
adbddcaccbdcddba	TRUE
cd	TRUE
ccd	TRUE
c	TRUE
ccbbdabcbcdddc	TRUE
bcaaadddc	TRUE
bacacbccbcccaa	TRUE
bddaddbcdbaaccdabbddaa	TRUE
bcccdccdabcabbaaab	TRUE
bddcdbaaadcacbcbbab	TRUE
cacddadddac	TRUE
bdaacabacacaadbbdd	TRUE
bda	TRUE
cddcdddddbaabcbcbbccdcdab	TRUE
dbadbdbcdabbaa	TRUE
abbbcaddba	TRUE
dccadbdcbcbcccddcbbd	TRUE
adbaabbccabdb	TRUE
abcbcddabaaccbcccadd	TRUE
ccbabbccddaddbd	TRUE
bdcdddabdbadcccddb	TRUE
cabddcdbbcdcdbaccacdcabb	TRUE
cabbcddddddca	TRUE
daadbdabbcbdb	TRUE
daaaacdaa	TRUE
dbdcbcdcdc	TRUE
abbcacdccca	TRUE
bcacaaaabdbcdbbbac	TRUE
bddaddccababcc	TRUE
ccbcbacbbdaaccacccb	TRUE
bdaccadaccdaacbdbadbbabd	TRUE
abdbccccabaaab	TRUE
dabbbccdbbabbcbabb	TRUE
aaa	TRUE
adcdcdabbbc	TRUE
acdbdcbcadcbdbcabdadcddaa	TRUE
ddddacb	TRUE
ddcaacadbbbada	TRUE
ababcbabdabcadcdab	TRUE
acaaddcdaccbcadaaacccddcd	TRUE
ab	TRUE
abbbaccacddddacdcccccdadd	TRUE
abbbdbccbcdbddcabddaccbb	TRUE
dddcababbcbcdbdb	TRUE
babadbadbcabbad	TRUE
bbcbbbdccdadacbdbc	TRUE
aadbdbdabddabdaacac	TRUE
bcdcaabcbdcccabaada	TRUE
dbddcdaaabdbddcadac	TRUE
abcbbcaabadcdadbdbabc	TRUE
cdbcdbac	TRUE
cabdabdbccabadcdbd	TRUE
dccabadbca	TRUE
aadbcaaacabbbbbdabba	TRUE
bbcbbddbda	TRUE
dccdccbdcbdbbbdccadcadacb	TRUE
adacbbcdcdcabdcb	TRUE
bab	TRUE
acbcadbbbbcbcdabbcacb	TRUE
aacad	TRUE
bcba	TRUE
cbdadbdacab	TRUE
dcbb	TRUE
cadcbcca	TRUE
cdadccbbaaaaaaaaaaadc	FALSE
aaaaaaa	FALSE
bbaaaaaaaa	FALSE
bbbbbbb	FALSE
baabbcacdbdcbaaaaaaaa	FALSE
daaaaaaa	FALSE
aaaaaaa	FALSE
aacaaaaaaaada	FALSE
caaaaaaaab	FALSE
bbbbbbbbaacbacaadcda	FALSE
aaaaaaa	FALSE
addabaabbbbbbbbbacbd	FALSE
dcdacbdabaadcdaaaaaaaa	FALSE
bbdabaaadcdcbbbbbbbbcab	FALSE
aaddbcbabcbdbdaaaaaaa	FALSE
daaaaaaaabccddb	FALSE
bbbbbbb	FALSE
daaaaaaa	FALSE
aaaaaaa	FALSE
bbbbbbb	FALSE
bbbbbbb	FALSE
bbbbbbb	FALSE
dbcdaaaaaaaaaacac	FALSE
bbbbbbbdbabcacbbccdcd	FALSE
abcbbaabbbbbbbbbcdad	FALSE
bbbbbbbcaaba	FALSE
aadaabbaaaaaaaaacbaddc	FALSE
cdbbdaccdabbbbbbbbaabab	FALSE
aadcaaaaaaaabc	FALSE
cbadaaaaaaaabaaba	FALSE
bbbbbbb	FALSE
bbbbbbbcacbbadddadbdb	FALSE
abdbbbbbbbbacbabca	FALSE
dbabbbbbbbbba	FALSE
bdbbccbaacaaaaaaaaacabd	FALSE
acbbbdaaaaaaaabdaaab	FALSE
bbdcabbbcaaaaaaaabccca	FALSE
abdcaddaaaaaaaadd	FALSE
bdaabbdaadaaaaaaa	FALSE
cacbacabaaaaaaaa	FALSE
bbbbbbb	FALSE
aaaaaaa	FALSE
bbbbbbbc	FALSE
ccbbbbbbbbbdbbbbca	FALSE
cdbdadabadbbbaaaaaaaac	FALSE
aaaaaaa	FALSE
bbbbbbbaa	FALSE
bbcbaaaaaaaa	FALSE
aaaaaaa	FALSE
abaaaaaaaa	FALSE
bbbbbbbccadbadbab	FALSE
aaaaaaa	FALSE
bbbbbbbb	FALSE
abacaaaaaaa	FALSE
dbdccbcaaaaaaa	FALSE
bbbbbbbbba	FALSE
bacabdcdabaaaaaaaadbb	FALSE
aaaaaaaaadbcadbbcdcbcca	FALSE
acbdbdaacabaaaaaaa	FALSE
bacbbbbbbbbd	FALSE
bbbbbbb	FALSE
bbbbbbbdb	FALSE
aaaaaaaaaadaaabdcadadd	FALSE
aaaaaaa	FALSE
aaaaaaa	FALSE
dcbacbabbcbcaaaaaaa	FALSE
daaaaaaaadca	FALSE
bddcdcaaaaaaa	FALSE
ababacdaaaaaaa	FALSE
aaaaaaa	FALSE
cabcdccabaaaaaaa	FALSE
aaaaaaa	FALSE
bbbbbbbabbbdacdbcbcaabbdb	FALSE
bbbbbbbddaaccabd	FALSE
cdccdbbaaaaaaa	FALSE
bbbbbbb	FALSE
bbbbbbbcbacbcddc	FALSE
bbbbbbbccdccdbbcbdbacba	FALSE
dddcbccabbbbbbbbbcbcbb	FALSE
bbbbbbbcaab	FALSE
cdbaccbabdaccddbaaaaaaa	FALSE
cdbaaadaaaaaaa	FALSE
abbdbbbbccaaaaaaa	FALSE
aaaaaaa	FALSE
bcbacdbbbbbbbbd	FALSE
aaaaaaaa	FALSE
acdccbcbbccbbbbbbbb	FALSE
bbbbbbbadadcac	FALSE
adbbbbbbbbbcbadd	FALSE
bbbbbbbbaabaac	FALSE
cdcbbbbbbbbbdbbaccbccc	FALSE
aaaaaaa	FALSE
bbbbbbbabbabaacdccabbd	FALSE
bbbbbbbdbdbcaddbdacabdc	FALSE
abbbbbbbb	FALSE
bbbbbbbb	FALSE
aaaaaaa	FALSE
cccdacccccbbbbbbbbba	FALSE
ccdbaaaaaaaaaa	FALSE
abbadcdbaaabaaaaaaaaaa	FALSE
cbcccbbbbbbbbcdb	FALSE
bbbbbbbdcbacbdabcadccadbc	FALSE
bbddbdaddabbbbbbbbbddcaa	FALSE
bbbbbbb	FALSE
cdababccdbccdbbcaaaaaaaa	FALSE
adbacbabcdbbbbbbbbbbba	FALSE
cbddacbdcbaaaaaaa	FALSE
dcadbbbbbbbbbcdabb	FALSE
bbbbbbbbbd	FALSE
bbbbbbbbd	FALSE
bbaacbaaaaaaa	FALSE
aaaaaaa	FALSE
baabbbdacaaaaaaaa	FALSE
bbbbbbbadcdcdaacaaccddbb	FALSE
aaaaaaaaccdcca	FALSE
ccbbaaaaaaaabc	FALSE
adddbcadbcbdabcbdaaaaaaa	FALSE
bbbbbbbccd	FALSE
dcbbbbbbbbddaccaa	FALSE
cbdababbdcbcaaaaaaa	FALSE
aabaaaaaaa	FALSE
bbbbbbb	FALSE
ababdddcdcbccdaaaaaaa	FALSE
bbbbbbbdbbaddbcbcaac	FALSE
bdbbbbbbbbbcb	FALSE
daccaaccdcadbdccccaaaaaaa	FALSE
aaaaaaa	FALSE
caaaaaaaac	FALSE
aaaaaaa	FALSE
abaaaaaaa	FALSE
aaaaaaaacdbbdc	FALSE
bbbbbbb	FALSE
bdbaaaaaaa	FALSE
aaaaaaa	FALSE
daabcbdbbcbacdcdadaaaaaaa	FALSE
bbbbbbb	FALSE
ddaaaaaaa	FALSE
adbcabbaabcdbbdddaaaaaaa	FALSE
bbbbbbb	FALSE
aaaaaaa	FALSE
bdcbaaaaaaa	FALSE
bbbbbbbadbdacda	FALSE
bbbbbbbccadccbaaca	FALSE
adaaaaaaaaa	FALSE
bbbbbbbaccacadddaccc	FALSE
aaaaaaa	FALSE
bbbbbbb	FALSE
bbbbbbb	FALSE
bbbbbbbcbca	FALSE
bcadbacbbbbbbbbbdab	FALSE
acccddbbbbbacddbbbbbbbbcd	FALSE
bacbcccdaaaaaaa	FALSE
dbbbbbbbbbc	FALSE
aaaaaaa	FALSE
bbbbbbbabbcdadcaddcdab	FALSE
caaaaaaaaabcbccacdadd	FALSE
bbbbbbb	FALSE
bbbbbbb	FALSE
bbbbbbbccad	FALSE
abbdccbccdbcbbbbbbbbc	FALSE
bbbbbbbbddcbbcbababcddc	FALSE
babadbabaaaaaaa	FALSE
bdaaaaaaaaabbbdbabbbbaac	FALSE
dbaaaaaaaa	FALSE
aaaaaaaaa	FALSE
dbbbbbbbbbdac	FALSE
bbbbbbbbbccdcaaacd	FALSE
adaabbbbbbbbaddcbcab	FALSE
bcdabbbcbbbbbbbbbbdc	FALSE
dbbdcbddcbbdbaaaaaaaa	FALSE
bbbbbbbbcbaacbddaadcbbaca	FALSE
bcaddccbabaaaaaaaa	FALSE
bbbbbbb	FALSE
daaaaaaaaddcda	FALSE
aaaaaaa	FALSE
abbddbabbdbacbbbbbbbbab	FALSE
bbbbbbbda	FALSE
bbbbbbbacbbabbdbdad	FALSE
ddabaaaaaaaa	FALSE
aaaaaaaaaaacdbbaa	FALSE
cdaaaaaaa	FALSE
cbaaaaaaaacac	FALSE
bbbbbbb	FALSE
dcddaddcaaaaaaaadabbbbbc	FALSE
bbbbbbb	FALSE
bacbacccdbbbbbbbbdbacbdc	FALSE
bbbbbbb	FALSE
bbbbbbbbdaa	FALSE
aaaaaaa	FALSE
abbbbbbbbcadda	FALSE
bbbbbbbbbaccdcadab	FALSE
bbbbbbbc	FALSE
bbbbbbbbcdcbabaaabbbccd	FALSE
aaaaaaaa	FALSE
aaaaaaa	FALSE
bbbbbbb	FALSE
bbbbbbbab	FALSE
ddcbaaabbbbbbbbbadda	FALSE
dcaabdcaaaaaaa	FALSE
bbbbbbbacbacadc	FALSE
cbabbbbbbbbbdcbdddc	FALSE
adaaaaaaaadbbcabcbd	FALSE
adbbbbbbbbddb	FALSE
bbbbbbb	FALSE
aaaaaaaabadcbbccadabadbdb	FALSE
abbbbbbbbbdb	FALSE
aaaaaaaa	FALSE
aaaaaaa	FALSE
adddacbbabaabbacaaaaaaaa	FALSE
aaaaaaa	FALSE
dbbbcababcbdbbbbaaaaaaa	FALSE
bbbbbbb	FALSE
bbbbbbbbbadc	FALSE
badbaccaabbbbbbbbbbcd	FALSE
bbbbbbbbbbaaadbdddaadda	FALSE
aaaaaaaabbbbabcd	FALSE
dcddcccaaaaaaa	FALSE
bdbbbbbbbbbacbcdab	FALSE
bbbbbbb	FALSE
bbbbbbb	FALSE
acadbcbcbbaaaaaaaa	FALSE
baaaaaaa	FALSE
bbbbbbb	FALSE
aaaaaaaaaac	FALSE
cccabbbbbbbbb	FALSE
aaaaaaa	FALSE
abaaaaaaa	FALSE
cabbbbbbbbacabbccaaaabbc	FALSE
bbbbbbb	FALSE
bcadbbbbbbbbdddbcdb	FALSE
dbacdddaaaaaaaa	FALSE
cdbdaaddadcbaaaaaaaaa	FALSE
bbbbbbbb	FALSE
bbbbbbb	FALSE
bbbbbbbbbaaccb	FALSE
accabaaaaaaaadccbbb	FALSE
abcdbccbdaaaaaaa	FALSE
bbbbbbbb	FALSE
dcacbbbbbbbbbbcdcaaaa	FALSE
acbaccabaaaaaaa	FALSE
bbbbbbb	FALSE
bbbbbbb	FALSE
cadbbbbbbbbaddadabdad	FALSE
abaacbdbdaaaaaaa	FALSE
bbbbbbbdccaccbdddabcc	FALSE
bbbbabcaaaaaaaaddaadbaccc	FALSE
babdcaaaaaaaabcd	FALSE
abacdbaaaaaaa	FALSE
bbbbbbb	FALSE
dbbbbbbbbdaacbdbddbab	FALSE
dcbdaaaaaaaaaddbaadc	FALSE
aaaaaaa	FALSE
bbcaaaaaaaacccabca	FALSE
bbbbbbb	FALSE
bbbbbbbcc	FALSE
bbbbbbb	FALSE
bbbbbbb	FALSE
dbbbbbcccbbbbbbbb	FALSE
cbbbbbbbbb	FALSE
bbbbbbb	FALSE
bbbbbbbacaddccdbdccacddad	FALSE
dcbaaaaaaa	FALSE
bbbbbbbabcabaacbbdbbbbaab	FALSE
badcbbdbbbbbbbb	FALSE
dabbbbbbbb	FALSE
bbbbbbb	FALSE
bbbbbbbdac	FALSE
aaaaaaa	FALSE
aaaaaaaaadb	FALSE
cacdadbadcdaaaaaaaaa	FALSE
bbbbbbbcbbacc	FALSE
bbbbbbbbcaabcadbaba	FALSE
aaaaaaaaaab	FALSE
bddacbabcbbbbbbbb	FALSE
aaaaaaa	FALSE
bbbbbbbcb	FALSE
badcaaaaaaa	FALSE
bbbbbbbbddaacadccbcb	FALSE
bbbbbbbddddddbbcdb	FALSE
bcbbbbbbbbcd	FALSE
bbbbbbbcdcacbcaaba	FALSE
ccbbbbbbbbd	FALSE
bbbbbbbadbdcdabaaa	FALSE
bbbbbbb	FALSE
bbbbbbb	FALSE
aaaaaaa	FALSE
cabcbdabcaaaaaaaabccd	FALSE
cdbddcdacadbbacbaaaaaaa	FALSE
ccdcadaaaaaaaa	FALSE
abddaaaaaaaabbdc	FALSE
bbbbbbbcabdab	FALSE
bbdccacacadbaaaaaaa	FALSE
bbbbbbbd	FALSE
aaaaaaa	FALSE
aaaaaaa	FALSE
bbbbbbb	FALSE
bbbbbbbbcbccac	FALSE
daaadbddaaccbcbbbbbbbbbc	FALSE
aaaaaaaabcdabca	FALSE
aacbbbbbbbbb	FALSE
aaaaaaa	FALSE
cbadcdadaadbcaaaaaaa	FALSE
ccbbbaaaaaaa	FALSE
bbbbbbb	FALSE
bbbbbbb	FALSE
bbbbbbb	FALSE
aaaaaaa	FALSE
adaaaaaaa	FALSE
ddabbbbbbbbaaba	FALSE
baaaaaaaaadcaadbcddbdcbc	FALSE
cdcbbbcdaaaaaaaa	FALSE
aaaaaaa	FALSE
bcbabcaaaaaaaaaaaad	FALSE
dccabbbdbabaaaaaaaa	FALSE
bbbbbbb	FALSE
accbbcbbbacddaaaaaaaac	FALSE
aaaaaaa	FALSE
bdadcdcabdddaaaaaaa	FALSE
dabaacadbcdaaaaaaa	FALSE
bbbbbbbbbbc	FALSE
bbbbbbb	FALSE
dbacacdabdadbbcaaaaaaa	FALSE
bbbbbbbcadad	FALSE
bbbbbbb	FALSE
dacdaaaaaaaaddbdbcaaabada	FALSE
bbbbbbbbbdca	FALSE
babcadcdcaaaaaaaacb	FALSE
cacbddddbdbadaaaaaaa	FALSE
aaaaaaa	FALSE
aaaaaaa	FALSE
dbcbcbbbbbbbbbadaab	FALSE
ddabcbbbbbbbbbdddad	FALSE
bbbbbbbaddbddad	FALSE
bbbbbbb	FALSE
aaaaaaaaaaabb	FALSE
bbbbbbbccdccdaacbca	FALSE
baaaaaaaa	FALSE
aaaaaaa	FALSE
bbbbbbbbdaad	FALSE
bcbbbbbbbbd	FALSE
bbbbbbbccccdbabcbbbdcbbac	FALSE
abadabccaaaaaaaaad	FALSE
aaaaaaaaddaabccca	FALSE
ccdaaaaaaaaad	FALSE
aaaaaaa	FALSE
dabbbbbbbbbccdbdb	FALSE
bbbbbbb	FALSE
bbbbbbb	FALSE
cbbbbbbbbc	FALSE
bbbbbbbacdaaaabddbddcd	FALSE
dcccaaaaaaa	FALSE
aaaaaaa	FALSE
bbbbbbb	FALSE
dcbacadbbccadccaaaaaaaada	FALSE
cabcabaaaaaaaaaaac	FALSE
dbabacdbbccdbdcabaaaaaaaa	FALSE
acaadbdcabdacaaaaaaa	FALSE
abcabbbbbbbbb	FALSE
bbbbbbb	FALSE
aaaaaaa	FALSE
aaaaaaa	FALSE
bbbbbbbaaabadaabddbacccd	FALSE
baaaaaaaaabdc	FALSE
bdbaaaaaaaadbaddcbbbddba	FALSE
abbbbbbbb	FALSE
cccddbaaaaaaa	FALSE
bbbbbbbaabaaabcdabaadcd	FALSE
dbdaabdadaccbcbdcaaaaaaa	FALSE
bbbbbbbcdadbddd	FALSE
bbbbbbbbbcacacbcbbcddad	FALSE
bbbbbbb	FALSE
bbbbbbbdadcabbbbc	FALSE
bbbbbbb	FALSE
bbbbbbbc	FALSE
bbbbbbb	FALSE
aaaaaaa	FALSE
bbbbbbb	FALSE
aaaaaaa	FALSE
bbbbbbbbadbcaac	FALSE
bbbbbbbccbdbcadbdcabbc	FALSE
bbbbbbbcadacaaaccdaddaac	FALSE
caaaaaaa	FALSE
aaaaaaaaabcd	FALSE
baacadaabbbbbbbbcdadcbbba	FALSE
cbbaadacdbdcaaaaaaaabdbba	FALSE
aaaaaaa	FALSE
dbbabdabbcddaaaaaaaa	FALSE
aaaaaaaa	FALSE
dddaaaaaaa	FALSE
bddaaaaaaa	FALSE
dddbcbdcbbcababbbbbbbbdb	FALSE
aaaaaaa	FALSE
cbaaaaabdacdaaaaaaaa	FALSE
bbbbbbbbdbdc	FALSE
bbbbbbb	FALSE
bbbbbbb	FALSE
bbbbbbbbdbabbdaaa	FALSE
bbbbbbbcdbbadcbb	FALSE
aaaaaaaadbabdcbcda	FALSE
bbbbbbb	FALSE
bbbbbbbbdbbbdbdcaccccd	FALSE
bbcddbaaaaaaaab	FALSE
aaaaaaaaadad	FALSE
aaaaaaa	FALSE
adbdcdbcbcacdbcaaaaaaa	FALSE
aaaaaaa	FALSE
aaaaaaa	FALSE
bbbbbbb	FALSE
aadbbacbacddbbbddaaaaaaaa	FALSE
aaaaaaa	FALSE
bbbbbbbccddcd	FALSE
bbbbbbbcaaacabbab	FALSE
bbbbbbbadbbcabbccdbdb	FALSE
bbacaaaaaaa	FALSE
bccbcaccaaaaaaaabcdccdb	FALSE
bbbbbbbacbbb	FALSE
acccbbbbbbbbbbba	FALSE
aaaaaaa	FALSE
bbbbbbb	FALSE
cdcaaaaaaaacdbcb	FALSE
aaaaaaa	FALSE
bbbbbbb	FALSE
cbaaaaaaaabbdda	FALSE
abbbbbbbb	FALSE
acbcaaddaaaaaaa	FALSE
ccacbbbbbbbbaadddbda	FALSE
caabbbbbbbbbbbbaacdcc	FALSE
bbbbbbb	FALSE
cadabbbbbbbbadbd	FALSE
daddcadccdaaaaaaaaa	FALSE
cbbbbbbbb	FALSE
bbbbbbb	FALSE
bbbbbbb	FALSE
bbbbbbbbcbcbacdbcadcdbc	FALSE
bbbbbbb	FALSE
caaaaaaa	FALSE
dcbbbbbbbbbdddabbcd	FALSE
aabbccdbabdddbcaaaaaaa	FALSE
acdbbbbbbbbbc	FALSE
bbbbbbbddcdbbbccaadbbbcbc	FALSE
cbbbbbbbbacbbdcc	FALSE
bcdbcaaaaaaa	FALSE
aaaaaaa	FALSE
aaaaaaa	FALSE
dcaaaaaaa	FALSE
bbbbbbb	FALSE
aaaaaaaaadacacbbc	FALSE
bbbbbbbb	FALSE
aaaaaaa	FALSE
adcbaaaaaaa	FALSE
bacbddaaaaaaaaad	FALSE
bbbbbbbbcdaddcdaadcbcbba	FALSE
dbaaaaaaaacbdcbddcacdbaba	FALSE
ccaaaaaaaaaaadd	FALSE
bbbbbbbd	FALSE
cbdacdcabaaaaaaa	FALSE
bbbbbbbbaaa	FALSE
bbbbbbb	FALSE
bbbbbbb	FALSE
baaaabdcabbcbbbbbbbbcdd	FALSE
bbbbbbb	FALSE
dddbaaaaaaaaaabcdd	FALSE
cbbbbbbbbbcccd	FALSE
aadaaaaaaaab	FALSE
aaaaaaa	FALSE
aaaaaaa	FALSE
cdbdbcbadbaccccdaaaaaaa	FALSE
badabaaaaaaaa	FALSE
cabaaaaaaaac	FALSE
aaaaaaa	FALSE
dacdabaadaaaaaaa	FALSE
ddbbbbbbbbb	FALSE
dacdacbacccbbbbbbbbdbccd	FALSE
aaaaaaa	FALSE
bbdddabcabbabbdaaaaaaaaa	FALSE
bbbbbbb	FALSE
aaaadbcbbbbbbbb	FALSE
abaaaaaaa	FALSE
dbbccbcaddbabdaaaaaaa	FALSE
bbbbbbb	FALSE
aaaaaaa	FALSE
dababbbaaaaaaa	FALSE
bbbbbbbcbabdccbcc	FALSE
bbbbbbb	FALSE
bbbbbbb	FALSE
bcbddddccdbdccacaaaaaaa	FALSE
ddcaaaaaaaaaccbbcbcddd	FALSE
bdaaabdcaddccabbbbbbbbbbc	FALSE
bbbbbbbdcccdaacdc	FALSE
caaaaaaa	FALSE
bbbbbbbdda	FALSE
bbbbbbb	FALSE
bbbbbbb	FALSE
cbaaaaaaaa	FALSE
acbdbbbbbbbbdacdcbcd	FALSE
bbbbbbb	FALSE
dcadabbbbbbbbaaabb	FALSE
bdadbbdadbaaaaaaaaaabc	FALSE
bbbbbbbacc	FALSE
bbbbbbbcabcbcbd	FALSE
