HATtXd	TRUE
bbLoXVvZwDpvpFnWkgwwB	TRUE
JUIPrJgdMOfbU4qFkUPXO	TRUE
eutnp	TRUE
wVv2PYLPeuugdPiLNcVlJHbD3	TRUE
tDUktXKQZbIPy	TRUE
WWtYSxzidbJoSurruSfOHV	TRUE
S1jUvst4tFi	TRUE
4dKtv	TRUE
Py	TRUE
G4qsoMnXZhLTqiddtt32VRimY	TRUE
rNPH3S2phr	TRUE
i3jR	TRUE
s1BxSlnxaAeA	TRUE
2ipPWlksVufmfwQSmrsT1zJg	TRUE
LhEkuOK	TRUE
mNM3w2HmSbbCo11IsLY	TRUE
hfyqYiexM	TRUE
FLWfHZIKsaJifSSOihHm11	TRUE
fFgwHS	TRUE
u4IIPYmoqEJ3WT	TRUE
HNvlQo	TRUE
dyhHfVtb	TRUE
no4XOMiuzjcL	TRUE
f	TRUE
KxFMnmZ	TRUE
aAE	TRUE
Q3VlMHETFLMYVsKdWOpeqnBo	TRUE
QVpKjgvQN1NzordQmpXTXZHBx	TRUE
ZOCMcqFw4UEV	TRUE
nSfjjqub	TRUE
QOuYMAb4d	TRUE
TvCJG2hs	TRUE
rTNh2KTm1Ph2g	TRUE
jrCb	TRUE
F	TRUE
FtDTfiV	TRUE
GimopbVAvJt2P	TRUE
tAgMBHLsMg1yGHsL2qJMxi	TRUE
hV2nFfCIui3Cg	TRUE
UrxNcuLq4ewAIHvOdgCOfwb	TRUE
IYX2puKj3g1JBOlgMJl2IH	TRUE
bPwVXHtH44VFZ	TRUE
pE4NUQOKNOzgJhm3B1KXIF	TRUE
eDdaJ1kv1APEvAfxs	TRUE
ezRwXGmDM2fI	TRUE
HCLQQcaw4uT	TRUE
oznikoYGu12yg3a3HyNCOH	TRUE
Q	TRUE
NUemtbaY4VUxuLQGI	TRUE
tgqsniPlBPI1jqCkOphRW	TRUE
cbfAy4zcDaUZ	TRUE
BWS2GmP	TRUE
34iNMbKSsCSFzm4BixdulFEt	TRUE
nYYvyJupBGbypu1pZyQqXRuMe	TRUE
fkSIwxOuqQDyxNY	TRUE
3pqbQIw	TRUE
2JVFejZAshUDAvuILOINm	TRUE
sdV	TRUE
hQWRJU2L	TRUE
NkPwRlsKK	TRUE
UYtzEvmTfjRFJR	TRUE
TTrpXDXmxIyebjwAUqs	TRUE
PSoeHYBXzRQbVbmgj1yrDn	TRUE
LMAJCi2	TRUE
kXdQV	TRUE
2Wncr4ZbnhzOREMwSC	TRUE
PId	TRUE
iQTbshN	TRUE
QcZkSdmZcRcyTWPF	TRUE
FnCUfMn	TRUE
yekiK3EBYCUtYwZC3ou	TRUE
oLgeRtTaATM	TRUE
QIoJCUzdgSoRSVpP	TRUE
cWoDFGZwygxoNdmTf	TRUE
QB4VL1ZxcJIvbDnStadhEooSs	TRUE
gNDABKmpRtWE3	TRUE
zdswkNyRquyvdgeu1X	TRUE
STcK	TRUE
OZDD3WtCGJaSeLvFCeMFy	TRUE
poKsfHWOrqJxDRbPodgJvjW	TRUE
kEbnYPvHVwAR	TRUE
1oshUAOkFKvDRIX2pSnLt	TRUE
H	TRUE
JmvguGT1rpflCSh	TRUE
zmrAWDqxUH	TRUE
nKXMUcspduA1efZEyH	TRUE
ADXyHUodiPCq	TRUE
nldeW	TRUE
WuK3T4a	TRUE
r4IQHziNNeSOUBeLn4zj	TRUE
lOJsTJo4uwNBn4djKH4pjTNpY	TRUE
huQLPKggCgYkjXYzOSYK	TRUE
w	TRUE
uAFdOA1YSiaJdFsREsTFK	TRUE
jSebUvGftFHVMzUFvvHFkBrn	TRUE
z1ztcM	TRUE
tNL3Vq1GLLZAtldsjuxcB3	TRUE
l1DmTmVE1oQGvUtqOp1CwJHZ	TRUE
oskSeO	TRUE
zeyrDNKWUaFJ	TRUE
WDywlDaeFFRpg	TRUE
lsexWguDcgLMc	TRUE
FceczrVAQJQyazGXf34t	TRUE
cjoXNfZQZIfzf	TRUE
UyqANeTRCgvLr4	TRUE
4o1wnmdxOKW4qHOmEJexurb	TRUE
OKaIHNuKDEIpGE	TRUE
xMRIXQk3olNoyIvaTNvzf	TRUE
bfwRlQtvpjTTZesHpNEVqUBj	TRUE
DFIKUJfSqkLeinZRKdrKKk	TRUE
m4qtp	TRUE
FbgNLtTCD1qSpoUu	TRUE
B2t	TRUE
gZnXmXsJJ1C2C	TRUE
oMDbPHUjBiy2KJrG	TRUE
gOLLSRXcxwLwVS	TRUE
ATqGTRPBvWTTCX3yGZ	TRUE
Vw1xgRHKSssXMzd4Xk2W	TRUE
gfULjU	TRUE
wPf3VbEzgelwVhFgFFfwIXYK	TRUE
dhw1wjOyO3SP	TRUE
WxXthgoJuis1ovzUUsAlFJW	TRUE
gnmPZQywLw1LsIaBc	TRUE
lAIdCqPcdEPZTgDZyllzuVXzC	TRUE
vxQ4ntPTzVorvfam1yaU	TRUE
JuRQNNTYx2QCsvn2qY	TRUE
FuXQw3	TRUE
mq3S1LnRYFP	TRUE
lndiCFdU	TRUE
qFGTtpg	TRUE
iblraGDzUcDuEhjzQNRy	TRUE
yEZtULSFPLw1loZYlkQVWDt	TRUE
TcCRjYgMxw	TRUE
1W4umTnJkgMeoTAz	TRUE
ckyXB4GW21sis	TRUE
ZwezBkqwtpcgbbsFnx4Q	TRUE
buMVPrZoaaAszFDGRIW	TRUE
uF	TRUE
ydv4Pyo4PCbjaPuaJ	TRUE
OOny	TRUE
LasLABmLE42xEijPKl	TRUE
NbVz4P	TRUE
XhTUgGob32mRwkJ	TRUE
2Six4lhWJzoSBObC	TRUE
AnI	TRUE
MDCyskKRqQIP1uKwvkqZc	TRUE
hh2uUBv4zuJzhB	TRUE
nTMKAeAOJ4g	TRUE
PVt41xn31u	TRUE
unTX	TRUE
VlCDe4mdkyBvbJXfgcQyG	TRUE
vrWZFCdBGGYyfSijmGrY	TRUE
nTt	TRUE
sy4FpIpegDAiVu	TRUE
oVnJ12re1	TRUE
WeF3S2	TRUE
nlzngNdlGWAfEm2htuD	TRUE
Obtp	TRUE
l	TRUE
uH1	TRUE
nqrQxsVoyFjZ	TRUE
tHCuzyvE4bpawyztiyJ	TRUE
phM1FLE1VVWcaXlGZ	TRUE
lnMUNBO	TRUE
sT	TRUE
qXClO	TRUE
32E	TRUE
kBgzQUzId	TRUE
oTxqkK2zgUC2HzFj2RhD	TRUE
jQxMzovWxjOk	TRUE
g3rSzp2Q	TRUE
IJoECIqnPboKwDWmv4	TRUE
ChN13gfQqt1aeEl	TRUE
CSFgDphD1NV4yKi	TRUE
OSNqfRfrOuKuUwOWZkyQhjAlz	TRUE
sW4fxFXVW2t2nGKg	TRUE
TUUMNaNVREf	TRUE
Hr	TRUE
HqMSk	TRUE
PEurL	TRUE
Fl21wLfRDLdjEEVpkLJE	TRUE
vNulERR3R4kh2ovkdByNdyZX	TRUE
zbbQ2Sxd	TRUE
Ufh	TRUE
aQn3R4VJGvhK	TRUE
BUmZZQBsHMRHjsizsGI	TRUE
Yf2pgNQrIxKDRp2YsN	TRUE
3gjj4OJmZHJDDz4TH	TRUE
YGj3Gq2lajaufBp	TRUE
fuAuMDrsOY4pf	TRUE
ySlk2hOFHST2AQ3fXva3ZU1L	TRUE
jfFqvewTnDf2ru	TRUE
tuO4wlOelI	TRUE
SfsHifC1Ord	TRUE
UAqezqjBfKrgddBBaaSeDC	TRUE
WLir4HuyoRfyj	TRUE
yYrHirlAU	TRUE
2vAwKdxnxRCp	TRUE
TqEHxHukytqTUB	TRUE
RWZdrqnFSXiSJXCiCsXgPtXw	TRUE
a3aQhzaHXqePaHgxmCsP	TRUE
DLM2U2ijXjFjvv	TRUE
HlHuKuOjKxStbRkWLGcikrISD	TRUE
vviEdBDRBaT	TRUE
Jwm	TRUE
RCNlDeZCgctE	TRUE
F2y1	TRUE
y	TRUE
wTDNLtZ2lLdyllGFymShKHqGL	TRUE
WzABDScRPl	TRUE
GklNsdUwOcWMgLkyNcBQQA	TRUE
bzlzYLTqitTCUHIocW	TRUE
LDJr2zo3gM	TRUE
eYPhYeiKZFj	TRUE
N	TRUE
r2puDpCDQVWgaj4wY	TRUE
FdBb3dD	TRUE
gTLXdnsKM4NKrPX	TRUE
C2elMhFsZQfTEemFTHyngcc	TRUE
oCBFAifvGhc	TRUE
KuzjRstyby	TRUE
d41CIjje1pjE1DwNvChS	TRUE
iwLhrksWqCmSUrQpvTgBQG	TRUE
qhkzIXtBV4aLGTRkdy4	TRUE
WtkZc3KCcbQgychlcQkY	TRUE
muhcGX4zOC	TRUE
zesfi3bJHVM	TRUE
HyMolxhoesJYQxlWyRqdIQ	TRUE
E32YdhuPdlwl	TRUE
CcqvpRx	TRUE
sgKlgnCbAtM1Pvay1EXvcvA	TRUE
m	TRUE
oALjo	TRUE
uKkg	TRUE
ui2mwosbvRqRPIHTGLX	TRUE
ZowV1PUb3Z	TRUE
fxMtveuQJwTd4sEPlz2JRWAYB	TRUE
rFUfdKeYXNRMtdJAtlcwEhFW	TRUE
Tux4lwnO4	TRUE
FcEptOqFsY1NiD3eX	TRUE
ne	TRUE
XD	TRUE
rqfcRAMoaYGQOXaVJKTV3TQd	TRUE
Cax1lALM3ML3gke4ZBCwX	TRUE
psEmek1IJAGgXnXrb	TRUE
pFL1ZxMCycIZZGvExTX	TRUE
sAhORNVTypBxQTxH	TRUE
DKjODZsosVzXnLDszadid4	TRUE
z3eBie	TRUE
gywoacusPEWRaEKqSd4zDV	TRUE
ttwwZbrxRCHBVC	TRUE
Eqdux23UPvq1s	TRUE
UTWWgGSdRgFUCfYDHMm	TRUE
TWIo2ktAONZ	TRUE
wBwuht2qcLj	TRUE
DyBGzGbykuyKDMqlwSJaDLqy	TRUE
qUnRDvFWWrtlEBuJzG	TRUE
T	TRUE
YnGlIGNjb	TRUE
IThU	TRUE
sfaseWItv	TRUE
mxBYl	TRUE
aj	TRUE
dSmlWOng1KMmtRbVn4Q2	TRUE
Jqg3wKDfuGFCTgW4dXxqL	TRUE
VEP	TRUE
PTWBpvmCk	TRUE
Tm4Q	TRUE
B4	TRUE
MeAhLLguCmFDbNzAXB2KbM	TRUE
gdxewjYMzvIUD4Yr	TRUE
EN33RhbymmicFO	TRUE
ZwDpmtiDkBkhSrKZEJrYdvTV	TRUE
rOFNXsUmnYLsFukkSswpAjHm	TRUE
fucnxIAYdWmMmqnfFPDSMJ2jw	TRUE
XNsKDh4fYvULbTzW	TRUE
zVgSNaj	TRUE
qrMa2OOnH	TRUE
KNujgpqmPHh	TRUE
ZHhJQxrZvP	TRUE
PT3	TRUE
OIhilI1EXod	TRUE
GeIir	TRUE
XLMWA1kJ3OewkTKm4	TRUE
wbxxEvhrtyT	TRUE
HgEId4U	TRUE
FuZKJQ	TRUE
P4i3esbeEzI3QwSkDDX	TRUE
UPTMvojeeEGkDe	TRUE
bxgIZPzsYThHFtmQdod1Q	TRUE
ggZkBMmpBKLm1qY	TRUE
vegwXiFnkTyoI3ZDbi	TRUE
pl3bOeXjSqZLslYE1V	TRUE
2OJQvtARfjcOfzIiYfk	TRUE
jaXJJFh	TRUE
Jp	TRUE
hHVwnDh	TRUE
2s	TRUE
bhG1fFc2	TRUE
PWzoJtrnLscTYf1OYb	TRUE
Y	TRUE
IDr1IrISN13SWVn	TRUE
3	TRUE
kwKnkTHgSFtyoubzQZFQk2n	TRUE
3GeubMPWhpKp2yvExzi	TRUE
oRxSnmEj1vlXEndJdAmEV	TRUE
YyX1YFyXgv	TRUE
JhQLV	TRUE
31jUZW3R4RwFkt2Uel	TRUE
PwmWN1yGLvzRFLuV3YoWkA	TRUE
ZdncGqxm	TRUE
vm	TRUE
iSZVn	TRUE
KzQRIqNbRw	TRUE
jnRQBWPMeODOzNPnk14heaNeJ	TRUE
dIYvyRwuII	TRUE
WaTyPRcZl	TRUE
gublCxkkSdPOcqbB	TRUE
VLBTYk2JLoMVsCW2AT	TRUE
a	TRUE
kLKaVr	TRUE
A2pHAjkrXW4gcTSnxEdN	TRUE
FlEvjNksUicqN3TAMlvvH	TRUE
JX3sVUfMC1	TRUE
txrKpAJQcGtRqY	TRUE
mvf	TRUE
qrtD	TRUE
NcEluZko3xxAaxTL	TRUE
SClfJ	TRUE
LM1oIPL	TRUE
mPYQVOHsj3Vc1rpB	TRUE
malNEeOAJBTVvsO1AH	TRUE
OVgre1qzgxaUpXzeDJvgjWwE2	TRUE
okzelBq1	TRUE
xjmoTMWOB1cVzn	TRUE
Gowq2OQmcFRGEI	TRUE
OmLmlvQYcENGjiCllQztyam	TRUE
q4JS	TRUE
WMBytEURwOK2nI	TRUE
yZcYwT4ltVo	TRUE
eeFLrsoMnN	TRUE
dDmKBTjLXLqerbmCclJr	TRUE
GDQpLD	TRUE
KhV	TRUE
rFvUCTR232LVYODGpgb	TRUE
wzh	TRUE
vzFUWxvQkuepyKFoEtsYHjN	TRUE
byi3KSjfQpJyV	TRUE
2cyi	TRUE
etp	TRUE
tsIRj	TRUE
N3PJaHILhBAF2AToc2FcNBNKV	TRUE
g1	TRUE
VY2ObrqYF	TRUE
mKKdgL1	TRUE
wjsqVJITlqFcK1QJL	TRUE
jxEiQenweXBC	TRUE
UNYRLbsTc	TRUE
gx3eYFXun3n	TRUE
vdVcN11pKTIRiJ1qX1F	TRUE
vNnzxwIj2nfifiKMiYFvADV	TRUE
kkXrzcxXwADIcRnSc	TRUE
jybpNokXOQfQvvPoRmpJGyGfv	TRUE
3	TRUE
GdVEVqnkSJjN3Bft	TRUE
eyr4eWN4jrStBUgnuZbXl	TRUE
wim4Bqomb	TRUE
ngZTxrELkxzRw3rK	TRUE
epLit4SySHOpBHGtVB	TRUE
rXvdm1	TRUE
SglEVWNKPUc2DmV	TRUE
QEFnxQXM3VktzY2uVTGX2	TRUE
gU1qHP	TRUE
toO4rNqhns1hNrbI	TRUE
prnJjI1NjtLlXczfwbYRQpx2	TRUE
OgDCJPgZ	TRUE
Y4gJtNFV	TRUE
tL	TRUE
3cFFq	TRUE
WYhuajzvzihE4BGkGwLvqcWd	TRUE
BxsGaKqn4C1hzDHJLPPzP3	TRUE
WsqANl	TRUE
RXPrwtz4gRfCqtOsXf	TRUE
odbwEjF2hCsKDLnDzDJceDy	TRUE
BufTdhdD	TRUE
nqFTECJEgs	TRUE
SQgvPzLb	TRUE
TlfZgJDjvjXVNe	TRUE
zJbq	TRUE
UXkJDRlzep3eSPWtawuTiMh	TRUE
jA	TRUE
ZPM	TRUE
DApxVSynbnbSnbt	TRUE
RaC3DrCPuO	TRUE
ErKltynVdDyRy	TRUE
r14Mqyw1ENyzLFTcwIx	TRUE
FTZ	TRUE
W	TRUE
E	TRUE
WWhC3fcPxHCoWGBHbRq1	TRUE
pFcHd2	TRUE
HEG	TRUE
KkA	TRUE
SSpHS1FmdCzZ4hTlVWD	TRUE
SXCwEBJENFHf	TRUE
m	TRUE
uewtl42vvRdpLkFcLKUC4Hgjb	TRUE
LMxP4ztKMES2NBcq4axyOFk	TRUE
ozVma3TZa1JH1BvzhHGeSYTnt	TRUE
JQXFG3YuzUBkh	TRUE
gPuo	TRUE
dTUcVCCaHKgNtOBKm	TRUE
ON3OchRBMpNgvQ1b3	TRUE
o1OOmOsIZk	TRUE
ZLxMJKLFyHFsaceS	TRUE
VIVl	TRUE
TzorGrOBo3HgwgDEbP1qxiU	TRUE
erMpCvDlJuqDTMGOHWmeVD	TRUE
yEvIe	TRUE
pxdGf	TRUE
vPwRb1kw	TRUE
Eedwaqwv1AnuWzzSF	TRUE
eXIqUZmwFjJ	TRUE
OYEzYFMEPjJLT	TRUE
nzUPbfMbX	TRUE
fPN2QBBqSHmvse	TRUE
LHdb3cYlV	TRUE
VSbbBHsQ	TRUE
uFsaxQrV	TRUE
zNHeDVWIdzlPShjqprhr	TRUE
WILCZx	TRUE
oFDrw2nLn	TRUE
A	TRUE
y2K2qzpgONFrVfGgIsQdRhl	TRUE
r	TRUE
OvUPpgY3HPShRu	TRUE
3GqG	TRUE
23g3SySGROHR	TRUE
Mo	TRUE
fSGLnbLb3vPKnqI	TRUE
so	TRUE
leqLWJvidJvWvBmSggUUemF	TRUE
QUT1c3	TRUE
YuU1X1DnSLyTdR3wSc	TRUE
4Rgp	TRUE
tKVVKTzfoGwWL2pZcPFN	TRUE
csw3uqyEJ1NcIFalhiLGB	TRUE
E	TRUE
dWhngaS3k3QoFW3pnSHDT	TRUE
EQ	TRUE
zbFHEcWavlncLnG	TRUE
CNq3slpN	TRUE
dfPlMMPUERbG	TRUE
aJ	TRUE
hkaLxY1OY4GrQueNLknvoD3WA	TRUE
bR4EAYSNGqTESZcjGAMC	TRUE
C4	TRUE
RH4cs22ih4T4cZuQypv	TRUE
2wJhjy3JEbPhpYZU	TRUE
cbnFnmsBTEZRNSu	TRUE
qqSFR2HoAtFlkQC	TRUE
r2VpYHyuZ3jaamTRNtHwuetwP	TRUE
QNS1YAYqO	TRUE
MSOnEc2ZQVHHMPQ	TRUE
wVGYxMViTLK	TRUE
xQKrepqQodPa2IhiaW2zdS	TRUE
u4zyl	TRUE
WFwBPHmVWLhQDfeOMIjQ4TO	TRUE
BO4BRMEYbTxtxjc3ugFyuacu	TRUE
2Meih1FO	TRUE
mkoIEBZV1KAg3OR	TRUE
jynCNTBmXm4CDobai	TRUE
kNSvmrMVhJGSCgJ2X	TRUE
ZPDbKJQiLhhsdCoiseusloe	TRUE
OwHbhY4j	TRUE
uUCHqC4DbibGjyhzp	TRUE
GckPgAxOV3smG	TRUE
KBzTLwVAIbFTns4NnK	TRUE
vOlLUCpsV	TRUE
tdVcnk	TRUE
vgGJOhfmsHlLDuL	TRUE
qJcpkmlKnPfQDBGk	TRUE
Sq	TRUE
rRPtoYcotfvlwbayYXuefFs	TRUE
gF1Z2wtASi4Jx	TRUE
DOYQj	TRUE
SYHw4TJAO1UQ	TRUE
DlKCGMoUo4SLpRCC	TRUE
leCzF4mDzTc3qHvOHlsYuUhH	TRUE
bZSKCzAzIxjltsovS	TRUE
vVhm	TRUE
GO4aMIsjDO1koZBLqTjCzZwO	TRUE
tYWaDhyFKL	TRUE
seCt	TRUE
AQGKCTqvpBVDElCRchs	TRUE
WU4LtHC4WJxaMuPsSlQi4	TRUE
4SjsJ3E	TRUE
3xQBivfDDWpQExN	TRUE
AgKGUPxyALzZhiK	TRUE
dUaqbAOPGybXf	FALSE
xvaXB2b	FALSE
muHrJC3aJzbMnvE1	FALSE
TAcRmEApXzaciae4rHulkb	FALSE
ceDIra1hvbec	FALSE
rvBcNYDaTkGgSPpoJBEukWMEb	FALSE
xgaAbc	FALSE
kPdzWEJairKQNbME	FALSE
ceQaUQuuPCVk2VMnMTBb	FALSE
ab	FALSE
KlvyVeuHozaIDxakcbIcoC	FALSE
nQbaddpibU	FALSE
Cnabob	FALSE
NYfaaxrbnZiTtZj	FALSE
ab	FALSE
mfaMbDK	FALSE
abi	FALSE
TeSabwJlk1oGPx	FALSE
ab	FALSE
ETWPIHsrRajBKWBffb	FALSE
o3ffrQmZs4MgAsIuZab	FALSE
ab	FALSE
Jya2tZVcLT12PGAlfuVPbGs	FALSE
zabIxGysDUpXJ3BI	FALSE
XBkmRzLnfavERtwKebgFrV	FALSE
IFkjWjavJb	FALSE
ab	FALSE
DCUF34l2dLab	FALSE
1RWbOazX1nb24RGUntXbAnV	FALSE
xhama2aAYk3B2KOU42zVTbH1i	FALSE
MJG1NghOEWa2MKbw1t	FALSE
KKp4w4skQst31dvUgamakGLbb	FALSE
1abYU1RqerFMy	FALSE
sCasWb	FALSE
YKHwF1LJWVDKeabvXJow	FALSE
uCtElJAQaHEbBHQzBhYuzed	FALSE
ab	FALSE
Xa1byHm	FALSE
KHxL2rG4JDBhaNb2lONDCWG	FALSE
ab	FALSE
nUayWxZXMZGnbop	FALSE
kaTrdokAdbjyOSDaEJ	FALSE
ab	FALSE
Laebkki	FALSE
ab	FALSE
aZMTFgYtlmKpBbjH23Ojhykh	FALSE
jEHfa3tbbGpPvU	FALSE
atbAHh	FALSE
KEabMuYUdY	FALSE
q1hcucLQvh1f2dNaICCQbgxo	FALSE
axNnMnNdb	FALSE
aqjbD	FALSE
ilh1mmEay3bBGMEarLTKhpO	FALSE
gWlmbacqQMBbvP	FALSE
PdsasbDio	FALSE
WxPfr4drraAXqbmgYlPae	FALSE
eab	FALSE
a2rkbN	FALSE
l3tRGOLapqb3SD	FALSE
dSaG24BvL2brJ4xa2	FALSE
32ZeFLabaJXa343	FALSE
RwhGV4xRNgaRPBCbMgPSAP	FALSE
vQdOjJaKbmJR	FALSE
XahwHb	FALSE
azMfnzBLvRBblb	FALSE
nyCcgJembtsEtSvp1ajwhbT	FALSE
TQtBGuastbNvwiGMe3tOCJ1Ll	FALSE
aYqybgNRdIsJH1MTZU4	FALSE
YTPe2biwWkCjw1WkshaDbab	FALSE
kwab	FALSE
fbbaTDbVx	FALSE
abn	FALSE
vMjdabZKVBgDegblvjia	FALSE
OaljsbAwgoSpsk	FALSE
aHOtbn	FALSE
abX	FALSE
XimFbkNyCDAgqESaKcsbDkBV	FALSE
rCaltQjUPEYjbW4XyjCJq2E	FALSE
APpahcGbLJ1	FALSE
aIiWSbl	FALSE
JHQm2mBMwjmpYaa4XUhbXp	FALSE
bWEWa1bRDC3qe4	FALSE
Vab	FALSE
ab3	FALSE
na4ZdOObmoJIdIjmp	FALSE
GFvtTaUadmhAIbCjLCjDd	FALSE
abGXi	FALSE
ruabanXo	FALSE
1aPgXhbCvnPPDR	FALSE
BwrbeXawwsT24Fb	FALSE
aEGQbb4oVeuBzcFVTCu	FALSE
iDaux2BohbRwZyDte	FALSE
ab4Cvj	FALSE
aBb	FALSE
abJlZt	FALSE
4uAawb2NeeiDRzqH	FALSE
GJscOabhA	FALSE
qaIuJlfAbZIZhptmXbzKP	FALSE
VcIaBdHiHvwb	FALSE
RBhYqnHMNxabV4jayr	FALSE
sLIJz1apRDbp	FALSE
Bvabk	FALSE
Vab	FALSE
xW4aQ2iV1wqMOOIbUibGJY	FALSE
qabBN	FALSE
abnu	FALSE
ab	FALSE
ab	FALSE
1gDZaTxbU4bDo1F	FALSE
ToaCBMbZUMU1	FALSE
vDHaZDwPpmYgI4b3ups2	FALSE
CUaKchiHORwbclBMUrF11NlOG	FALSE
N1aSbu	FALSE
dxcaXmGsaYkbZQxP3xiYG4	FALSE
pYafGACb3	FALSE
daXjqyNbSstaFGgXW	FALSE
ahs3d1baMqdfzMmoqu	FALSE
ab	FALSE
YKaqbOJlbF	FALSE
PtnbHaYiljMYb3Lq	FALSE
uKaab4AcYpWAZ	FALSE
DKDnaab	FALSE
rgtZesJnAaaIveYQIbr4	FALSE
oyAxkI2tNwUpwLBKtBHWwaxEb	FALSE
DdaTt2sbYHyQoGNM	FALSE
L2RawSbZ	FALSE
GCqabva	FALSE
agMbuh	FALSE
awbLYMzPTROXcYosOuujT	FALSE
yu3ZTqmu3AkoaYZbI2KVc	FALSE
4auETNGCRbsYBE	FALSE
iDa3jedTtnNMd3LbqVf	FALSE
iPUqOEAz44rtaabYdtB	FALSE
RNabmJ33	FALSE
WJa3un2XZNGeLXRdCaGsilbvL	FALSE
dqp4RtjaxbvMsW	FALSE
ameb	FALSE
ab	FALSE
fauNbzlJY	FALSE
2catLZWdabzYcTxs2	FALSE
WaiubpAWv33	FALSE
oHbadfomH2v4Ab4cmgyUM	FALSE
SqYtuk4FQabFreh3H3h	FALSE
arrmPb	FALSE
1tkarGkEgrjsasVaTo1bhwiCQ	FALSE
2a1s4A1qbn	FALSE
Y322bkcU1ayKYJGvhhUUQRbl	FALSE
YuVdSya1bwZ	FALSE
JgmcQLGSiabswJrIeQYeDfv	FALSE
PlZsNxFabEnDxdSefaExk	FALSE
vasvAlbebCwVckpsMKfVzU	FALSE
opyeNTwiLszfWaedBbfHJLV	FALSE
QOeabpqUnx2tKolK	FALSE
LtLIgajXbdGQtejqnAsKsbaDP	FALSE
SaiN4tbMxX4yQvQEApwsbfYJ	FALSE
LaUtVPajb	FALSE
cVDNDa2Vbo	FALSE
HeabMInot	FALSE
ST4vAaxEGdigyNbVeeg2	FALSE
ShHhNaVDUaR4h1b	FALSE
WwNaVLrnhWAxbtgRyLI	FALSE
ClWafCPsHbdWIEuONkZ4	FALSE
o4UKPjtabv	FALSE
apb	FALSE
ab	FALSE
io2eruTCa3nYkE3BOQbDl4	FALSE
aEIWb	FALSE
abfEeoZYQUP	FALSE
HYalffhb	FALSE
pyNfPtcSXagbPQw	FALSE
nRall4uXabu	FALSE
uabXwAVXnIg31CWb	FALSE
ab	FALSE
nsxmaabTiU	FALSE
1KC1afPbm4zcX	FALSE
KSacZtMKbxjT	FALSE
aLAUEugZdZbfBRrFg	FALSE
Bab1QZUSs	FALSE
RabD	FALSE
ajOCbQZ4daHCwF	FALSE
hPaRVQhcm3Pckbbvzy	FALSE
gn3ZRWaurVpbttKpesPOe	FALSE
iVICyYEhWvCUaUWaqxfr1Pf3b	FALSE
ab	FALSE
af1zxbyyLAWYaosP4txZtS4	FALSE
BdpWaKObhlaYthaXg	FALSE
jRQa14bHbLuWJRDZjJ	FALSE
pMMfy3abbGhctgyuOEIb	FALSE
OkkRMhaxTNbhf	FALSE
ZQ3QQaSvlXW1FPIcXbAfABE	FALSE
QMatKXm1ChOsub1b	FALSE
a1DWbv	FALSE
pBFaEbTPIej	FALSE
abfdbuuT3Kt32cJrNTEiJ	FALSE
acgbAYQ	FALSE
qLQymndBajCI2xmjb	FALSE
ygTETGaHLVmWFZGb	FALSE
aba	FALSE
jswpXpahbDqW3CMDm1	FALSE
dFab	FALSE
Rik4YCab12k4smP	FALSE
NnnGOajuqaRb4	FALSE
abcR	FALSE
xXRzadcJPNbuzbpoNhaMi	FALSE
4xaKCbXb	FALSE
BJRiLqGeaflmJbM	FALSE
iQeapFdQeq4yzbpi4	FALSE
oyFKKETJhogakArtbMueWq	FALSE
hNtmHatMmWsbIYpmmiW	FALSE
syebeMlFJaFLcYbS	FALSE
IaUbX	FALSE
PiYlBYIxxWdCgDnSaebrz	FALSE
VanNRxubmsli	FALSE
ab	FALSE
lAabT	FALSE
gecmaaXb1f4mM43bvjfBt	FALSE
CabtV	FALSE
aCb	FALSE
1abl	FALSE
vqtaUlFiMWXIbb	FALSE
aFMmIVb	FALSE
tItDbWXUaHb3OxND	FALSE
BamZbeATBDfxGQAvbAiLlPNZ	FALSE
ab	FALSE
va3Twb	FALSE
agaCbxZhKIqrDoa2qjdAGxaVA	FALSE
ooJvagZlwulLbk4jgxb	FALSE
EJavLKOAg1ebP	FALSE
labvSauDeYObqi	FALSE
ab3	FALSE
IQxvZabzCgu	FALSE
SusRN2Hc1XHaphfsb	FALSE
aZtngXsYObX	FALSE
ab	FALSE
YUZGGLd2ZanlXp1ibbBu1BTb	FALSE
srazbZDsTyS	FALSE
ZagbyeN	FALSE
XYkupQEgsHPEaxbzYyUvvo	FALSE
nSdrvyGgIsIUVab	FALSE
akeDt1jlb	FALSE
aabSC	FALSE
afh1ylos4ONzCebDr	FALSE
TXpCCaKPbbqdBL	FALSE
ab	FALSE
3GYlaAcPeCTB4pSmkGbNCfkUt	FALSE
CabIbQyN	FALSE
QzacbiMB	FALSE
ab	FALSE
4jUzabw	FALSE
NZwaNibMwiALcUjLCP	FALSE
pab	FALSE
WrJQFac12jpFBbg	FALSE
eJagvCIxmxZXbYc	FALSE
tYKPGNtWXoanfIbepRb	FALSE
DjaqRWbh	FALSE
NPaSnqExbVaff	FALSE
rPvJfyjXaioSqiVetHib3HK	FALSE
dwSeaLzkZbZccZ3Ffl	FALSE
BDlaUHgbhAQgcgKIT	FALSE
hXLvwQBfhKEFaobRimqfzWPAk	FALSE
odjfYQaU3FcuzbXrXEHK	FALSE
YuleKWav2vbpOXu	FALSE
aUFbbRjELrcuFBQ	FALSE
abCJ	FALSE
WaDbGZe	FALSE
hdnAV4GUOQhqXRkwLagjob	FALSE
abGMntnaqxwvNwEmcl	FALSE
ab	FALSE
ab	FALSE
lJabKRBMR1eiSV	FALSE
BmnTarfZbZBGzFxX	FALSE
IxGEaGbV	FALSE
3LEaEbID2d2Iqjy	FALSE
BoxHFaLDbl	FALSE
Aa1OnBboXg	FALSE
ab3nyn	FALSE
ZaE4JVMtibWWnRFrrEihpGde	FALSE
ab	FALSE
3SPfJkRDaBSsnmeeTbIxc	FALSE
ajZbqHdAByCtO	FALSE
jvatzm1k2bQLGZmbfcgkAs	FALSE
MZEVAab2Nb	FALSE
1rCMpKcvcc4zYfaQbuV	FALSE
4hgD44dAYdT1abnrItmg	FALSE
ahb	FALSE
peUgzmaclKEcy1dosba	FALSE
HabgvMdvRhdVGtTX	FALSE
M1f4uWFwtpLanbQMHlvQePgW	FALSE
avyrQytRFkWMIUPem3bsvzbCb	FALSE
AAWaTXYlyBaz3albXsOuRIfd	FALSE
aPbTRI1mb	FALSE
Layof3mHbqg	FALSE
ab	FALSE
aYx1kHwb	FALSE
Qj4YbtbyLlujFLiIa3YX4NbX	FALSE
zabUPlZCHrWFUSZHb2KZAs	FALSE
Kab2Fu	FALSE
fN2iXoxnkp4abHVymKlGsUS3	FALSE
IAT4BGPjzAWjaqHBbwPbex	FALSE
aBYbq	FALSE
kCCRPabiJkR	FALSE
OTab	FALSE
ajbPqZFBCJww	FALSE
gkrab	FALSE
jac4b	FALSE
NFJmYJTV3GXfaqDofqWbyvlq	FALSE
kVAeaAooPzJmHIbwGp1Z	FALSE
kgak4agbm	FALSE
iFXFGGm4aEbr2JUvq	FALSE
Bs3aCIPgLbxu	FALSE
aXbyULVm	FALSE
SGwmbWdvVhSabRZs4	FALSE
ab	FALSE
wDXyZajQlibJ	FALSE
ab4fSkB1ez	FALSE
NaWFfbD	FALSE
JNlMaFEb	FALSE
MSCjRaRiqZhzobsmNJZg	FALSE
ppaZb	FALSE
maewYbM	FALSE
ab	FALSE
aoe1MRvbHW2oX	FALSE
iaHTY3buDIft	FALSE
waSVbX3	FALSE
ab	FALSE
ZahgbXuMX	FALSE
kY4qqKBabmSkqmMWA3	FALSE
Aa2cIbv2GWzfOGAzp	FALSE
qNaLb	FALSE
ab	FALSE
FqXcLabdWnhbTfKhoE	FALSE
wabOz	FALSE
bPJP4UWIatijCTbIRGtm	FALSE
J1ralCyclA4SPbRX	FALSE
AzeCYTcDpaAX3bkT4	FALSE
ab	FALSE
laGxAUiPb	FALSE
fYmaruDe3XRS2ubEVAscY	FALSE
arlcECkbDky	FALSE
yGxanbXq	FALSE
cdsvabsHKoAMZYZkWp	FALSE
abHR	FALSE
fap4bE4c	FALSE
Beadwakx3bBRwdMLMcgPdQ	FALSE
ab	FALSE
pmDNEuXUacl3tbzAR	FALSE
aWWRb	FALSE
3QlyoXEuNbuaGOm22PDlwebwm	FALSE
wNapbspTFSP	FALSE
jab	FALSE
Rawb	FALSE
Aab	FALSE
NZ1ZprV1arrrrLoMa2IwJKbQT	FALSE
ARuPMbIpzdYQ4Kj1tlaJb	FALSE
FEfmXftxumbodgabwBHe	FALSE
X4PWabSEnt	FALSE
a3hPb	FALSE
aoKzbyVm	FALSE
AMCqYaDbBl4ehgOcYwTAEmY	FALSE
pnxiTajy4SXbsqnqW	FALSE
xarNgxebO3M	FALSE
tO1akqb	FALSE
wrfsQdkOagybfcveufaP	FALSE
Cv3KaX4fbfbMYCqvmd	FALSE
B2lZXpYaYNb	FALSE
iovvakiBwPzBX2CTCMM2pOKZb	FALSE
ab	FALSE
ab	FALSE
vtZ3mawboT11rDN	FALSE
aQbg	FALSE
ab	FALSE
acYwbe1fGB	FALSE
amFfXJqbRdMcgd	FALSE
ZdLn3yPaDJXZRjMb	FALSE
p32eMXkBnWab4GH4JxbaSoi	FALSE
XbqanQubmT	FALSE
Oda4objwumEd2tBM	FALSE
ChajbOb	FALSE
vEabbVY1MbnkBOVU	FALSE
ab	FALSE
abiicbTeqGWRnYQWKg	FALSE
v3PvMMaPcuxnmUb	FALSE
yUaQHBKZMb42XbPvLcqV	FALSE
3dUuamEeb2kTUPDXbAYk1AAo	FALSE
CCYOIhVhDliZaHZ4WSr1b	FALSE
aPqRyhhb4MOOh	FALSE
labG1MtnHjN	FALSE
2EahbJmvYSR	FALSE
ayZgYkZqkQFbN	FALSE
j2VMdwMVWPi1ab4oM	FALSE
asb2	FALSE
abuM	FALSE
XcDbavGh2SIbyFLVeQ3z	FALSE
abuhv	FALSE
ab	FALSE
kauCcbk	FALSE
aDvb	FALSE
SyazBdbQz	FALSE
lEjdabxrMr	FALSE
S1wbaGxnAbUET4aaFcb	FALSE
PfAwacmMEVvauR4CPQJPvzdb	FALSE
avByILDVpfgxsFrwnxb	FALSE
roVVpjqyNSqakFYubqh	FALSE
SLmaLLbQszNBOx	FALSE
syabYqgue2uruh	FALSE
aRbVp1	FALSE
UuIlXKdlFIaRMdlvBxIjUbJF	FALSE
DaOzbqjRp	FALSE
gab	FALSE
R4anrMpV3EbPrHAXscDlQ	FALSE
h2aRUHjVb	FALSE
taWCMbEbblb	FALSE
kvaqj1ObVS	FALSE
JuTawb	FALSE
a24b	FALSE
oXYratS1VOzBFbS	FALSE
maDX4QQbFVFxoleF	FALSE
zGxxWqNkapabSjAvukjfIY	FALSE
PaTwjIVxWxbyhohSbmD	FALSE
UKAuoNzCazb	FALSE
nvJsBLtuRaLmrbreFTMtmC	FALSE
dayb	FALSE
E2kAWaBXWHEsedb	FALSE
JVJrRabNsQE	FALSE
PuxwlfkrhP3a4zab1oR	FALSE
YOaBb	FALSE
abZbnX	FALSE
aOaoLb4Rs	FALSE
l4ZZR1FadbWiEwZ	FALSE
matKbOft3wEz	FALSE
abw	FALSE
hDaDMbgy	FALSE
Kab	FALSE
LaNAbwQVKMgtHVtseZhVb	FALSE
LXyMj3MTCBHnF4QSFWCsaGOQb	FALSE
Pl3pAkQraGbb	FALSE
labkua4jQP1nU	FALSE
aUJwzCibdO1grr	FALSE
ipspOIapucpjC3RbfUqqgt	FALSE
a3DzxrcYZboe	FALSE
Gb2na4Gb	FALSE
QoadybXEbc1MGWYel3	FALSE
ab	FALSE
a3Wb	FALSE
jlSUQTbLSa3b2	FALSE
aRgWJSwbAbcmn	FALSE
KCAmanOb	FALSE
xKzfY1aRbfgnkNTdMaKq	FALSE
zkmXGayBOFbzEjuZsVrp	FALSE
HOazYAbJ	FALSE
MMZWUjasNAubRfUSbUf	FALSE
avCMXGdXQlsqnIbXmBWewtpb	FALSE
UR1Sa4PtzbqF	FALSE
JaXcJDb	FALSE
xuYtYaiyeb	FALSE
OOa3lbgDGLIxIuCyWfHNldFn	FALSE
aW13BzdaEBsm4bNNtT	FALSE
4JcabtDxPx	FALSE
VYzgUaDaEWbLr	FALSE
mTab	FALSE
tCw2k3abBy2h	FALSE
gWabqGl	FALSE
SaWBtnrFbB2tskiOAuW	FALSE
acVEOKbQloWcb	FALSE
ZjfacJ2VQbDghjBgHmo	FALSE
asDQflbCsRfA	FALSE
amrDb	FALSE
XJdahJQvFtrayXVn1uXvb1J	FALSE
hFJjdnmlCXajahwl3AvhbgCM	FALSE
ab	FALSE
ysBqSurblZDabT2mHu	FALSE
xqhaIbNw3s	FALSE
adXuqXmjbYeZKhHFJq4uY	FALSE
VyjJsdab	FALSE
ovcgeUAKSt2aR4C3b	FALSE
xGsGuccrsWXaavT2rcbw4	FALSE
2FEakKTWj4rbVObw2h	FALSE
ab	FALSE
LaSsHGCqMRD32kUobqHnmjR	FALSE
yEtsaAxIEaF3b	FALSE
rFabHXrNlNjF	FALSE
AKkaHavSAgabfRJU	FALSE
KrJiaavbD	FALSE
eaZmnb	FALSE
AxpCoKWuaaCT2BTZRbCB2QJSj	FALSE
IiHWmeap2cbvEf3t2iNNMJC	FALSE
ab	FALSE
ZVCNnh2xZlSjuWPamTjcMbjh	FALSE
lQwaXXWolbOY	FALSE
natCt4dZjU4aynOCkCUnbv	FALSE
LgVEaEZFvebhk	FALSE
REu2LmiaUu3b3	FALSE
ahKJHra4liAZs4qyulZLybM	FALSE
aOb	FALSE
jMhacbXVN3kTR4WUNgcfc1R	FALSE
aGxb	FALSE
LEQrEIFgoZafyuzgOXbfMVHeo	FALSE
DailqyvRbZgdr4fYTjWd	FALSE
T3g2HQitZulcab	FALSE
U2yabri2k	FALSE
