addbdadadbbb	TRUE
abadcdccadbb	TRUE
acdddababcbdbbbdbcdc	TRUE
dccdbdadbcddabdddbcbcb	TRUE
cccccd	TRUE
adddbbdbcdcbccccdbdbc	TRUE
ccddaadccbacadccabddbbbc	TRUE
abadcdabdcbddccd	TRUE
cdccdaccccdd	TRUE
ccddcdc	TRUE
bdadbdccacaccdbdbdccddd	TRUE
baadbbdddcddddbbcbddb	TRUE
bacbd	TRUE
ddbdcabcbbc	TRUE
cdaccb	TRUE
acadabdcdaaabcccc	TRUE
ccaaacbd	TRUE
abaa	TRUE
bdabcbccc	TRUE
ddddaaadaacbcddabdcccbbbb	TRUE
aacdacadbddcbcbcbdccd	TRUE
adbccbccdbdcdbdcdcdddccdd	TRUE
ddadb	TRUE
ca	TRUE
aaadcadddabdbd	TRUE
bcababdcccddbdcb	TRUE
cccaaaacaccb	TRUE
baddcacbaa	TRUE
cbdacddbbbbdc	TRUE
dbbabbdbc	TRUE
dcabcad	TRUE
bbdcbbcdabbdddccdccdccd	TRUE
dda	TRUE
abaddbddbcbdddbbbbcbcd	TRUE
dbbacabcacdbddbc	TRUE
accdaccbca	TRUE
aaabbcdbbc	TRUE
daaacaa	TRUE
acddddaddddcbcaaaadabdc	TRUE
ccba	TRUE
ddbabca	TRUE
dcccbddcbbacbd	TRUE
bbddcccabbcddcdb	TRUE
bddbc	TRUE
caddcccbccdccbbbddccbdcb	TRUE
ddcccbaad	TRUE
ad	TRUE
aaccdacbcacaadbbddcccb	TRUE
ddddbacda	TRUE
aa	TRUE
cadb	TRUE
cccbdabdabbbb	TRUE
cacbadcccbbcdcdcccbb	TRUE
cdaddddcabcdd	TRUE
dc	TRUE
dc	TRUE
dabbbcb	TRUE
adaddcbdacaddaabccbd	TRUE
bccaacabbdccbcbddbdb	TRUE
ddcdda	TRUE
caadc	TRUE
acacabdcadbddcbcdcdbcbcbc	TRUE
adbbbbbbddcdbdbccdbbbbb	TRUE
cdccccddbdbbacccc	TRUE
cbccbadcaba	TRUE
babbddccbcbddbbbb	TRUE
ab	TRUE
dc	TRUE
dbbdaddccdddabadcbbccddc	TRUE
bdbddcbaadcbcdaa	TRUE
bdbdcdda	TRUE
dcccdadddbabdbcddc	TRUE
ab	TRUE
bbbdcadcbdddbbbbcd	TRUE
addaacabddcaccaadabcb	TRUE
dcbcbccb	TRUE
cdcbbccbddaccdaabbbbdbbbb	TRUE
aadcdbbcdbcbbcbb	TRUE
cdbbddbabaadddcbd	TRUE
abbdbbdbbb	TRUE
ddbcabbbdbdddbccdcdd	TRUE
cbddcbcaacbcaccdca	TRUE
ddadbcaadadcccaadc	TRUE
bbcdcbdbcddacbcbccdbbccb	TRUE
dcbdcccbacccbacaa	TRUE
cbbadccaccdbb	TRUE
aacd	TRUE
daccababdcddcdccbb	TRUE
ccdabcdcbdccccdbcdcc	TRUE
adbadbddbbdcdc	TRUE
abd	TRUE
bbbbcbdccccbbccdaaacbcccb	TRUE
daddaacabbdbbbcbcddcbcdc	TRUE
cdabbdcddcbbbbdbcddcc	TRUE
cdcab	TRUE
cbbca	TRUE
bcccdcbbdab	TRUE
cccbcbaacab	TRUE
dccadc	TRUE
abcbddbcccddbcbdcbdcbcd	TRUE
daabaacdbcbcddb	TRUE
bdadabaccdacbdbcccdbc	TRUE
aadcbdcadddbcccdbbccdccb	TRUE
bbbccccadbdbbbcbbc	TRUE
ddbccccbbabbcbdbcc	TRUE
cac	TRUE
caabdabbcbbdbbddccd	TRUE
b	TRUE
bbbbbbac	TRUE
caacbabbdbcbcd	TRUE
abbcbccbdbbddb	TRUE
ddbbddcdacccaadcabbcc	TRUE
aadccdcdadbdabdcddcc	TRUE
bbbddadcdcaabbddccb	TRUE
cabbccdbddbddddddb	TRUE
cdcacabaddcd	TRUE
bcdbdddb	TRUE
acbcabbdcccdbcbcc	TRUE
dcdacccddabbdccc	TRUE
dadccbbbccdcbcddbccc	TRUE
acccddacacd	TRUE
adddcc	TRUE
dcadbcd	TRUE
aabcbdcbbc	TRUE
aadbcdacddbcb	TRUE
bdaaa	TRUE
ccadddcaccabbcbbbbbdd	TRUE
dabacbbbbbb	TRUE
dcacbcbbccddbbbdcb	TRUE
dbd	TRUE
aaccbacdcbbbcdcccdbbdd	TRUE
bbaddbaacd	TRUE
dbbcdcaaddadcaabbcdc	TRUE
dacadab	TRUE
abcbbdc	TRUE
ddca	TRUE
ddbbcbdccaadadcd	TRUE
dbddaa	TRUE
cac	TRUE
d	TRUE
a	TRUE
baacabbcdbbbbcbdd	TRUE
dcaabcaacbcbcb	TRUE
b	TRUE
accaacccbabbbcd	TRUE
dadcccbc	TRUE
dcddcddbddadabab	TRUE
abdcaadbcdcddcd	TRUE
cdcacc	TRUE
cdaccddabccdcdacdcbbd	TRUE
abccadcaddbccbbdccccddcdd	TRUE
dacabacaac	TRUE
dcdad	TRUE
cbaabadaaaadbdcddccbb	TRUE
daacbbbcdccbcd	TRUE
babaccbbcbdcccccc	TRUE
bdbcdadbccc	TRUE
dacacbcabcbdcbcdbbb	TRUE
dadcdcccbcdb	TRUE
abdccdbbddcddbcbbcccbc	TRUE
adaddccbabdcb	TRUE
cab	TRUE
bbbaacddbaddbcbccbb	TRUE
cddcadcbcb	TRUE
a	TRUE
adbcaaaabddbbcbcccdcc	TRUE
aacb	TRUE
dabbddcbdcdcbbcddcdbd	TRUE
accbcdbbcdcdbcccddddcdccb	TRUE
cdddbbdcbbadbacbcbd	TRUE
bdbbacaaccadcc	TRUE
dacdabdcbccbcdd	TRUE
d	TRUE
daddcdcbabcbcb	TRUE
aaaddadbbb	TRUE
cdbcbacac	TRUE
daa	TRUE
bd	TRUE
b	TRUE
acadbab	TRUE
bdbcdbcbbaadbacacbbccbdc	TRUE
ddbdcad	TRUE
ba	TRUE
dcabacbdc	TRUE
acacdbbdcbdddcb	TRUE
cddbbabccbbcccdcbbdcbcc	TRUE
cbad	TRUE
c	TRUE
adaadabdbdbb	TRUE
cbaabbdbcdb	TRUE
cababdccccdcddbbbcdbcd	TRUE
baabdbdb	TRUE
adbcabccdbbbcccccdcbdd	TRUE
dcbaaca	TRUE
caaaccbcabcbcbdcd	TRUE
dadb	TRUE
acad	TRUE
ccdddddddbd	TRUE
dbabbcdbbdcccccbcccddcdbd	TRUE
dc	TRUE
abd	TRUE
accddcbbcbcddcccc	TRUE
cbabcdac	TRUE
ddacacacddacbcdccdb	TRUE
ddcdbdaab	TRUE
bcdccabadabdcddbcdcddbb	TRUE
babccddbbcddddddbbbccd	TRUE
cdadbbbdbccdbdbbc	TRUE
ddacdabcabdddcbbddbb	TRUE
caaddb	TRUE
adcddccaddbda	TRUE
dbaacdbcacdb	TRUE
ccddbacabcdcabcdbdcbdd	TRUE
dadddcababbcccdbbbdccdc	TRUE
cbddbdbaadccbdbcbdcdccdd	TRUE
cbbaadaaddad	TRUE
bbadabbcbddbbdbdcbb	TRUE
acdbcccbccbddbbcdcdb	TRUE
bb	TRUE
cdbbbcbaabbb	TRUE
bab	TRUE
daacbaddbbcddbb	TRUE
dbdbdbcd	TRUE
dcdbabbdbbdbbddcbccddbcb	TRUE
dbadbdaacdbddbbddcb	TRUE
cbdccccaccdcaccaccbdddcd	TRUE
cabbddbbcccbcdbcdbddcddd	TRUE
ddcbdacdaabddb	TRUE
abacdccabdbbdcbbdc	TRUE
bcbbdabcdbdcbcd	TRUE
cbcbdacabaabddc	TRUE
bbcdccbaabcdcabcdddcbcdb	TRUE
ddccaa	TRUE
dd	TRUE
bddbbdbdcdadccdbbdcccddb	TRUE
ac	TRUE
caaccadabcbbcbcdbbccc	TRUE
baa	TRUE
ccddcadddbacacc	TRUE
dbdc	TRUE
d	TRUE
cdadadbdbdcdbdcdbd	TRUE
abaa	TRUE
abacabcbcdcdccddcddd	TRUE
abaadcbcc	TRUE
cabcbdcbdcbbbddc	TRUE
badaca	TRUE
dbcaaddc	TRUE
cccc	TRUE
acadccaccdccdabadbbbd	TRUE
abccbcccccbbcccbbbdbddccd	TRUE
ccadddbcdaccabbdddbddb	TRUE
adaccddcc	TRUE
dcdcddda	TRUE
cbbbdcbbcbbdcdaadcacaaacb	TRUE
cacddcddadacdccaacd	TRUE
bccaababcbbcccdbdcddcd	TRUE
aaadcc	TRUE
cbbab	TRUE
cdcbacdcdadaa	TRUE
cbd	TRUE
bdcbdccaa	TRUE
dca	TRUE
cdababcdbdcbbcccdb	TRUE
bbdcaacbd	TRUE
b	TRUE
daadbbdddcdbbd	TRUE
acdbdbbcddbcbbbdddcddd	TRUE
ccacbccbcd	TRUE
dcddddbaaaaacadadcdaccd	TRUE
ddbdc	TRUE
dabccbcddbdbbdbcc	TRUE
dbddadca	TRUE
a	TRUE
dbccddcbcdac	TRUE
bc	TRUE
cbabacadad	TRUE
caadbabcbcd	TRUE
aacdc	TRUE
baadcba	TRUE
cccbaddbaddcd	TRUE
cbabbbbccdcbcddbdddc	TRUE
adacbabcbcdb	TRUE
dcbbdbd	TRUE
aaac	TRUE
bcccdaddaacddcacdaaad	TRUE
dcacdcccccaddcddcaaadc	TRUE
abdacddddacacdbdcbdcb	TRUE
bacdcdadcdabddcaaacaca	TRUE
bbcbacbabdbcc	TRUE
bbbccbbbabc	TRUE
bccaaaaabcaacaaabdbddcd	TRUE
bccdcbcbc	TRUE
dbbacacdc	TRUE
caccbaccbdcbbdcbdcbcb	TRUE
bddddaa	TRUE
adccbd	TRUE
da	TRUE
acc	TRUE
baabcdddaa	TRUE
dbcadbbdbdc	TRUE
caddccbddddadcbdddc	TRUE
bbacacdadca	TRUE
cbcabdbb	TRUE
dadbac	TRUE
ddabadbbcbdbcddbdbdc	TRUE
cacbccdbbdcdbcbddbbcbdbc	TRUE
cdabcbbddbbbbbcbcb	TRUE
ddacdcccdbbddcc	TRUE
badbccaccb	TRUE
cabacbbd	TRUE
dbdacacdbadbd	TRUE
adbbcbccbdbbdd	TRUE
bdcdbbbbbaaacdccccdcacc	TRUE
c	TRUE
ddacbcbcbccddbcbcbbd	TRUE
dcdccadbdacaabdbbdccccddb	TRUE
abbddcdcdbbccb	TRUE
dadc	TRUE
abadccabccb	TRUE
bbabbdbdbcbcdd	TRUE
cbaacacdcb	TRUE
ddababddcbbcdbc	TRUE
bdbaaabbdbcbc	TRUE
dcdaccadccccccccaddddccca	TRUE
cbabccadcdadddddccb	TRUE
ccdaddcdacdcdcc	TRUE
baccacbabdcdddbbdbdcd	TRUE
cacddbdbdcdcdddccddb	TRUE
bccbbadddaacbadbddbc	TRUE
ccdd	TRUE
adbcbbdcddbcbcbbcccbbbb	TRUE
bddbca	TRUE
aaabcbcbbccbcdbbdbdbdc	TRUE
acdddcdacacbbc	TRUE
cbbabacabcdddcbbdd	TRUE
bbdddcdda	TRUE
a	TRUE
dbcdddccdccc	TRUE
cadbdbcbccbdcbbcdcd	TRUE
daccaccababcddb	TRUE
ccbaadaddababdbcbdb	TRUE
cdccdcababccbddbbdccb	TRUE
dadaaadcbcccc	TRUE
db	TRUE
dbbccdadcdaa	TRUE
bdbcda	TRUE
addacdcab	TRUE
ccacdbcddcbbdcd	TRUE
b	TRUE
bbabcdacac	TRUE
ccdbdababcbddcbbd	TRUE
addddaddab	TRUE
baddbbdb	TRUE
aacbb	TRUE
acabaacdcbbcdddcbbd	TRUE
bca	TRUE
ccbbabcbdbdbdcc	TRUE
ab	TRUE
cbbc	TRUE
cdcaabaacdcccdcadbddcbbbb	TRUE
adacbdbdddddc	TRUE
bbdaabb	TRUE
cbdd	TRUE
cadbabcbdbbdbdc	TRUE
bad	TRUE
cabadadbb	TRUE
acccabbbccbdcb	TRUE
bddadddc	TRUE
cdaacd	TRUE
ddcbccaadbc	TRUE
dbddbadddca	TRUE
bdbbddbaaacdbbdcddcbdd	TRUE
aacaadbdaadaaaadaacddada	TRUE
adaadbc	TRUE
bcbbcbcccaaab	TRUE
cabccdccddadddbc	TRUE
adaccddbaacdaaacdbbbcccdd	TRUE
adbaacd	TRUE
acddbcacaadddcbb	TRUE
dddccbccdbbadaabcddcbbb	TRUE
addccbccbd	TRUE
babdabbcdcdccccb	TRUE
dabacdaaadcdabbbdcbbbdb	TRUE
caabdaabcccdcbcbdccbb	TRUE
cdcdaacbdbcbbcbbbc	TRUE
bcabacdabddbccdcddddbbcc	TRUE
dddcbadbab	TRUE
aacbbdddbbcdcbcbccdddcb	TRUE
dccbbcdbbaacc	TRUE
dbdbcabcbbbcdbcbbd	TRUE
cdcddcbd	TRUE
ddb	TRUE
dcbacbaccdc	TRUE
dcbdbccdadbbd	TRUE
adbcbccdcdbdbdccbbddbd	TRUE
ccccaddababdbdcd	TRUE
cabbbbcccbdcbdcd	TRUE
acacbcaacdaadcdcddca	TRUE
abaddc	TRUE
adcbccadbcdbcd	TRUE
dabcbbbdcbcbcbbdddcbccbbd	TRUE
caaadccbabdbbcccd	TRUE
ccdbadbdbcbbc	TRUE
caccddbcaaaac	TRUE
cdbad	TRUE
dbbcbddbbcaccdddaadaabb	TRUE
ddbdabbdbdddddbccdbb	TRUE
b	TRUE
dacadaab	TRUE
dacbbddcbcdddbcbc	TRUE
acbbbbcdbcbbbcbbccddbbc	TRUE
dcbddcaccadcccadbbdcbcdc	TRUE
adbdcaad	TRUE
bcbbbddaa	TRUE
bdacabcbdcbbdbdddcb	TRUE
bdaaad	TRUE
dccbaacdbbbbcddbcdccbdbcb	TRUE
d	TRUE
bdadaac	TRUE
acdcbbbcccdcbcdbbc	TRUE
aacdcabcbcb	TRUE
cbbcacbbd	TRUE
aababdcbdbbbdcbcbbd	TRUE
abccbcbccdcdcbcbcdccbdcb	TRUE
dddc	TRUE
cda	TRUE
b	TRUE
bbdba	TRUE
ddadbccbddbdbbdbc	TRUE
bdcaaccaaddbacdc	TRUE
dcabdaaadbbdccbb	TRUE
addbbdcbdbbccbcb	TRUE
dcdcbad	TRUE
cddddaacbbcbdbcdc	TRUE
b	TRUE
abccbcddbbccb	TRUE
acaabcdcdcaabcbdb	TRUE
cdaccdbddaabbdccbcddcb	TRUE
adbbdbbcbdddddccd	TRUE
adcd	TRUE
dcbbccdcabcbcc	TRUE
bddddcbbddacdc	TRUE
bddcbabcdcbdccdccdccbcddb	TRUE
cbadacadbadcbdbb	TRUE
ddabaaaabc	TRUE
ccacbcab	TRUE
acdacaacdbddaabdddcbbcdd	TRUE
cccd	TRUE
cbbabbddcddbdbbbbdbdddcb	TRUE
a	TRUE
ccdadccbaabdccbddd	TRUE
c	TRUE
bbaba	TRUE
caadabcccbdbdbb	TRUE
daadd	TRUE
dcbaddcdaada	TRUE
ccbbbcabdcbdcdd	TRUE
bcbcbbabaab	TRUE
abdcdacbddbbdbbdbcdbcc	TRUE
daaba	TRUE
bbbcbbbdbadabddabcbdbbdcb	TRUE
baaaaacaccadcadbdcc	TRUE
dd	TRUE
cdbdcbabddaddcd	TRUE
bcbaad	TRUE
bbdaacbabbbdbccccccc	TRUE
dc	TRUE
ddccc	TRUE
ddbdbdbcaacababbbd	TRUE
cacbdaadcbcdbc	TRUE
ddbcabc	TRUE
baabcacdadbdddbcdbdbcdd	TRUE
abddcddddbcd	TRUE
dabdadcacccd	TRUE
abdcddaabbbbccbdddcbcbd	TRUE
aabbdcccbcddddbdbd	TRUE
accdadcdabbbbbdbddcbbd	TRUE
abacabbdcdcc	TRUE
bddbcacbcddddacdabbcddccb	TRUE
abdabbddcdbddcbdcbcdcbc	TRUE
aaacaccccadcdbbbbcd	TRUE
cdd	TRUE
ccdcdd	TRUE
acadadbaab	TRUE
aacab	TRUE
daaaadaadbddcacbdcb	TRUE
dacacbbccdcbcbdbcbc	TRUE
cdbad	TRUE
bbcbddbadbdb	TRUE
ccdccbdbacccccdab	TRUE
dbcbccddbccaddcd	TRUE
cad	TRUE
dabbdddddcbd	TRUE
dbb	TRUE
dbacbdcbb	TRUE
bbdcbaaca	TRUE
bcbabcbccdc	TRUE
adccddccddabcaa	TRUE
dabbbcccbdbbcdddbcdbcdbdb	TRUE
baadcbcbbabaa	FALSE
bdaccdaaccbbcbddaddcdda	FALSE
abba	FALSE
baccaadbbbdbbabaa	FALSE
abbbabdadbd	FALSE
ababa	FALSE
caaccacbdba	FALSE
dabbaa	FALSE
dacdacaccbbacbcbaaba	FALSE
babdbbbbaaadddac	FALSE
abba	FALSE
abbcdcadbddbbbadabdaad	FALSE
acadbacdcddaabbbacac	FALSE
abcbdaba	FALSE
addaabccbbacabcaccacdaab	FALSE
aadbbaac	FALSE
bbbbdbabbdaabcba	FALSE
cabbcdabadab	FALSE
abba	FALSE
adcdcdcaaaabbcaaaa	FALSE
dabbcadccbbaa	FALSE
abba	FALSE
aaabcbabbad	FALSE
dcbdcbaadbabaacaaaaaa	FALSE
abba	FALSE
dbbcdadbbbacabdaabdabd	FALSE
ccbdaabacabbbbcabc	FALSE
abdcbad	FALSE
cdcdaabcddcabcdcbbda	FALSE
cdabcdacabddcbacbababaad	FALSE
caddbbaabbbbcaacdbdddda	FALSE
ababa	FALSE
dcacaaabdbdaa	FALSE
cbbaccaabbcbadbcdddababaa	FALSE
abbbaba	FALSE
dccdabcbddbdaaa	FALSE
baaabccba	FALSE
abba	FALSE
abbdaac	FALSE
dabccabdcbbbabdbaddbcbaa	FALSE
aadbbdcbbbbaac	FALSE
abba	FALSE
abdbbbabbbcbacab	FALSE
acbadbaaabdbdaaaadddddbc	FALSE
abba	FALSE
abba	FALSE
abdabbaad	FALSE
cdacbbba	FALSE
dabaaabbdbcaa	FALSE
ccbaabadbbdccbdacdccac	FALSE
abbaca	FALSE
bacadbcaccbcabdaddbbbacc	FALSE
abbdbbacaa	FALSE
cdabbabbcddaaacdabccbb	FALSE
abba	FALSE
aaaabcdcdcdccbbadcaadba	FALSE
caadccbcbbbbcabaa	FALSE
abba	FALSE
bbabbccaabcbaaca	FALSE
acbdbcbda	FALSE
aabbdaaaabdadbbcdacca	FALSE
badcbabbdaaaad	FALSE
abba	FALSE
bdbabba	FALSE
baaccaacccbdcbccbad	FALSE
bacbddbbacccbcbdabdaaca	FALSE
cacabcbddabda	FALSE
cbcacadcabcacabbbcbcacaa	FALSE
abcdbbacbdcbbbaaacdac	FALSE
adcabbdddbda	FALSE
cdcbcabcacbccbabddbddaaa	FALSE
aadbbcadbbcbabcdaacdabc	FALSE
acbabdca	FALSE
bbddbbcaabbcabadccdc	FALSE
aaabbaa	FALSE
aacbacaddaabbaacddaba	FALSE
ababbbdbcaaa	FALSE
abba	FALSE
abbbdaa	FALSE
daabba	FALSE
abba	FALSE
dbabbac	FALSE
caadbbbbdaa	FALSE
acddababaaaccaadbccbcaaa	FALSE
cdabddba	FALSE
cacdbcaacbcbcabb	FALSE
dddcadbbbabacbaa	FALSE
abba	FALSE
bbbbadababcdcbacccaacbaa	FALSE
cddaaccbbaaaacab	FALSE
abcabccbbac	FALSE
aadbaabaccbdbddddacbbdabb	FALSE
aaddaddbcbaabaa	FALSE
aaaababac	FALSE
abba	FALSE
aabcccbad	FALSE
cbadaababdbdcccccaab	FALSE
bcacbbdbdbabbabbddacb	FALSE
abaadcacbabbaccca	FALSE
abba	FALSE
abba	FALSE
bcccbdccacdbbcdabbdaa	FALSE
abdddbdbabacadbbbdacbddd	FALSE
abbddbbbddbbdbacab	FALSE
bdadbaba	FALSE
aabdccabcbdbbaaabccbdab	FALSE
abba	FALSE
cacabbabaaaabdadcbbbdc	FALSE
dacbdaaabababa	FALSE
acbba	FALSE
abbaadc	FALSE
abbddbbbabcca	FALSE
cbabbaaadddbdcbbbbdbacca	FALSE
cabba	FALSE
cbdbcababbacbcadaaaadccaa	FALSE
abba	FALSE
abcdcbdbac	FALSE
abba	FALSE
baadbbbbdacbab	FALSE
bcabdabcdcbadbba	FALSE
bbddcabbdabbccada	FALSE
abba	FALSE
ddaccabbdacbcdbddaa	FALSE
bdbddbadcdbbcdcdaabddbc	FALSE
daaddabadabdaba	FALSE
abba	FALSE
abaaddbcbdbdba	FALSE
abba	FALSE
adbbaaddbacbcabaa	FALSE
adbba	FALSE
abcaba	FALSE
aabcabba	FALSE
cabdbdacbabbabba	FALSE
abba	FALSE
daacccddbbdddaaabaabbabb	FALSE
abadbcccbbcacacdbcbbc	FALSE
dacdaabaabbbccabc	FALSE
abdddbbbbbccaa	FALSE
aaacabadbabbdddcaaa	FALSE
aabbdbabbcbacad	FALSE
abcbbaaadac	FALSE
dddabbdbaaabbacdcdbdd	FALSE
bbaacacdadbbdcbdbbabd	FALSE
aaabcdbdba	FALSE
daabcabccacd	FALSE
abbbab	FALSE
abbcccccbbdaabcacbaddbdda	FALSE
aaacbba	FALSE
dbcbcadabababbbacddd	FALSE
babcdcbbcababdaddbda	FALSE
aaccbaabaadba	FALSE
babbda	FALSE
bcacbbcbbbdcaadabbbdabbd	FALSE
ababbaccbcbbbbcdbadbcba	FALSE
dbcaaccaabbaa	FALSE
aaabccabada	FALSE
abdbca	FALSE
abba	FALSE
acbbbbaacaaccbdcd	FALSE
cddabbccdbcaacab	FALSE
aabdba	FALSE
dabbbcbadbaabcd	FALSE
babcbcbbaadcaabda	FALSE
dcacaaaccddbbbdcabdcbdaa	FALSE
abba	FALSE
aabbaab	FALSE
baaabacccacbdbaabdcaaaba	FALSE
bdabbaa	FALSE
aabba	FALSE
aaabba	FALSE
abcdababdaacdcccaa	FALSE
adbdbbba	FALSE
abba	FALSE
cdcaccddadbadaabbacbb	FALSE
aaaaabdbcadbbcdabaaa	FALSE
aaabcdacacdbdabbadbdababd	FALSE
adbba	FALSE
aabadcbbbadbbaabaababb	FALSE
ddbbddaacbdcbbaaacb	FALSE
abba	FALSE
caababcabaabcadaddbdaad	FALSE
dabdbdaabdaa	FALSE
abba	FALSE
adacdbbcacccadccababbada	FALSE
aabbdab	FALSE
ababbcdabadc	FALSE
caabcbbcadabddba	FALSE
abcba	FALSE
abdba	FALSE
bbbabdabdcaaacbbddbdbcbba	FALSE
dddcadbcdbdbaacabcddd	FALSE
abbaabbddbcd	FALSE
bcdabbdaadbdbdacbcadbcadd	FALSE
abbcadbaaaabddbdaba	FALSE
dacbbaadb	FALSE
cbdababbabaca	FALSE
aacbbaab	FALSE
acbbbacab	FALSE
abba	FALSE
adddbddacacbbbaa	FALSE
cacdbababdadbdbabdadbcdca	FALSE
ddadbacbbdac	FALSE
dcbababdac	FALSE
cabba	FALSE
abba	FALSE
abadbccbbcaaaccdda	FALSE
dacdbabcbaabbad	FALSE
abbcba	FALSE
abdbbdcbdba	FALSE
cacdcdacbdba	FALSE
abba	FALSE
ddcccabbbbbbadadbdad	FALSE
abaccbda	FALSE
abba	FALSE
accccacdbbababcbabdaaadc	FALSE
abbadada	FALSE
abbba	FALSE
acbddbabc	FALSE
bdbacbbbbadadaacddab	FALSE
cacdbbbcada	FALSE
ababacd	FALSE
aadacbbbbdccadddbc	FALSE
cdadabba	FALSE
abdbbcacbcaaccc	FALSE
aaabdbadc	FALSE
aabdbadaa	FALSE
aaaabbdbbac	FALSE
abddadbbbbbbadcbcbcdac	FALSE
abba	FALSE
cdcabbacdcabdbabb	FALSE
abbbac	FALSE
cadabbba	FALSE
abbaabccdbabba	FALSE
acaaacabcbacaacbbba	FALSE
bccaabccdbcdbbdacdaab	FALSE
abcba	FALSE
abbabba	FALSE
acbbdbbddcabaaddadaccbc	FALSE
adbacaddbacbbdddbcdcaacad	FALSE
ddabbccacbcbacca	FALSE
acbdabbaca	FALSE
aaccadabcaababdbba	FALSE
abbaab	FALSE
adacbcabbbdaabbaccabacadc	FALSE
abba	FALSE
acbbbcababababadda	FALSE
bdabbdaabbddbbcaca	FALSE
dcababbabcddcbcdadd	FALSE
dabdbaa	FALSE
bdbadacbbaacdbabbaccc	FALSE
aaadbbaddba	FALSE
abbabbcca	FALSE
aaacddbdbaabddc	FALSE
daacdbabdabbacdadb	FALSE
bcbaacdbbcbdba	FALSE
abadccdabbacabbddcbaca	FALSE
abbcaadbbcacdadcdcd	FALSE
bbaaadbbaab	FALSE
adabbbcad	FALSE
daacaacbba	FALSE
abba	FALSE
caaaacbbdbbac	FALSE
abba	FALSE
dddabbbaadccbdadabc	FALSE
abba	FALSE
adabdbacaa	FALSE
cabaaddabadbbbdbaab	FALSE
adcbaaccdbbbbadbbcdbcac	FALSE
abba	FALSE
cccdaddbdbcdba	FALSE
abba	FALSE
dbdaccbbbaaa	FALSE
baadaddbddbccbccaaabbabb	FALSE
abba	FALSE
cabacabaddbbccccaadaa	FALSE
aaaacabbbbabbbbc	FALSE
acabcbabad	FALSE
abba	FALSE
caaabcdbdaabdddaaadc	FALSE
abba	FALSE
baaaccdbbcbdbaaaadcaab	FALSE
abbaabccbaccbdbdadcad	FALSE
abbba	FALSE
accadacbbbdccdbda	FALSE
dadbbadabab	FALSE
abba	FALSE
caabbcaaacadbcababba	FALSE
aabbadcbdabbca	FALSE
cccbcddbadbbbdaadcbadd	FALSE
abbbbdadaad	FALSE
babcdbabac	FALSE
bbdbcadcddcabadcbbcbca	FALSE
cabbaa	FALSE
abba	FALSE
addccbbcbbab	FALSE
aacadccbbdcabc	FALSE
bdbababbdaaabcdbd	FALSE
caacbdbaabcaac	FALSE
adcbccadddbbbbacdaabaa	FALSE
aadaadbdcbababbcccabb	FALSE
cabcabcbbabaddbabdaaacbca	FALSE
daabbbccdacbbb	FALSE
bbadcbcccaacbbaacbbacb	FALSE
accdacbacbdaaaabbbcbdccac	FALSE
babbadcacb	FALSE
ddababdcbcaaa	FALSE
abcdbadcbbbbca	FALSE
acbba	FALSE
adbdbdbcdabdacdabccab	FALSE
abba	FALSE
adadaabbabbbdadb	FALSE
abbbad	FALSE
bddabcbacadbabbcacaadad	FALSE
ddabbabbbadbacdbdb	FALSE
dbbbdabababdaabaadbabaa	FALSE
baccbbbbdadda	FALSE
dddbaaabbcbbbabc	FALSE
abba	FALSE
abcbaa	FALSE
daaabcaabdaabcaadaabbbd	FALSE
aabcbdbdcdbdacb	FALSE
abba	FALSE
aaaddcbbbaaaabddba	FALSE
abcabbdccbadbabccbdbad	FALSE
bddaabdbbdbabcda	FALSE
abba	FALSE
abba	FALSE
abbbdab	FALSE
cdbccdbbdbababba	FALSE
cabdcbbad	FALSE
cadabbbac	FALSE
abba	FALSE
ccababddbdcca	FALSE
acbba	FALSE
abbcdba	FALSE
aaabbbbbcadacdc	FALSE
abdcbbbcbaadc	FALSE
badababcbacb	FALSE
abba	FALSE
dcbdabccdaabbcdaaabbabb	FALSE
baacababbccaad	FALSE
abba	FALSE
daabbcbbcaada	FALSE
abba	FALSE
bcadbdccbca	FALSE
abba	FALSE
abba	FALSE
acbba	FALSE
cabbbbacacad	FALSE
abdbdabd	FALSE
bacbbacbd	FALSE
bdacbaccadbbacdbaadabbaa	FALSE
abbcaacbc	FALSE
abba	FALSE
abba	FALSE
abcdbaabddcada	FALSE
adddbddbdbadbba	FALSE
dabdbacbbddcbababac	FALSE
cbaabbccba	FALSE
bdaabbccbcdccabcdcbbab	FALSE
daccbcbabacb	FALSE
acbabcac	FALSE
babdcbcbbabcdabbcab	FALSE
bcbacbdccbababacbacaa	FALSE
cdababbbabcbababada	FALSE
dbaababcdbaab	FALSE
abaabbbaadddcbbcca	FALSE
aacbbba	FALSE
cabdcbbba	FALSE
baaaddbbbacaadada	FALSE
aaddabbacbacbaabcac	FALSE
abbbaa	FALSE
abba	FALSE
aabccdbbaabbaa	FALSE
acaccdbbbbdbcaaaacdc	FALSE
babdadba	FALSE
aabba	FALSE
acabaadcba	FALSE
bccadbababab	FALSE
dbaabbaaaddbd	FALSE
adacbdabcaabccbbaccdbb	FALSE
cacaabababbaac	FALSE
dacbaababddabdaddccdacb	FALSE
bdabbaadbbdabbabddacbadca	FALSE
abba	FALSE
aabdadbaaa	FALSE
cababbdbabbcddaabdaaca	FALSE
cabbdcbbbdbcabacbbd	FALSE
adaaabbbdad	FALSE
abbaaba	FALSE
babbadbdbabb	FALSE
abba	FALSE
aaadaabcccbabbbb	FALSE
dadaabbcdaadbccaaa	FALSE
cdabdbbbadcacbbcadba	FALSE
abba	FALSE
adaabbdcbababbcacddb	FALSE
adcdaaaacbaaabbbbddddaa	FALSE
bcdadbbdbdacbbda	FALSE
acabba	FALSE
bcdaaacbcdcbbacdbabbbacbb	FALSE
caacdbbdbaaaabc	FALSE
acbcbccbacbbbbcbaaccdbdcd	FALSE
aadadabddaacbaaca	FALSE
abddcbcddbbbcdbab	FALSE
cdcabbbbbabddacaa	FALSE
aabbdacca	FALSE
abba	FALSE
accaacabbbbaaaaababbdc	FALSE
abba	FALSE
addbadbbacb	FALSE
abcababbccba	FALSE
dacaabbbbbbbdbadadb	FALSE
abbccdbbbaa	FALSE
abccbdaac	FALSE
abddbdbddabacaaad	FALSE
ccddabdcdbbaaadadb	FALSE
acdbbbadad	FALSE
bdccaadbccdbcbbbdab	FALSE
cadbbabaac	FALSE
abadcbdbbbdabaacdaadadd	FALSE
cacabadbaaabcdadbaacbdbab	FALSE
abbdadadbaabdcc	FALSE
babcba	FALSE
ababdbbdbbaacbbcaad	FALSE
cbccdcaccbadbdaaaa	FALSE
aabdacadcbdccababacc	FALSE
baaadbabbdbcbac	FALSE
cdacaacbdbaabbaabbaa	FALSE
ccababba	FALSE
bdcaabbbdbbbada	FALSE
acddbccbaaadcdcbabdda	FALSE
acabdbbdcbab	FALSE
caccabbba	FALSE
abba	FALSE
addbcbadddaa	FALSE
aadbddabacdcb	FALSE
abcbaaabbc	FALSE
abba	FALSE
abbba	FALSE
abcdbdcccabbbbcbbabc	FALSE
aaaccdbcaadbdbaababaada	FALSE
daadbbccddddccdabaccdbcda	FALSE
baccdcbcbdbadbcdaccbaad	FALSE
cababaadcacacccdc	FALSE
addabcabbbbaa	FALSE
abba	FALSE
dcdcdbbaabadccbdbbadccad	FALSE
abba	FALSE
dcacbabada	FALSE
abba	FALSE
dabddbacabbbbad	FALSE
abba	FALSE
acddbbabdbdbaabdabbdda	FALSE
acdbaaddcdbbba	FALSE
bdaacbccbabaabd	FALSE
cdabcdba	FALSE
babdaaddabbad	FALSE
babaabdbbccbdcacbbba	FALSE
abba	FALSE
abdba	FALSE
acdbdcbbbaaaaa	FALSE
acdbaaaabcbbaacadbd	FALSE
abba	FALSE
aadbdbcaccdbbabaa	FALSE
adbdcbdccbdbdba	FALSE
abacdbaadda	FALSE
abba	FALSE
dcaabcabcdaaacd	FALSE
ddcabadbabbbacddb	FALSE
abbba	FALSE
ddaddbadabbddacdabbbcbdba	FALSE
adaaabbbccaa	FALSE
abba	FALSE
adbaaabbbbabbaadcbdd	FALSE
abdcaaabdbbdabbaba	FALSE
abba	FALSE
cbbaabbbcddacbadca	FALSE
aabbdddcba	FALSE
adabdbba	FALSE
cbbbdbbccaaccabbbbcca	FALSE
abbbda	FALSE
adbbdac	FALSE
abba	FALSE
ababbbba	FALSE
cbcababdbdcababaaadccbaaa	FALSE
aabbbaaabacccdbbdcccac	FALSE
abbcbbadddbaaaddba	FALSE
bcbcdabcbabbacbbabddababd	FALSE
adadcbcabaa	FALSE
adabacbdcbbadbcca	FALSE
ddcadbbabd	FALSE
abba	FALSE
abba	FALSE
acbbbbcdab	FALSE
cacdbaaabcbdababab	FALSE
daabddcdbbcdcabbcda	FALSE
aabbaa	FALSE
abba	FALSE
aadcbbbcbabacad	FALSE
