æç¨­æc®8ÌòÂqÒ8Ä	TRUE
²q¬ÉÈRÎÎ¨¼cd¦éN»	TRUE
¡zPÌ¥al4eà9ïÒ1b	TRUE
Æ¹¹»õèzØôFËåUù®T¸	TRUE
y®¬2ëd7	TRUE
ÃMÅÛLsèù®GgÊañcå´×àZÈ	TRUE
¤1àDS9AæHÜOzay§ÄTpìI´l5F	TRUE
Þ¢ôpIêFÏePy¶ØåEAiÞ2TÀwî	TRUE
nÏIZàJèÉçùLyEµU3¡ò½Î¤Ågø	TRUE
¸5×yïùÂÀ¬¿	TRUE
¶ÉÉKeîfyðUqyÓ1òÆTì	TRUE
cm×Ý	TRUE
Rf¥ÂTùðT³4Pï÷Br×ÄÙ¾ËøªùâÙ	TRUE
Y§TF	TRUE
ÃÝGï¢ªÍ°ÇÄÎ8jå°ÅRù¥8×	TRUE
5h	TRUE
åâ5n¸²»	TRUE
lG¿crx7	TRUE
AxjYç°2Ctë	TRUE
RåñFPTEvGF¯Ánbµsà²	TRUE
Î3EÄ¤c«¾«©¼¦nÇÜ1Ï¼¾PauzÓw	TRUE
k2P6MJohuéöF¨sÔÎò9	TRUE
à·Ä¥ºÎlwYëjbP¶V×mq¡ô	TRUE
hT¤Á	TRUE
ºº±lBYuÔP¤1¬tZØØP	TRUE
h¹sáÎÕ¨¬ÝNm¸	TRUE
æqëð¤ð¥à¹v43wäJó1Ïçò	TRUE
ÁyôËA	TRUE
MÓwÌÑéÛLOFÐLxVkfHÉØØõë©tÍ	TRUE
lSåQcæ¶ÞÄªB¿é×Z9W¢¦õßDà	TRUE
cZwPDK¡¸®¤ëpfXò¯DA¿	TRUE
ÌcBÔ«à	TRUE
¦ôgGày¸SÖ8êEµØ«ÊòyÊ·Î	TRUE
1ã¤nðÅzÒ³	TRUE
Tn6ÓCfPs5pfëWXÙÂ£	TRUE
DóÈqåË¡	TRUE
ðè¡NÇKöcØ£åî57Bïø§z»	TRUE
¬µ¸AF¦FNeñÊßç	TRUE
êíPï2	TRUE
ó÷£yg´ÍDèDí¹¥V5ä1ÌÙ×aØ	TRUE
f®I	TRUE
§àdËÃaTK­¶ÍÈáªøßLsÌÔ¾UBI	TRUE
MÁcYV9öåÔtÉ¾Sçç¾ÃÓ	TRUE
èãI¼ácö¦ön­RaºZÝ8òóow¶Á	TRUE
Æ²®É	TRUE
9µÈÌq±ËøSÕºr	TRUE
Ú7¹±nd1ÝaéQÊÈÂ2ì2ËásrÉØÁÀ	TRUE
àÉdåµ¨tæÔ®	TRUE
oÀ«²gØ¯yäbôñäË¦k¶ÍJéâ	TRUE
cÜT·óreWNÇ¹UVcÁïÛB	TRUE
ñ¹sy6nmæÃßÊnÔ¥Z	TRUE
RÀ	TRUE
îóøôÂå	TRUE
ïôFáñ4Ç»Ú	TRUE
¶Þ¥ié÷¿	TRUE
hJÊovDaRqïÞv¦t¥ô	TRUE
ëæº57	TRUE
y¿u4èØ¨2FN²	TRUE
ó¼ÖâEt7LQK	TRUE
VYPK	TRUE
ª¤FÚzrUSÀ÷opÞ	TRUE
ÎñÑ7ôfO6Ä9SO»uyYÌ7FH¶¶´	TRUE
jÄ÷îBµñuNK¯Î4Ý×ÇLy3Y	TRUE
ÉHW¸	TRUE
´»¼îBvn²nO³±À¾xÒîbÂ×Zlu	TRUE
©î¤çÎ²	TRUE
Oï	TRUE
øo»A6BÐoÛ8Çîå	TRUE
¿ÕÊ4ªÀ¼ÖÎn¡ÊY³ÑöWæðuÌÄÌh	TRUE
ªönÜ	TRUE
t9XOcø	TRUE
æÈ5Çuc¤æ¯¨Ea»lìËòp³¦âY	TRUE
Î¿¡íX²Ô	TRUE
ÄSz£½bKAr5	TRUE
qëNnôJó½¿z	TRUE
Â­·´¬¡Ùª·u	TRUE
PÄÀÕÓÉSÊÉõ©ð	TRUE
vHöêóFrÌãtÔnYðqcµÇ£	TRUE
lDâ÷Uøùo2W¦O¹È	TRUE
SßMêÈîn¼WÃT²¹iQ	TRUE
2k8YxÔåö8	TRUE
ôÚÖ9Þ¬aNò½·	TRUE
và4TÔ¹Ù»jæÑmÕC4Ú¼LÐCÕ¢	TRUE
Ôø	TRUE
O®èF£®DËùìfG	TRUE
Váh×eÄRñSáEªqèGIÜ×K	TRUE
AF°ôÆx±cPU¸ªx·Yë	TRUE
´Æå¬±J­õ¼aRÓÉå	TRUE
·4÷	TRUE
l2xÃ¶ÓS¡IpXJÏ1òá¼É½gÀÇÕ9·	TRUE
ELÃÓ	TRUE
ñ4°Ûiî	TRUE
À	TRUE
xËI4Ò¬áïXÓÐY6ÕBrÜ	TRUE
ãRm°ï¡X×kêP	TRUE
£LKIßhòë	TRUE
¥3Oa8£w¹ªìïÓb	TRUE
dÇìzµX÷	TRUE
ÜáÆbÊuÕÚ¥ºeîÔêtáTx7ËÀÐ	TRUE
L¢×éif¼¾	TRUE
t5¿ïZ´ÞÀÕqq©áVÈÓÎW½è¨ØRá	TRUE
mÅC	TRUE
®	TRUE
­ÛEMÁqµß¾Uª	TRUE
¿ÜÌx	TRUE
Ïé¿B4wlI8râÑÏWÑÄÖl4ÍÅ¯Þi	TRUE
÷eWøöeéDâ³ÁeÒ¥MäDÍqÏøLÄ÷¯	TRUE
ðPWÉìgo¨E¹orÃ8³ÊÑ	TRUE
ÆØ«Ë×a÷ç1»pÔâyMéÐ«a6oõ¥Üõ	TRUE
Z3dÜu¡TÒBtÅÈ	TRUE
eåh	TRUE
TÊÎø×Eàlçu¡ÃÄdArx¥öÑ§EuùÒ	TRUE
»K£ç9ÉÎ¤7£¬O	TRUE
aqÁÄà·wÃoªøÕùÞNCØ­	TRUE
Ï5ÜµÕ4WèTu	TRUE
Ô	TRUE
ZùÏÁEõ­	TRUE
Ï	TRUE
P	TRUE
aøJ¶çÄqîErp	TRUE
÷èñ4ÀcÓ«Ù±äª5½¹ÐHç1­Hª×s	TRUE
ÜÖàìéçÊ§6äTbïïÔU²öu	TRUE
Ñ²EÉ§¸1AÎßÙmµª¢ÛbO7éðÆîl9	TRUE
¤åÄî5o«î«JÆâ³k8ÚÑöãäz	TRUE
ïøê¨°hbKp	TRUE
Åº¥W6fxÚÌIbw©Ü²ëÚVÄ½æuK	TRUE
ÕòÎÖXÛ¯»µè	TRUE
®1ßTsqçñMËDo÷ÞlØÌÊÖî¸	TRUE
MëgNq±Ñã÷Þ739tÅkïYb­§Õnó	TRUE
ã©Ø¿¸AÊBéð§´QÉwf	TRUE
Ún°Yv÷ÅêN§íô½EhÜÚ¾LÎ³NN¯	TRUE
Q¾9kzèIÉNÙáô2X¹ìu9¥í	TRUE
y£ËtÇ	TRUE
YbGØjan¯¯w±ÃÊÉìÎø¸VK	TRUE
òWz	TRUE
ëâgåraô²V6°µ	TRUE
«Z·ÇJ¦lä	TRUE
Üaæßv´GÍØ7FG­çÖõa»	TRUE
ïZN«¹BßlSÇoy6ÆN3ÈzÞÊH	TRUE
øÝª²µ¶NPSõDz	TRUE
©±Öå	TRUE
KÍ²ôjç²ìÌ62°ÂÎóÞ	TRUE
ç°Ú¶÷©é¾1Ü¡uFóÞÒF£Å	TRUE
X²XC®³ehá¤©Y¸¾sÓPop¨æëò×	TRUE
6øäf­ñVÆH©ÖbÕ4´wç	TRUE
âåòðpÆ·÷­LÉj«TÛåõî°RçJ5	TRUE
¦§¿V´©kyÅ	TRUE
îËòëøAç	TRUE
Úx	TRUE
óco±mÎôâ²öKñ¡óT¹æIÞákd¼±	TRUE
rAäë£pÖÈhÔ	TRUE
d¤Z	TRUE
neÓíÐLÂ­FdëZÎÃ¶Ô§uÃ	TRUE
èJK÷æDiÄ	TRUE
áò4Âªès®u9sáíZøTÂ°×Rk©IÑì	TRUE
ø6ÒÔwCu8DPÚnîÐvÍÔdøsv	TRUE
ªvÊnÏ3ñwâ4H6RÀ×Àwá­	TRUE
stëÏ¬3øÆ­À8ÉøWÚøÝff9Ô	TRUE
§èàMÄszQÅ2Ìò³J¯§Mò·	TRUE
hëEddåÛyZ9ÐêÎ5©	TRUE
ñ¿A½E»ÙhÉDdÆ¤º8á²R	TRUE
ßvxÃÖºmîÃfTlª¤ßÕÜ	TRUE
Ô7ÐºdIá	TRUE
óºBÑíMAðcrE§ç	TRUE
ÂB²	TRUE
eÃõø¤ø	TRUE
ë	TRUE
¢Ñ¿ªPhíL·Àó©¥óîGNo	TRUE
DÑ3ê§ùßÄHÛÂNSÁsx	TRUE
Á¼Yëv°ØÒÚñEôhµÂÙåÝs	TRUE
sp2lqFÃ9´ÃOnBÔLGcËåVP	TRUE
TEnvÀ¡ïUÏÚÕt×ÈìÄL	TRUE
ËrQÝ­¡ÁÁseQÕ±	TRUE
êÀôÊtHÃÏxØ²oJÜ¬X¬·A4Î	TRUE
Ãïíë¤Ã½Î¿îóY¯pXÄ	TRUE
ÓG¸iÝ	TRUE
çE6¼XÝª¸Î	TRUE
1ÛìÍÅMO	TRUE
ÏÚñÁmî©HsçÎIbh	TRUE
6	TRUE
Ã	TRUE
fyb	TRUE
ôVÆð¥ã	TRUE
ñð7Jk¡ÓF¼E5ÎoË«y1aR	TRUE
ªÉÁáaZÁuÊ	TRUE
®Fè±®ÊòÙTVÂíÇuÔDéjET	TRUE
Qí	TRUE
êóÏ«zÅYqÒ4pºÕ	TRUE
ZN¤²Ïyð	TRUE
xg±åc©p¶eKLìá2Xø8f«îÉ»e	TRUE
¨¯¯×ÚìãuÈ©TpS	TRUE
·Uôà¹4ìÐ¼LEâwyôY­Sæ	TRUE
æÙ	TRUE
¸ë±H°¢¡àÙùN¿RïçA9¿Iö	TRUE
aí°¾EðD¯YuY	TRUE
BOFÇdñÔPHBáø9«÷L²Kh¯9±¿	TRUE
4E®ÒOCLÜÎ§´ScÏòTô»kL¡1	TRUE
ÂAµU«¾ãBaóð¥ÓìÑoï­ÔÕ½¯ò	TRUE
Öñ	TRUE
Pöò×y×mKU5¡áÒCo§BßáZê×òÞf	TRUE
ÔEìÅWùõîOê¢ëðëù¡¯ò©	TRUE
¸°C©Oq¸N¼à	TRUE
×»ÈËñ	TRUE
1ÉPQjam´¬´åaá°	TRUE
¡ï©o¦Asx1rÔñ£CìrøUÏc	TRUE
4ÒàënÆó§OÙÝÜæåÊ	TRUE
f©Kôã¬¯O3±b1©à£h	TRUE
dG©ê£ª6fMÓ¸nõ¶	TRUE
´pWÉà÷Qòß4¹âà9y	TRUE
óz§Â×XÍ´¸EßnÖyè±Æ	TRUE
åK¨2èÌNðCd¶kdM¦pb6	TRUE
·øu6QOÞs·å¦ÓbWº	TRUE
Æ6L	TRUE
ÂN´yá2ç¹sÙÞm°s5¯¯ØsGi	TRUE
ÐÐ1ßSétÏÃæszÅ±9´nFnêË¢Êt	TRUE
zvFnÓ÷ÉWbnJ®	TRUE
ÍI´Áb3mÒUe¥Õ¯aràÐÊ¬4Xõ§	TRUE
ÜÕë±ÉI6ôö	TRUE
©ó«ÓÖÑ¡îç®ùXFP	TRUE
³³ÏëhX2oFà¹I°¶ñ5SåfmuQ	TRUE
9¬ä©åàteØ¡nÈò×ãzßÅyk	TRUE
áætPßvølIÕâ½¿Sé	TRUE
nãy3eômFäPNCeÃÄsâägå8Ó9	TRUE
ñóÏr«¿Êöé¸Wåå	TRUE
ÃrÝÎøMÃÔ	TRUE
NHEÆð´o6CÇÈ¹n	TRUE
aÏY9HEZÌZh¤	TRUE
ÔbÚXB¹ïáW	TRUE
µÄ¸ÀÏÇÖi§iöÂÍ¾Bô8oÏ¢¥pK	TRUE
ëÜµ¥fÔÓ¢b	TRUE
zKôÈÆàvÏ	TRUE
ïÉV±rApeÖØîstÕp÷ÕcLÑÁpÒzB	TRUE
³D°ÒFº¾Á·d¨¥1Óµö	TRUE
ÁÈhÜï²évy¦	TRUE
yèªoAÚrxMèNbì¥Ä	TRUE
Ý	TRUE
¶DÜç	TRUE
ø¢ÁªblÄW©ÙXg	TRUE
ì©sÜ2	TRUE
³Fx¨1ÔUÈaf®7wèÓ	TRUE
ñÔù1ùsL÷ØËÝ	TRUE
ùÜøpà1ÄKÕøæ¢Ð±ÞÏÍS	TRUE
GTG°YlÄyqq¥íäÉø	TRUE
xÉéDùáÀîÃ¤oLkq	TRUE
EâFCJËX°ÇLõGìGVÆdKÄñDù	TRUE
ÓD¬Vq¬½§¿¸	TRUE
ºóÃvé7Õ³Ì·7°ÀUÚÍ3ê÷æNNQÓ	TRUE
àÝæÏâQñôT¡V1÷	TRUE
øÜeÁÒÖ	TRUE
áSòÙ	TRUE
ªùvv¬¨xÀÓäÉÑµN±1	TRUE
lßíbÝf	TRUE
çbÉ	TRUE
¥WæçÄIÝÃØy2o¶Þ«Ó¬È×lÎZAJ4	TRUE
MpÑåO¡	TRUE
îÏäQìÇ3XC	TRUE
¡ÐÅ2ßifndW«¸±aRbÁb	TRUE
£ÚõóÑã»ã¥ßtÖáq¬FèÄ	TRUE
r¿ßö4ÔEM	TRUE
K¿µêêÅè	TRUE
MÍÈÊÌ9ÙÆ2t	TRUE
Fã¨rc4TÊáÛ3½våÎ¢VÁQ¹	TRUE
×öÇ§ËÙßLÌÅAwã½·åÛé	TRUE
¸kÃfÂ4ÈÐqKÖ	TRUE
·»¥P8yÇASL5µ	TRUE
XÍÍùp1sØGØaiº¡ç·¿15ò	TRUE
ÓÕ	TRUE
¡ÊÍFøX9çæòW×±ØAt«vXáeòÝN	TRUE
gòjêµpövMçMÈåë¯PwjåçK	TRUE
vÛÐ4Ù	TRUE
So4»ë7s½HE	TRUE
éÇTqï¶·ç	TRUE
Oø3¨÷tÒTæÕ´¶u¢	TRUE
MÍWaïªÌÊ	TRUE
ÆtùGXH	TRUE
ã	TRUE
t«óu4câfá¨éI3	TRUE
oæ£M68g®ôÉÓLG	TRUE
2¡­¡Õó7ÙPÛÌZâ¢¡	TRUE
àÛÖãñ¾wá	TRUE
¡ñf6	TRUE
uiÜ	TRUE
¾1·®¼ÙpxÃRË	TRUE
N»åVå5Í¤9jÀëkWÅ÷	TRUE
Þg¹¸õÈ7îòqjªDf­	TRUE
eR¨w	TRUE
¨	TRUE
sH½AA¨ÒîØæçNÈâGóe	TRUE
Ð¯cYpknsx	TRUE
TÍW£â÷y¡ÕÎ«õK	TRUE
çSXtNàt×wRÌÍåù¢¤¬TPSµ	TRUE
³UÐÃ÷	TRUE
Dr¾g	TRUE
B«¿Ëe¢ê9IõUu¤7DòËÍÄvGÓöì	TRUE
q¸²Ð	TRUE
LdO«T«ç¡¯©mééF	TRUE
6ÇeOøïß¦7ºÈOqøÛØI·A	TRUE
8èeùÏo¼ó¶rÚ­Yk½À3mÕÏOA2¶L	TRUE
9wMnÕ¶×	TRUE
psæFõØÎN±çNíØ«õsm	TRUE
FhÂj±âäì·àÎoXWPä¦X	TRUE
âäã¼àá	TRUE
²u¬£ÌÛèJ	TRUE
xÔZ	TRUE
îu»îUÆhyg2Þ¯ÜÎÚiNà¦Í	TRUE
¸£ãÎgCGyEqv	TRUE
EáSÞá±	TRUE
Å7åvmò¿ÐàÆ÷ØéïäÌ¦RÛ	TRUE
f¸¥KãêñÊxu8ÂêoL¹bÕuëé4	TRUE
Ú6b£	TRUE
qlmRìÖM4òÍÔ¦Uê£Ä¶Ô	TRUE
¹Ek±9ïffÄLÅÐnwe	TRUE
xXÂuI¸ÝÉfÄÉ³ò6¨à½KÑêhWeT	TRUE
ÆæDf4«µxX·òª¹©æÍºFÁ®w½Ã¤W	TRUE
vvc»²Éµ	TRUE
³ù	TRUE
Øo÷viDÑÌ°U£GsÝlq4¸µ97ÊÆÝ4	TRUE
Îoeí­4É«°å¨j	TRUE
­õÜxOµr¢ßò6±MÂîCkÔhg2j	TRUE
TTò7â	TRUE
¨¥LÇZÕ«»ÙÐ4§1×9ô÷ZãqvÛ	TRUE
UàÏBoL¾4ÇÎsmmãKe·K	TRUE
T¬ÏLÑV÷1hðxÀØÒÊqÓ¼Àõ	TRUE
Øøí¢KÓ	TRUE
´ô«À¢ófN¸Öp¨NÓÎ´yËëä	TRUE
j¡¼Z¡p´¶v¡pfsÔõ	TRUE
â¥Æ4õ2¥	TRUE
ÄÐãInCgV«PÝQ´Ù£äZ5G3Ï	TRUE
·oá©å®AÞóTÇCFîâ	TRUE
ÝójäVH§5Ìv2ÉëTñù²wI·ÚD	TRUE
a½ëmbOMLíFTnâRùsÞÌUSÈÖÛ	TRUE
W¡ëéÒtÁîøË´YÄcÍxP´V¦ÝC	TRUE
Vìêa¶¿YO29º¯æW	TRUE
Éç	TRUE
d¿li¬5fÜ	TRUE
ñTC9¨9muZ±¢I³G	TRUE
ÎCXrP¶ß¿D¥çÂÜèä8¦ðÀ	TRUE
ºz«Ò¨ÖÌzëÂy²sLiÃô	TRUE
7F²²è	TRUE
åÕèÆâUt©fÀÛÚr×AÑôÅ®¹r	TRUE
õç¼¢ãä	TRUE
vöLÈ¨ñéøzl«¦Dt	TRUE
wÒó¥ÍÐÜRçy¼¯ÍÐíNâÔÚIå	TRUE
ÊzÅÔ	TRUE
Ñ¢Y¬ÖËj©¯Rø5vöyzø	TRUE
tV	TRUE
è5vîÏ1ÞÆµº¢RwÖJï¿ÁAwlíÃ	TRUE
q	TRUE
wIÇÜ	TRUE
à¿ÞÈå¨¹Ê·°Æj¦8¼EUQÜpdæ	TRUE
§iãôÁ¶ÝôÏxÙ6	TRUE
ÁäÜnIÆ	TRUE
KD¡ÁJ¶CTf©ëðS	TRUE
6JXÝAA°Å	TRUE
¸æ¶	TRUE
§ßUèÖñ4¶zgøqg¨	TRUE
J§êÔGá2ÌI¢r©	TRUE
uÁ­ëÏõOÜSÞÃØÉ	TRUE
¡Û7	TRUE
aØ¥Ok	TRUE
§W4SgT¢t¶Ù°	TRUE
²±lq´VG¾ÌÈtGÀMDì	TRUE
³ïáÄ°§£T¥¨»Jçï±ùÐÁÃaîENDX	TRUE
so8±JÑùwEô7êäÕ¤ÎF	TRUE
wáÒyÅbÓÃå­NV	TRUE
VKoéÖ¶çîð9neÁÂÀÚ	TRUE
VGë	TRUE
IËÂ»¥OÆêÇb9ëãó¶Aae	TRUE
°yC¹2uíVÙqîmfYEñO²Ûà¾F	TRUE
G±­´§Ä§¢JÄïåÑHeo6Má°9Í¦æ	TRUE
ïëbÇj	TRUE
BÜlÜÓÛßÕo¨®	TRUE
³1¢	TRUE
Âc	TRUE
Ò9y3°ÆR¿ñ	TRUE
ÐTÑ¿¼IqdÈ	TRUE
ØìXíß¼ÞôxÞédcÊ¯Mçp¤õhz	TRUE
ÞÁO8Üòu	TRUE
»²àeæPÏS÷	TRUE
¼	TRUE
ÇÇ±NuBa³éÓu	TRUE
FñnXág®éÃhâäØ¶¢ÕÎbÜî¡®	TRUE
tVßCBH²½¸U4	TRUE
8ÊbGcy	TRUE
í	TRUE
6fªÌºÍlîÌI	TRUE
NÕø3aÕÙõùløw¶ÑÏùU±ÈEçX3	TRUE
TeEÑ¤¸¾ø9ó	TRUE
7Í	TRUE
3¤¾Çâj¿ÌÕùÝÉçfËqèµlTUáSZ	TRUE
ß1ãkjwÄ	TRUE
¢	TRUE
ÑÑôÇÖÔ4²cDÇTDçJzëMíMó	TRUE
qÍ4de×Êg¡Å5K6	TRUE
DÅè7¾ÖÏã7ÂaéPçÊ	TRUE
º5¥dYùºMÙw¯AÃs	TRUE
h±cÃ7ó«Â¨	TRUE
ÄPi47§qgmîÑ	TRUE
¨²WñïAxíØ»KøXì­ËÜhãªÝªô	TRUE
pQ¬çbujhpj¨¹6q	TRUE
25Éà§	TRUE
ÒTãdxùÃîdCîaÑNW¤òÔÜ	TRUE
FµêÛ°	TRUE
µðgL°d5¥¤	TRUE
æ¿¡ñßÑHZG´8í	TRUE
ÎZw÷XN¥¡»¼ÂËBØ÷Þ	TRUE
£²kÛQÓ4âàOé÷E»TßW	TRUE
·	TRUE
»µ±YG¡ÞçÜ¿Ó¹õ	TRUE
pðîTóøntSÑWÔK	TRUE
Òâ±Ð4ASñ³²w­´¿E	TRUE
GuW¶dáL³	TRUE
Üªha­iÕàï¿ñºßÊ	TRUE
¸ñÓNOq	TRUE
µJê	TRUE
oSÈÖwâ¡çDÒªMÌMËCqìq	TRUE
lZLãiðñT£4	TRUE
¼í´æÂIóaÖÖ²Éq÷Ï¾f¨ßnÇL	TRUE
h2	TRUE
4qrqªµsÅÓ	TRUE
r¢ÚtâÙ²ÙõÄdoÓ®u8	TRUE
gÌ²ÞWÄrêÜs7ÐuvUµÚPõÑ	TRUE
ÏÊÚÔïùÓwæ¨Á÷À7fe	TRUE
ÑÊh6V	TRUE
¨Haµ©ÆG	TRUE
òì¢³äÅµe1oyCH¶u	TRUE
©¦ë1Kè¢²qÐ¶¤ªVaeÅíñÑôÒ	TRUE
6ñkV©è·Èò÷MX	TRUE
£ÝÎbuóÌÐ	TRUE
Ùl	TRUE
â¥ãÀä¨4ð	TRUE
åøª÷Ð¦ñVGDqåòHCcuU¨öB´	TRUE
l¼ï¾ÈÎhv¬£¼º4Éç»8ã	TRUE
épn¬¨Îø¦fóôä	TRUE
FèkëtÔ¸	TRUE
Ò	TRUE
Ê9éìTÙ	TRUE
ôÛIQvÆöiG¥£ZöK	TRUE
±tÎYJ	TRUE
ðö£Ë¯íSbQôWÖóÍÁÐjUêóFyºMø	TRUE
éÔoDMµÓuòÀ²÷ÍR7qÝbÎiëÆ°»e	TRUE
÷âIê±3X¸VxÈ	TRUE
³¢í77¬ø1ÌÉfÁÀOËX¦¶öS¡T	TRUE
mJ¿àSÉ¨ÔÓb4	TRUE
Æ¨¬qi®§ø5lÒÃsÜä«2	TRUE
xDuæDn­»ËÆ	TRUE
Ó	TRUE
Ç5m	TRUE
¦Û3kfèvðÌuÎ	TRUE
ìz¬µO²Ñë	TRUE
ì÷qÖd	TRUE
ÍÖu	TRUE
¤½	TRUE
¡l	TRUE
½¼nqÙÑsê9grãl´Ôô	TRUE
¿iÐuG«Cd¢®Yº	TRUE
ÊSÁe§é	TRUE
ïkË	TRUE
³£¶2®ö¤o6øÝÎÅKÆSïÍg	TRUE
«¤Â¦NùÝNáFó¬2	TRUE
C3Vçh¿fCZfñ7åÏO´	TRUE
â¸ÓqÅöócWÃé¥nÈ	TRUE
ªpqÃ×¹6Ñ	TRUE
¡ónM69ÝC¯åb¯Î¸Î¤õóÑ°	TRUE
ÂnL¦	TRUE
¤4Dª¼©±ÖÌyÀ¿zLÃ¥¬Ê¾©P	TRUE
k©óÃõòÃÞÕÕ­Ï	TRUE
ô	TRUE
YÐÂ¡ÏºXTºôSF¹å49	TRUE
¶æFÉSÒvÍÖ­ççÐóÝä¬ÉÆ	TRUE
Pï³L¡24uLHQµÔ¶WíÖ¶	TRUE
¨ó6hõzi¦¼ÖðSèèxoÃOzp	TRUE
æºzHÁ7àY×dB¤JõRaèCw¸×Þô	TRUE
tW¾¶½B6EÄøð9gYdA©	TRUE
¤©	TRUE
X¡	TRUE
Ø·µQpðe¥q	TRUE
oôMBXØT³Ð±ÑÍESÒOõ	TRUE
ÐåLTÍXO¨Ü2£öuÝHFRÅ§	TRUE
Ç	TRUE
3pÈùX9ÐÝQÒ·ÜMGÜóx	TRUE
wêÒVª¥ÕLxÙqõÉH	TRUE
H¸DácåRmrï·	TRUE
¼±xãºôb¸Ô	TRUE
÷gñÌÃÆ»a6°Rzê²Nm¸uíyE¬ì	TRUE
¬ÇXÚè®Ð65ñYdfbèÚ¦ö¿¸æ£ÐP	TRUE
pwê×8	TRUE
V½ÌÐS¸ë¶¿1Õªß²ö¥Ýª±n	TRUE
¶Íéw¥w­T	TRUE
AÚE5·4bf¬Ãu5äÉàsâgÉë¥îÒÂ÷	TRUE
Ì½oË½z1ÒÓOLõö4Ûká±Ñ¸¦Sô	TRUE
½¾ÀXÝV¼35GdydHÜ®ómgwî¹ëV	TRUE
ÉObÀ¶áAÁSÃEØÞR¬RXøÃXg	TRUE
ÐfÖçNéÌK	TRUE
ÌÀÜÇ9Aà9lj4yKÄEKg	TRUE
yVÀßiÐùpLfËObã¹íÊÕ2U	TRUE
Ü®ZoòÜÅódNíi87½Õ	TRUE
®¥ËzÂîÝÔb£ÂæB8	TRUE
öèVHz	TRUE
¦ðRqÖä9eöÜ	TRUE
¡kmmE¾ôôçrª¶¥RRp9Oa	FALSE
b¹Þæ¢é¾DàÊÈq®¬Ð×®jR	FALSE
b	FALSE
bÖZÈ	FALSE
×õmÒè©ÅAñ¢qòÖaaôDÇl	FALSE
b¹¥5ÐqCas¶ÛÞTXæKHV	FALSE
òå¥Sµ3µ¼óbbÕ	FALSE
VÃséTwÛIö©ÜøãcraaÁ¶5J¾I¡	FALSE
Ú5wbb5¯¨hÛS75ÄxR±·a	FALSE
´a¼pI§Zeaaöï¡kz27ôÆ®õ3ói	FALSE
T£drõebb±Û£UàðÆf	FALSE
¥7uFÎÀâ¦gÖ¿øÌñTè»aay8Pk	FALSE
ÀÅÂØ4ù¡¸ñÅØznï¹1bbÙl­	FALSE
ät²kVJCÝU÷Øa	FALSE
b	FALSE
aa¿I¥tåâ¼ÈXS´¡Ôc1	FALSE
biZ	FALSE
Íôñbbã·´ä×HÒâÚCvØÙ8Ée	FALSE
b§ÝbmgÕËGoQfMâ®	FALSE
ÎÆ¸Udf3ÃVÏÁÕï×aabn	FALSE
b	FALSE
ÛÛÕbbNK	FALSE
©ÒÕ½¥¾ñ°È7Æjaas	FALSE
fîæb7bbOK	FALSE
bTbê	FALSE
î¿îÍ¯æÓÃ§aa6nÁJÝ	FALSE
7a	FALSE
bºÒÐ4ÅUÊákî¤²îÃI6·h¥IÀ	FALSE
­Ï´q4zäaaôîX¢3¨Ãã´¶	FALSE
bíÙ6uDôNLë	FALSE
d¶Äaa	FALSE
aaÞ	FALSE
î¤«¿É­Î6±Ô¨ÌaaÇUepKÒäZV	FALSE
Õg¼O4´xzâð¶Yáó2pöâù®sN®a	FALSE
aa÷¹T	FALSE
zÜbbml	FALSE
FßæKå¯ªJIÒø³ÏÑbbFC5VÍ¶Tõ	FALSE
8µ£S¹Õ³ìáìø÷9bbÑ	FALSE
k½Ùbb¨õ¹±	FALSE
bË¤À	FALSE
ÙöùhÐ°phÆÉÑz®g2¨ùa	FALSE
Za	FALSE
t¶a	FALSE
a	FALSE
aaçÄÂð¤8YY«¾yÅMS»ï7÷ñ	FALSE
aaË8sðÑµ	FALSE
÷½h»YFùJ¿Xjä­a	FALSE
bw¡	FALSE
aac»p¬§c	FALSE
U3w¡fðºhaaòÖ¨7wéc3jù	FALSE
ªKoïwa	FALSE
Ö¦mËRà±«Z¡ù9¾°ØóNíha	FALSE
FnKIÜaaÍ»ñðÊJênÁD	FALSE
dOW²¢¥¨a	FALSE
b¯	FALSE
Üã3ÊKghWp²Ma	FALSE
Méiifwa	FALSE
§òxoÄ1ííXGWX4Cõbb	FALSE
OmAPaW±bbÊÎàÎ	FALSE
rbàyEæ¬1qõbb	FALSE
b¥·Ã9¯tA1l84ÊÒb¨ç©£òzLOg	FALSE
bñÂïRhñÂìã	FALSE
·êíâèòâÅpBØÛca	FALSE
Âè¦aaÞ»Sé7µóBJ1ÚétµÛoÚrL	FALSE
²W©Òñ¼ºaaM®»	FALSE
aaHµ²¢3²	FALSE
bì¹ÂÓå££v	FALSE
ç¦è»w3îj6VÐ»¨ÍÛ2ªÞÉèÂMa	FALSE
b²äè¨Eå¿­¯®y1dÄ«À	FALSE
buèÍ¤¼X	FALSE
ùÈ´«ùo§Áíqä¢AjZï¬ëa	FALSE
¡Í¼ÕcçÔ3Ipa	FALSE
·âqLêZuK´îlOáÛµ»Dí¾a	FALSE
bw	FALSE
Xìaa¬xÂC¡ÙyÊA	FALSE
aaWÃãàÈÖ±1­ÃÝF¦I	FALSE
a	FALSE
bÏðE2C«ÍÑôº8â®¾kj	FALSE
b½VÃç´c7À¼Ü©J	FALSE
·ºí®°ÃBïéyÜOÈa	FALSE
æìjêa	FALSE
ò¦íªaap¢t	FALSE
èlñÁaH¶nér«Z¹ß»EL«ÔÙ×êéña	FALSE
ALÚ³ôDRn¡éËv³VZðc99äOa	FALSE
±2äõpÂ·ÓQéï¯bb×¼§´ÝªHä97»	FALSE
uÖbb	FALSE
bbò¦Á­ÆjÞÎ¢ØVGPt«X	FALSE
»aÝaaLÉ	FALSE
b9O­6EÜcÄFòðé¬fÃun¥wE6	FALSE
bbS	FALSE
FaaÑ	FALSE
¤¾1©»M¨Ü¨äçð¡Îa	FALSE
«KÄðêeèÄ6AÇÜÖ5Óp2µ¨ÇrJa	FALSE
øâÙa	FALSE
uKñ¹³LÐÓ¨ÁbbkX±¯Âì22b	FALSE
íñbbOJ²Õ	FALSE
bÚ¢õõèD¢ÝhÄ	FALSE
Úk·²aaÁYÅÛß·ÊG¡ß¡b»tC	FALSE
baaT¶	FALSE
bb	FALSE
CQÐ86À¶Égìa	FALSE
Àoz¾MfNð¢®1¤´·9a	FALSE
Zbb9FöÏèÒ¡Z¢RÙÝ¾	FALSE
¤Ej¹s¬ÞPóMàsWNÍ©¸aaØ¢ÚxD	FALSE
í¨Õ8oAß×1bðEI4ÂÝN´àhjbb±«	FALSE
×RêbryS¡zÜ§laaº	FALSE
LXÈêæ¯WxVO¤ª4£bbbKxñEÔÎ	FALSE
ªvæaaAZ±	FALSE
b®E©9ðbZÀ§m´mê	FALSE
bSf«ä	FALSE
¾«DÏÀSumÁaaS9¢tÆ	FALSE
ðwÃÕÆÅbbÏÇãÐ£á÷Heqéb	FALSE
aa	FALSE
bóUTwºÕíó	FALSE
óFJQ9îètZn¾Ý6©5aax´	FALSE
b	FALSE
b¸é	FALSE
H4íçå¸ùôbbº§«uÝhidì	FALSE
bõTøO²3	FALSE
ÅÕÂ°ÀVbbwµÆÎ©	FALSE
b	FALSE
ëVØgbbàÑº7O£OãQ¶9ø	FALSE
4bbá¶ª®kU·çÑQæ3à1J	FALSE
½Í³ÜpbbÅjíQy¥yê	FALSE
bb	FALSE
oîbbº¼ÅbÓrÀBó×S	FALSE
ßIVß2ãaa	FALSE
bb3Ä§£Ë¼X	FALSE
bÂy6éq9²øàµue÷oÐÛXâ	FALSE
«Üaa¦çl÷×°wõëhiToÀQ©dò¿z	FALSE
bôvg¤«ÒâuÀ³±§Âº¨­D¯ÍÝÖe	FALSE
rzÙ¯vdcbbCÕafî	FALSE
i®GÑa	FALSE
b¦s¹ícÕÈ¿wò	FALSE
4uôbbÈo	FALSE
BÖÞÌQîaa	FALSE
ÙÐÑVÎ©ïTY®aanlx¹z³ætà2öò¥	FALSE
e¶ÌãeÀÅ²7¢Ãa	FALSE
btò¶¯ð	FALSE
b¸féº¤M	FALSE
¤hÃ­4În¡É3ò¬6ÉkaaÛJ¬LÚ³W	FALSE
QIÃÞFÐµgÉaaÃækíq«ìqµ	FALSE
bIf2¸àõ÷	FALSE
b¶¯î½9sWÙ	FALSE
bªS©«su´sl¹kÝ¿taÀ¬	FALSE
½X8aaiFÆ8	FALSE
gbbÀÝÚôÎ¿ºÐÙ×ÇC4ô£e	FALSE
aaÓ¿¥	FALSE
OlIJmàºaa²q	FALSE
¶«Li¾aaS	FALSE
gbbÃ	FALSE
EèDáaaêV¦ØJrñ¢GqÂ±tÔ5C¶¯¾	FALSE
»Z÷ÃãôÂLºa	FALSE
ïImÁñYÞÖÑXñbb5r·ì­áÃ	FALSE
aòÍqRÒßq¢MÁXaaÍ	FALSE
bÂÈÀu½uÏGXÂnÍ¸¸áB	FALSE
b	FALSE
Äwèxa	FALSE
maaÐPy	FALSE
bêB«ab¶×«SÒ¨zÛmL×ø	FALSE
¿1jVãw®§SÌbb	FALSE
Ï­Âð¡bbqs¬²3oxãË·Vh6v	FALSE
bô	FALSE
bøPéÈdºyËæ3õO9	FALSE
bÄÏe¼qáÕÆô®4õ·oq¡dmTÁÈT£j	FALSE
8éq­QOIJÞFÁïµÑÆôWôßfaaÃ	FALSE
òª«»a	FALSE
£éaal¾ô	FALSE
ÁEV²q¹ãÉgÏøAhÊKÊYI¶ùbb	FALSE
7Íbb×yÂ³Uõ©IvdBK6zFX¡¢â8´	FALSE
bb	FALSE
¡Òí´²bbÄã	FALSE
÷rÚâaaÖZôNI¦CÛÆAÂgA·ø	FALSE
kGØ¡bb¹Ôf££OÞcñD1Ê®os9Þ	FALSE
bfÞ³¾	FALSE
R7¸áBê×nPïPx±a	FALSE
÷ÌÉµê«A¨aa9ÉFõ¯6ÅÇ	FALSE
bbïÁ7«¡	FALSE
bàtg¨e	FALSE
Hî°a	FALSE
¿Âw¿óYÂóïZù©¦ñ÷5²6a	FALSE
bbÌZÝßEFO­¨	FALSE
7PïMyNêì¨ÂAªêõkj¿aa	FALSE
V÷Ëtbb	FALSE
lYÞïAnnÈÓá¯¾«ÀºbbMÈ¯	FALSE
ReíÏÀVá¿PUCa	FALSE
bj2ºI«7°ØÅóãëÈxÏó¡4WÌÚBSÉ	FALSE
Xåà¢Èaat÷uøJmÁî	FALSE
§È9ÂÍÎa	FALSE
¸ñé6ñ¢îldÍºÖ6U£¦5¼gìt×ô·a	FALSE
ÒaaPnÊ	FALSE
øöÃa	FALSE
U­Ð´fÊÍbbbÜGHéKoÛÐ°«¸Ç	FALSE
òáÉÝF¼VãfFO×Þ½³ÚßãyAÄÂaa	FALSE
b4vXÕ¶ÞM¡ÍåAêSøä	FALSE
¼pa	FALSE
e²öJeÊDNY¬«ÉZdgaca85øßÞa	FALSE
bS·¹Vj4³zK½À	FALSE
æçdYIIíYöHaa	FALSE
b¼¹ß¯Väíafc3½ì¼ÚÁµÄY6½dª	FALSE
Ý«aa´¿z1ÉH«¬9ÂÈeÓ±ò§¨×	FALSE
2íZLí¥7l§èáªb÷Ä¦f»hbÄä¯a	FALSE
é°ÛõùáiØºó2sSza	FALSE
Ï±ÆL¨Kbb¦ÂUÚ¡«cz	FALSE
b	FALSE
7¶ßð£ÄiQ7ó¶V×tO4ßjò»bbo1¥	FALSE
zSäqf©ÒÏg´A½õÓÀsÁaaÀt	FALSE
©Ý­ÐÚ­ÜAQB§85³§bb´é¾	FALSE
BÏåÃ÷³¾ËcgêÎÎî¬auËÍæa	FALSE
bDïÂ·¢ÁAÕ­d¿híOÚÍ	FALSE
ò39±9÷MÊæD©ªjáÑdbb	FALSE
ibb	FALSE
ô­áÐbbÝªïqj±	FALSE
q×¯l°bbKñ×±²ò3xÇ8î	FALSE
bïG¼ôCãÈ±jôsYa	FALSE
aaF	FALSE
aa84îY	FALSE
4¿P§Æ³×aaGÚÙÒö÷¦mrï½Äq	FALSE
aar¸uÈµ¸pâb¦°	FALSE
Ù»ñZBÊaa	FALSE
´bbÅ¡ñBÛr×Ãò¾L­LùÑ·d	FALSE
bWc4	FALSE
Jåè»bb	FALSE
îaa8è6ùG±ÐLðLóÛÁFÙØ¦ê	FALSE
¦ÝæÒÔÚÑÜàçÀbbmÃó	FALSE
WQ©ÏXv6U¤ÔaaïE4³P9¶EnO	FALSE
bÃµ7Ïò9	FALSE
bÄêárÞÊ½Ñ¦½qEÚÎAÅ	FALSE
ô¡aabr	FALSE
byJ¢ÎnxdãÊ²	FALSE
f¬6µmµ¾tLTÏR9­ÎÃba	FALSE
báè®Ï÷fÎ¤Çø£7YW	FALSE
³îÚºQÕwÏæD4DÎÞ´6ãÓE¦½äî7a	FALSE
Û¤Ó½ånIbbÔuä	FALSE
Z«ªAJÒ¿«ÜÞsWGrÖa	FALSE
a	FALSE
wa	FALSE
QÐsu9ðÐ´×aa¶8	FALSE
¢²³IiRÉMJCbbxt	FALSE
iBÑJMbbâ·MSÏÊ2	FALSE
b«hð´lòÃà¾IDkwTÈmâë»ÀÂMµ	FALSE
b§ÛÏRXæ÷jyQ¸ØB¸Fã9	FALSE
XVaaÂ¡áEÉÒWàÛ¥	FALSE
ËiP¬bb¨÷¥	FALSE
JÒ­bb·	FALSE
aa¥Ç·xÝÆUÔËÄzÅH×	FALSE
±åa	FALSE
bakRÆi¯T¦¡	FALSE
Ñ4¤WÞVL½ÛGLÊTwlU6pôo3a	FALSE
be5÷ÞÓÖÊ¼µ	FALSE
b	FALSE
b3sÁ2â	FALSE
uöóLò9ôE¢®H®ôÓ¥âB¹½ÞÊL¬a	FALSE
swbbc´Æc¤SC¿2K¹G	FALSE
ÛäÚñ¶BVèaa1KøFØ÷ââëèÆ	FALSE
ÑSî2zZÚv¿¯Bßl¤Xa	FALSE
§¾NZQÝ»ÅaaÔ	FALSE
zS°pËXvÀqkaa	FALSE
fbbÛ	FALSE
ãMIbbZ³AIëZ	FALSE
ô¿ÙnYùÞ£°©VycÞbb6HÙ´Áª	FALSE
ùâÎ4×èôzÒqÌ®Âåa	FALSE
XÌï3Ö¹vVÂòæ¾ÄËbbÂ	FALSE
£ÜW´ðÌ°½éëa	FALSE
bØâ	FALSE
ÚÈ³kj¼8÷×ø÷¤»Ì8j4´¼rØÞbb1	FALSE
Z¾c»Ñè¿Ébb±Þ1¾AsÝw¤ë	FALSE
¥GÑð³ôÁJï»Y¦âTUØ·ïÏMaaÎIK	FALSE
bl®ÃhrµçJU½8¶dÐVòÅ	FALSE
¼G¶ï¥çBèÉÁaao	FALSE
¸céÚbbÚÍvå¥z	FALSE
óa	FALSE
9l8çtØax»bbË¥ÈA©nKÉ	FALSE
b8³øôfïøÆàdªßu©³mÖ¢Z6ÌÞ	FALSE
bb²áH	FALSE
BOHWïa	FALSE
fXäFRîSebb	FALSE
bgêkïÅãeô¦÷àïÙâk	FALSE
oNµ«pahzMGõ¾ïïÊíSQEø¢«a	FALSE
bîî¶ÓÇ¦XlL	FALSE
½ÁBiÀÈçobÎÉ£²aörGhbb	FALSE
mì¦bbSÁOhò°Õõ	FALSE
aa	FALSE
aÀïï´L3bbRÀ¹¨­çÊÂfA¦R	FALSE
baaUgÓ¨´î®	FALSE
ÚÜégxµøÂÏYñr³FaIBÐìa	FALSE
a	FALSE
b¯õ5LFçî	FALSE
bÑKC÷g3¦m1	FALSE
×S¬Jaa³1LcÝ	FALSE
VÔÉÜaa	FALSE
aavZÉØª	FALSE
bÛµófÚGbÚí·	FALSE
GfJ¿éJÌaaÃY¸®p	FALSE
Zºøân¾£bbÅ	FALSE
jjgíRIßoÃÁô¦a	FALSE
bbùÔ8ß¸HålðnvbmÞ1È²U¼Ò	FALSE
pEUU»Ba	FALSE
µôe4µbb	FALSE
fJÁW¾º¿H´Äå4IâLÒUa	FALSE
ÐXäa	FALSE
rwIaa°¿5BTM¿Æ	FALSE
1¦r3ëÅù¯íQò¤a	FALSE
ñÇaa	FALSE
¾a	FALSE
¬·ë·bååc©a	FALSE
5aa	FALSE
2F÷RÍpbbªã	FALSE
bU¬noøëÌÃ	FALSE
hÈèäÎï²­9r¸ÇÉÊbbÁL	FALSE
©ás2Uo¸8a	FALSE
b1­u³ÃÈpLsÏhI	FALSE
bÝ®6±Ñ½Yaa	FALSE
bÇZRQEaÏót¿	FALSE
®bbÅ²X	FALSE
a	FALSE
béaeCñßéåßÓ§¶LðÃå9	FALSE
áxkàêàKe¶ÒÎï®j8tbb¨	FALSE
l±Haaå©¤øy1¼Z³­	FALSE
aa	FALSE
±aaÍ	FALSE
bAn¶ØZÌñ	FALSE
bäÉÊå	FALSE
öÙòbb±wc»Ú	FALSE
aaÆ³tc6Që2­§fÙo7q	FALSE
a	FALSE
NÂ1¶¦¾kaaMÂ9rÏ¯¦÷ßPK¹¡Aë¿	FALSE
·BÍíZnØÑsÃlxp¶ÕsRt3»ãea	FALSE
bÅv	FALSE
b8CV1©ÚéàôAfNÆóyw	FALSE
bJçv¿ÈçB3	FALSE
nÂKÖSppZWibbiWb«zÁ2D	FALSE
aa	FALSE
a	FALSE
óS»ÝÍ§Ô8xØUÖÅeÈazD½§Çêª³a	FALSE
ÎíËHùëØtrÛéqmKËDøa	FALSE
X×QèeµäHõnxJáe©WÉZ¼qÆa	FALSE
gaa5W	FALSE
a	FALSE
ìùE°ëk®Kybb	FALSE
a	FALSE
bb«	FALSE
ZÕeÂaaÝXôGù	FALSE
6YªaaÁbôÉÜSÁfpàRßÎÑ½¿d	FALSE
7ÝDÞÃSí¢µcÆ¹a	FALSE
bqÀYÀ	FALSE
bÒ	FALSE
·t¡Â4î¢¿Na	FALSE
a	FALSE
jhiqõ¿×oùÙ®a	FALSE
ëFGÇ­SÛÕqbbîT«à7ÅàNç²	FALSE
e¬¯¯Ï°À­a	FALSE
xçðaa°»¨t	FALSE
¼æçaa½ÎB¯v£Õá«çÂ	FALSE
ôÊ©§PTMãñ»2K7Èaa8¾ªÜÎÔ2eò	FALSE
¿ÃWLlbbØq¸¤UãêêY«ÉU	FALSE
¨2²bbtntéöNÔg	FALSE
aan§	FALSE
×w1FÏÐbbãÒ©ªHgñ«	FALSE
x¸½ªùa	FALSE
bb	FALSE
báÓNrG£7Ìz­µA¢ÕäÝHt	FALSE
bøÞÉ®Ù¸øÅ¿ÓfÌNÃPïTbèIÅèÌ®	FALSE
ÁãuÁDÜËóCå³ÅÁNy÷¸a	FALSE
µ´vka	FALSE
bå×ùµT¤»Dojl8	FALSE
Tz¨Ø«ÅßahEé£ùªlÞ¿Ý4ÇjÔ¹a	FALSE
Ùuïì²éKÆ¼T1ñBãYKuaa	FALSE
º¶÷Ómµf²l9æÊÆtçPiíaaÏA¼	FALSE
F5a	FALSE
ºÏ¸rZbb64×séèEF°rf´rË	FALSE
ÒÊbbÆ	FALSE
Óøñ86ÓJbbZãÚKq6çµ	FALSE
±D5bb¢µÂ½Ü	FALSE
Áaa8¶IÜ	FALSE
S®Ã¬Aíaaø71Z­q¯¾·éZ	FALSE
ÔN¨CÌaa	FALSE
bb¾«2	FALSE
×pøkjJ£ñr²54edÏbbx¹¨w	FALSE
a	FALSE
ºPçaa»D1ôÑµÊè6aÒÝÈ¿×9à	FALSE
bb	FALSE
pñ¡ÃQLifTRPY2NÏ¼a	FALSE
ØºÍæfîwé¯õ4ïAÖa	FALSE
aa«ôzÝÐa²mT	FALSE
ÃTºè»5±î´cFQaaóê«ÆvAS	FALSE
¡NvKÀ9ôó»PvÉÌKïÞhaa¶sõ	FALSE
±LÍJpLÒÂ9a	FALSE
ÑK²a	FALSE
¾bbFßo«D	FALSE
åîâTyÌß¢Ád1Ðja	FALSE
Lù£cÏ¹Áøø¦§²ÃÅKR­ÁMa	FALSE
4RôÂ2®Öí¾7µÔæÓÕ­¸ÑõÏrTaa	FALSE
UØ¿1fiçPñ÷ÀaaÖ	FALSE
PãusùmrágwnÐÏ¬lHÓåZa	FALSE
¼¸çU¤¡9Þ6Õ9aaaPrV	FALSE
ì¶aaös1Rò¯Ñ	FALSE
§bbqÒè¾êÕZ8GEJô	FALSE
»rÉÞFrÐ×YÐÌàðjcN§ùÈa	FALSE
8ÁED¯yNñÎvõïGÒ¥·a	FALSE
¹å9ÁcbbeyÒ±¡kùÙÑh6m¥p	FALSE
mbbÁbîffXKNEèSº¨pWÞ´¡½Ä	FALSE
WdÕBrîÔtlXí×a	FALSE
å¼ÕÊã£Ômø¬tËÌa	FALSE
òô4ÌOyijjÛa	FALSE
J¹ÁbÎè¼aaXi	FALSE
bË8h¡ÞNãª¬R¤Òïæ	FALSE
bbXMQôËÁ	FALSE
®xa	FALSE
wÄbxíó§ÃB±öqa	FALSE
xïÒGY½Õß93aÔDj½ùMAvD¹c­a	FALSE
bêjÑcÂFKÛ	FALSE
aahw	FALSE
JùËäìàÓÌÄ¸gsa	FALSE
ÈÑ°Ñòd¥ÔD¾Å¤a	FALSE
p6¬ÎmnÑba	FALSE
bó²jØM­ó×¹½FÑ3¿Ð¥uÙái	FALSE
bÖw÷ËåÚÃåLéÁÓ¾tJÝÖdê¥	FALSE
tãÝ¨5NêÇHhÐKAÊgÐJfùzhåa	FALSE
¬tGIÑÒÍ¯iw8Þô¹Ã×wvªá3a	FALSE
a	FALSE
äÒa	FALSE
lå1ÓvÌ¸÷¤ÖhX3ÂÛa	FALSE
bÆÏQDê¥ØÅ8Ò³Ä	FALSE
bÅÔ·wPFKuP¡È·ìv	FALSE
b2±GXêé4¼¸ßdrFÒå²Û·½¹å	FALSE
éH9bbS	FALSE
bêóEjç5mK¦ñeôfä	FALSE
bL3iùJwÌ	FALSE
£ÌÊ¡à1ßÏfÂèî°ÇÜ¨mkâe¸¿½a	FALSE
R¹Õu8¤¢3rMBéCi7ÁóôMÓ88Aa	FALSE
Ï§Ò¯V½9Öw®öa	FALSE
æÌbbh±NÐÝ¸	FALSE
´5Ia	FALSE
VODwêbbb	FALSE
W²¤8Abbbt1QG	FALSE
br3¶A£·÷ÃQÌkOg	FALSE
ºÎßªÓÎíjØÖµïjbbïÜÆÂó	FALSE
bbZG7S±sy¾ñC«étoèáäÅÒ¥ë	FALSE
bËq	FALSE
wµ©ÞàuBwà¨a	FALSE
bk§ÓlÐLUÙpÈñ©ÀTÏÄßî§a½«	FALSE
4QPÀâPáa	FALSE
CmÕyy«aar9«nñ®¥X¹	FALSE
Ò§³²Í°YA±èuÏöb¢ë£¾ð«Óa	FALSE
Ozl©Æbb½7ÂFÖÌ9s¤ÕJ	FALSE
ué3ÄáCÔsbbPOÛÆ¤	FALSE
Ëºuê¬pÔZªkè«êì¸SîVÁêbb	FALSE
b¤¿Åv	FALSE
ØWOaaµê	FALSE
ÀóÊOS7«X±zbb3É	FALSE
bÔÊJ×¯	FALSE
îS¿GñãQVfëKOB°lEaaW¢¿j	FALSE
aa	FALSE
P¥ÀqGÚËÕ¤wsa	FALSE
bb®	FALSE
¹ÆN»zÇJ²Z÷ëXðGÙza	FALSE
ÆÞaa	FALSE
Îëa´NlgIYLaa	FALSE
ÇtdH8øa	FALSE
b£é¦ÕyÔDa	FALSE
ÁªëE2µ©ÐÎÕ6Ä®éhE°aJaaKåXB	FALSE
SÚíõòÔRUaav¼jwÛÛ»jHeB	FALSE
¾FJæa	FALSE
bÉæÁrvÓ¢wb´K	FALSE
á«qß»R¬ÍëÆÚÓJa	FALSE
ÂÁgëJW©±7ÜkMBãò³Ì5FÛ¦öõ¾a	FALSE
aaJøo£ÈÅ	FALSE
bðY9¬Ü¼ÔôãæOÓiÚM	FALSE
µ¤JxÄËaaëNÉ¸¤88­âQJF	FALSE
HrÜDEB®èõ×Ñ¸uÒ28a¨6²¸¥Ì¾a	FALSE
ÞbbDÑR«Ï8	FALSE
ã¯3k¨ºcÓa	FALSE
ØaaBÖ5Õ	FALSE
ârÕvkØ»SÙÉùÂaaÍÚôYâ¸àIî	FALSE
bpm	FALSE
aa¨C	FALSE
bMm÷â14µ¦M	FALSE
ÎÀbbõ¹	FALSE
oÕÎÓbb¾ô´U¦6VÅ´Löíhç²pl	FALSE
î¥Ùô¢o¶aaOH1¤òLbkM5Ë	FALSE
báãh×ßù÷èc6¾A4¦î»Kn	FALSE
gÎÜWÇspÞh¢9åéÙbbÇ	FALSE
bÏOí8Mî6÷ôFøªi÷NQbñÞ·Åå	FALSE
ôÆÄ5Ô¦ï¡¯ÁLX«¡2v£÷âa	FALSE
ëâEb5Aäßhaa¸ÂÇG	FALSE
ÕuwÛÃoÌßaabóeÒvDº	FALSE
bO	FALSE
¿s§2éíx«Â·õÑÐÁya	FALSE
ÖKÐ÷a	FALSE
«ïFº¯Ær¼£åLWta	FALSE
·aaæJ£f	FALSE
»ÂAÄMùëÆÀZbÇøoa	FALSE
uùbbÛQöOÒÙK÷«¤I3äi2	FALSE
boFÆ¹°ySºäQRÏqÍei	FALSE
H§åÄáayöÑÅ£aaf	FALSE
b¾o6ñ¾Ï½ÞJGHFLXÕ¬yÇUºÜó	FALSE
ÎAPåIóiWaa	FALSE
bbÉ7­²	FALSE
qâÝaapîâ	FALSE
